pref_code,pref_name,age_group,year,gengo,gengo_year,pop_total,pop_m,pop_f
1 ,Hokkaido,total,1920,Taisho,9,2359183,1244322,1114861
1 ,Hokkaido,0_ 4,1920,Taisho,9,376676,190044,186632
1 ,Hokkaido,5_ 9,1920,Taisho,9,319370,161814,157556
1 ,Hokkaido,10_ 14,1920,Taisho,9,270012,138018,131994
1 ,Hokkaido,15_ 19,1920,Taisho,9,239092,125670,113422
1 ,Hokkaido,20_ 24,1920,Taisho,9,208337,109351,98986
1 ,Hokkaido,25_ 29,1920,Taisho,9,175257,96638,78619
1 ,Hokkaido,30_ 34,1920,Taisho,9,157450,86287,71163
1 ,Hokkaido,35_ 39,1920,Taisho,9,143281,78926,64355
1 ,Hokkaido,40_ 44,1920,Taisho,9,127242,70818,56424
1 ,Hokkaido,45_ 49,1920,Taisho,9,97859,55004,42855
1 ,Hokkaido,50_ 54,1920,Taisho,9,76617,43412,33205
1 ,Hokkaido,55_ 59,1920,Taisho,9,53524,29659,23865
1 ,Hokkaido,60_ 64,1920,Taisho,9,44115,23975,20140
1 ,Hokkaido,65_ 69,1920,Taisho,9,33402,17456,15946
1 ,Hokkaido,70_ 74,1920,Taisho,9,21433,10466,10967
1 ,Hokkaido,75_ 79,1920,Taisho,9,10484,4766,5718
1 ,Hokkaido,over_80,1920,Taisho,9,5032,2018,3014
1 ,Hokkaido,total,1925,Taisho,14,2498679,1305473,1193206
1 ,Hokkaido,0_ 4,1925,Taisho,14,405607,204576,201031
1 ,Hokkaido,5_ 9,1925,Taisho,14,336438,170315,166123
1 ,Hokkaido,10_ 14,1925,Taisho,14,300821,153388,147433
1 ,Hokkaido,15_ 19,1925,Taisho,14,252275,131986,120289
1 ,Hokkaido,20_ 24,1925,Taisho,14,215391,112790,102601
1 ,Hokkaido,25_ 29,1925,Taisho,14,186159,99237,86922
1 ,Hokkaido,30_ 34,1925,Taisho,14,152114,83238,68876
1 ,Hokkaido,35_ 39,1925,Taisho,14,139774,76040,63734
1 ,Hokkaido,40_ 44,1925,Taisho,14,126620,68948,57672
1 ,Hokkaido,45_ 49,1925,Taisho,14,112769,61572,51197
1 ,Hokkaido,50_ 54,1925,Taisho,14,85288,46801,38487
1 ,Hokkaido,55_ 59,1925,Taisho,14,64998,35637,29361
1 ,Hokkaido,60_ 64,1925,Taisho,14,43812,23516,20296
1 ,Hokkaido,65_ 69,1925,Taisho,14,33679,17441,16238
1 ,Hokkaido,70_ 74,1925,Taisho,14,23395,11550,11845
1 ,Hokkaido,75_ 79,1925,Taisho,14,12971,5829,7142
1 ,Hokkaido,80_ 84,1925,Taisho,14,5054,2084,2970
1 ,Hokkaido,over_85,1925,Taisho,14,1514,525,989
1 ,Hokkaido,total,1930,Showa,5,2812335,1468540,1343795
1 ,Hokkaido,0_ 4,1930,Showa,5,445457,224549,220908
1 ,Hokkaido,5_ 9,1930,Showa,5,383080,193478,189602
1 ,Hokkaido,10_ 14,1930,Showa,5,329334,167701,161633
1 ,Hokkaido,15_ 19,1930,Showa,5,296826,154310,142516
1 ,Hokkaido,20_ 24,1930,Showa,5,248258,132268,115990
1 ,Hokkaido,25_ 29,1930,Showa,5,214713,116156,98557
1 ,Hokkaido,30_ 34,1930,Showa,5,180075,97392,82683
1 ,Hokkaido,35_ 39,1930,Showa,5,148585,81969,66616
1 ,Hokkaido,40_ 44,1930,Showa,5,132094,71915,60179
1 ,Hokkaido,45_ 49,1930,Showa,5,117921,63638,54283
1 ,Hokkaido,50_ 54,1930,Showa,5,102601,55382,47219
1 ,Hokkaido,55_ 59,1930,Showa,5,76118,40916,35202
1 ,Hokkaido,60_ 64,1930,Showa,5,55651,29551,26100
1 ,Hokkaido,65_ 69,1930,Showa,5,35062,18006,17056
1 ,Hokkaido,70_ 74,1930,Showa,5,23986,11630,12356
1 ,Hokkaido,75_ 79,1930,Showa,5,14204,6488,7716
1 ,Hokkaido,over_80,1930,Showa,5,8370,3191,5179
1 ,Hokkaido,total,1935,Showa,10,3068282,1593845,1474437
1 ,Hokkaido,0_ 4,1935,Showa,10,462550,234131,228419
1 ,Hokkaido,5_ 9,1935,Showa,10,417967,210495,207472
1 ,Hokkaido,10_ 14,1935,Showa,10,372110,188761,183349
1 ,Hokkaido,15_ 19,1935,Showa,10,317212,164046,153166
1 ,Hokkaido,20_ 24,1935,Showa,10,278229,145037,133192
1 ,Hokkaido,25_ 29,1935,Showa,10,234977,126338,108639
1 ,Hokkaido,30_ 34,1935,Showa,10,201819,108882,92937
1 ,Hokkaido,35_ 39,1935,Showa,10,169407,91739,77668
1 ,Hokkaido,40_ 44,1935,Showa,10,136412,75205,61207
1 ,Hokkaido,45_ 49,1935,Showa,10,121204,65577,55627
1 ,Hokkaido,50_ 54,1935,Showa,10,106400,56631,49769
1 ,Hokkaido,55_ 59,1935,Showa,10,90828,47891,42937
1 ,Hokkaido,60_ 64,1935,Showa,10,65172,34025,31147
1 ,Hokkaido,65_ 69,1935,Showa,10,44236,22517,21719
1 ,Hokkaido,70_ 74,1935,Showa,10,25466,12321,13145
1 ,Hokkaido,75_ 79,1935,Showa,10,14770,6541,8229
1 ,Hokkaido,over_80,1935,Showa,10,9523,3708,5815
1 ,Hokkaido,total,1940,Showa,15,3272012,1695083,1576929
1 ,Hokkaido,0_ 4,1940,Showa,15,456318,230441,225877
1 ,Hokkaido,5_ 9,1940,Showa,15,430141,217615,212526
1 ,Hokkaido,10_ 14,1940,Showa,15,401194,202527,198667
1 ,Hokkaido,15_ 19,1940,Showa,15,354389,182608,171781
1 ,Hokkaido,20_ 24,1940,Showa,15,291584,150654,140930
1 ,Hokkaido,25_ 29,1940,Showa,15,259621,138081,121540
1 ,Hokkaido,30_ 34,1940,Showa,15,220332,119732,100600
1 ,Hokkaido,35_ 39,1940,Showa,15,190365,103303,87062
1 ,Hokkaido,40_ 44,1940,Showa,15,156820,84964,71856
1 ,Hokkaido,45_ 49,1940,Showa,15,124292,68003,56289
1 ,Hokkaido,50_ 54,1940,Showa,15,109273,58414,50859
1 ,Hokkaido,55_ 59,1940,Showa,15,93436,48745,44691
1 ,Hokkaido,60_ 64,1940,Showa,15,77004,39157,37847
1 ,Hokkaido,65_ 69,1940,Showa,15,51494,25585,25909
1 ,Hokkaido,70_ 74,1940,Showa,15,31322,14943,16379
1 ,Hokkaido,75_ 79,1940,Showa,15,15130,6743,8387
1 ,Hokkaido,80_ 84,1940,Showa,15,6454,2592,3862
1 ,Hokkaido,over_85,1940,Showa,15,2829,972,1857
1 ,Hokkaido,total,1945,Showa,20,3518389,1738623,1779766
1 ,Hokkaido,1_ 5,1945,Showa,20,497219,252253,244966
1 ,Hokkaido,6_ 10,1945,Showa,20,447774,226133,221641
1 ,Hokkaido,11_ 15,1945,Showa,20,436104,220621,215483
1 ,Hokkaido,16_ 20,1945,Showa,20,398031,200381,197650
1 ,Hokkaido,21_ 25,1945,Showa,20,296266,125878,170388
1 ,Hokkaido,26_ 30,1945,Showa,20,251138,113300,137838
1 ,Hokkaido,31_ 35,1945,Showa,20,226494,106578,119916
1 ,Hokkaido,36_ 40,1945,Showa,20,205518,104367,101151
1 ,Hokkaido,41_ 45,1945,Showa,20,180418,94652,85766
1 ,Hokkaido,46_ 50,1945,Showa,20,149246,78458,70788
1 ,Hokkaido,51_ 55,1945,Showa,20,116448,62134,54314
1 ,Hokkaido,56_ 60,1945,Showa,20,100043,51867,48176
1 ,Hokkaido,61_ 65,1945,Showa,20,81130,40623,40507
1 ,Hokkaido,66_ 70,1945,Showa,20,62712,30303,32409
1 ,Hokkaido,71_ 75,1945,Showa,20,39498,18367,21131
1 ,Hokkaido,76_ 80,1945,Showa,20,19655,8543,11112
1 ,Hokkaido,81_ 85,1945,Showa,20,7832,3182,4650
1 ,Hokkaido,86以上,1945,Showa,20,2863,983,1880
1 ,Hokkaido,total,1950,Showa,25,4295567,2169393,2126174
1 ,Hokkaido,0_ 4,1950,Showa,25,663628,338126,325502
1 ,Hokkaido,5_ 9,1950,Showa,25,524173,266014,258159
1 ,Hokkaido,10_ 14,1950,Showa,25,472030,238681,233349
1 ,Hokkaido,15_ 19,1950,Showa,25,455200,230778,224422
1 ,Hokkaido,20_ 24,1950,Showa,25,414482,212766,201716
1 ,Hokkaido,25_ 29,1950,Showa,25,334066,160615,173451
1 ,Hokkaido,30_ 34,1950,Showa,25,276842,133284,143558
1 ,Hokkaido,35_ 39,1950,Showa,25,249904,125239,124665
1 ,Hokkaido,40_ 44,1950,Showa,25,212512,110617,101895
1 ,Hokkaido,45_ 49,1950,Showa,25,182023,96002,86021
1 ,Hokkaido,50_ 54,1950,Showa,25,145259,76510,68749
1 ,Hokkaido,55_ 59,1950,Showa,25,112609,59652,52957
1 ,Hokkaido,60_ 64,1950,Showa,25,92453,47034,45419
1 ,Hokkaido,65_ 69,1950,Showa,25,70010,34088,35922
1 ,Hokkaido,70_ 74,1950,Showa,25,49493,22882,26611
1 ,Hokkaido,75_ 79,1950,Showa,25,26482,11612,14870
1 ,Hokkaido,over_80,1950,Showa,25,14319,5451,8868
1 ,Hokkaido,total,1955,Showa,30,4773087,2428833,2344254
1 ,Hokkaido,0_ 4,1955,Showa,30,578015,295270,282745
1 ,Hokkaido,5_ 9,1955,Showa,30,652105,332268,319837
1 ,Hokkaido,10_ 14,1955,Showa,30,520095,263869,256226
1 ,Hokkaido,15_ 19,1955,Showa,30,478640,243826,234814
1 ,Hokkaido,20_ 24,1955,Showa,30,477693,253023,224670
1 ,Hokkaido,25_ 29,1955,Showa,30,417087,217471,199616
1 ,Hokkaido,30_ 34,1955,Showa,30,331041,160057,170984
1 ,Hokkaido,35_ 39,1955,Showa,30,272037,131605,140432
1 ,Hokkaido,40_ 44,1955,Showa,30,244333,123275,121058
1 ,Hokkaido,45_ 49,1955,Showa,30,205570,107313,98257
1 ,Hokkaido,50_ 54,1955,Showa,30,172800,91056,81744
1 ,Hokkaido,55_ 59,1955,Showa,30,136432,71134,65298
1 ,Hokkaido,60_ 64,1955,Showa,30,100924,52573,48351
1 ,Hokkaido,65_ 69,1955,Showa,30,77641,38436,39205
1 ,Hokkaido,70_ 74,1955,Showa,30,54469,25351,29118
1 ,Hokkaido,75_ 79,1955,Showa,30,33965,14605,19360
1 ,Hokkaido,80_ 84,1955,Showa,30,14856,5922,8934
1 ,Hokkaido,over_85,1955,Showa,30,5334,1755,3579
1 ,Hokkaido,total,1960,Showa,35,5039206,2544753,2494453
1 ,Hokkaido,0_ 4,1960,Showa,35,455213,233417,221796
1 ,Hokkaido,5_ 9,1960,Showa,35,576230,294325,281905
1 ,Hokkaido,10_ 14,1960,Showa,35,650036,330838,319198
1 ,Hokkaido,15_ 19,1960,Showa,35,508799,254493,254306
1 ,Hokkaido,20_ 24,1960,Showa,35,466201,234547,231654
1 ,Hokkaido,25_ 29,1960,Showa,35,456601,236265,220336
1 ,Hokkaido,30_ 34,1960,Showa,35,406635,210205,196430
1 ,Hokkaido,35_ 39,1960,Showa,35,325295,156892,168403
1 ,Hokkaido,40_ 44,1960,Showa,35,265390,128209,137181
1 ,Hokkaido,45_ 49,1960,Showa,35,235937,118591,117346
1 ,Hokkaido,50_ 54,1960,Showa,35,195596,101257,94339
1 ,Hokkaido,55_ 59,1960,Showa,35,161977,84189,77788
1 ,Hokkaido,60_ 64,1960,Showa,35,123233,62669,60564
1 ,Hokkaido,65_ 69,1960,Showa,35,86454,43470,42984
1 ,Hokkaido,70_ 74,1960,Showa,35,61616,29143,32473
1 ,Hokkaido,75_ 79,1960,Showa,35,37235,16144,21091
1 ,Hokkaido,80_ 84,1960,Showa,35,19025,7503,11522
1 ,Hokkaido,over_85,1960,Showa,35,7733,2596,5137
1 ,Hokkaido,total,1965,Showa,40,5171800,2583159,2588641
1 ,Hokkaido,0_ 4,1965,Showa,40,451390,230709,220681
1 ,Hokkaido,5_ 9,1965,Showa,40,446543,228280,218263
1 ,Hokkaido,10_ 14,1965,Showa,40,564190,287232,276958
1 ,Hokkaido,15_ 19,1965,Showa,40,599110,298657,300453
1 ,Hokkaido,20_ 24,1965,Showa,40,451306,213227,238079
1 ,Hokkaido,25_ 29,1965,Showa,40,443552,218388,225164
1 ,Hokkaido,30_ 34,1965,Showa,40,444456,229144,215312
1 ,Hokkaido,35_ 39,1965,Showa,40,395352,204354,190998
1 ,Hokkaido,40_ 44,1965,Showa,40,314889,151735,163154
1 ,Hokkaido,45_ 49,1965,Showa,40,255874,123275,132599
1 ,Hokkaido,50_ 54,1965,Showa,40,224639,112246,112393
1 ,Hokkaido,55_ 59,1965,Showa,40,184087,94706,89381
1 ,Hokkaido,60_ 64,1965,Showa,40,147094,74977,72117
1 ,Hokkaido,65_ 69,1965,Showa,40,106628,52674,53954
1 ,Hokkaido,70_ 74,1965,Showa,40,69414,33226,36188
1 ,Hokkaido,75_ 79,1965,Showa,40,42670,18875,23795
1 ,Hokkaido,80_ 84,1965,Showa,40,20537,8142,12395
1 ,Hokkaido,over_85,1965,Showa,40,10069,3312,6757
1 ,Hokkaido,total,1970,Showa,45,5184287,2552806,2631481
1 ,Hokkaido,0_ 4,1970,Showa,45,438566,224166,214400
1 ,Hokkaido,5_ 9,1970,Showa,45,436424,222706,213718
1 ,Hokkaido,10_ 14,1970,Showa,45,434497,221689,212808
1 ,Hokkaido,15_ 19,1970,Showa,45,499412,250272,249140
1 ,Hokkaido,20_ 24,1970,Showa,45,514232,238736,275496
1 ,Hokkaido,25_ 29,1970,Showa,45,432539,204712,227827
1 ,Hokkaido,30_ 34,1970,Showa,45,422693,206700,215993
1 ,Hokkaido,35_ 39,1970,Showa,45,420657,214338,206319
1 ,Hokkaido,40_ 44,1970,Showa,45,373007,190592,182415
1 ,Hokkaido,45_ 49,1970,Showa,45,299056,141796,157260
1 ,Hokkaido,50_ 54,1970,Showa,45,241113,114136,126977
1 ,Hokkaido,55_ 59,1970,Showa,45,206681,101054,105627
1 ,Hokkaido,60_ 64,1970,Showa,45,166341,83161,83180
1 ,Hokkaido,65_ 69,1970,Showa,45,127461,62533,64928
1 ,Hokkaido,70_ 74,1970,Showa,45,86387,40657,45730
1 ,Hokkaido,75_ 79,1970,Showa,45,49117,21861,27256
1 ,Hokkaido,80_ 84,1970,Showa,45,24514,9733,14781
1 ,Hokkaido,over_85,1970,Showa,45,11590,3964,7626
1 ,Hokkaido,total,1975,Showa,50,5338206,2621285,2716921
1 ,Hokkaido,0_ 4,1975,Showa,50,462080,236947,225133
1 ,Hokkaido,5_ 9,1975,Showa,50,427004,218215,208789
1 ,Hokkaido,10_ 14,1975,Showa,50,423527,216154,207373
1 ,Hokkaido,15_ 19,1975,Showa,50,397272,201906,195366
1 ,Hokkaido,20_ 24,1975,Showa,50,443148,209711,233437
1 ,Hokkaido,25_ 29,1975,Showa,50,515030,246916,268114
1 ,Hokkaido,30_ 34,1975,Showa,50,426829,205196,221633
1 ,Hokkaido,35_ 39,1975,Showa,50,408639,200120,208519
1 ,Hokkaido,40_ 44,1975,Showa,50,404726,205156,199570
1 ,Hokkaido,45_ 49,1975,Showa,50,358581,181654,176927
1 ,Hokkaido,50_ 54,1975,Showa,50,283864,132779,151085
1 ,Hokkaido,55_ 59,1975,Showa,50,226937,105630,121307
1 ,Hokkaido,60_ 64,1975,Showa,50,192858,92143,100715
1 ,Hokkaido,65_ 69,1975,Showa,50,149505,71924,77581
1 ,Hokkaido,70_ 74,1975,Showa,50,107133,50085,57048
1 ,Hokkaido,75_ 79,1975,Showa,50,65111,28726,36385
1 ,Hokkaido,80_ 84,1975,Showa,50,30348,12470,17878
1 ,Hokkaido,over_85,1975,Showa,50,14554,4914,9640
1 ,Hokkaido,total,1980,Showa,55,5575989,2737089,2838900
1 ,Hokkaido,0_ 4,1980,Showa,55,407498,208437,199061
1 ,Hokkaido,5_ 9,1980,Showa,55,465277,238711,226566
1 ,Hokkaido,10_ 14,1980,Showa,55,425549,217367,208182
1 ,Hokkaido,15_ 19,1980,Showa,55,410100,209528,200572
1 ,Hokkaido,20_ 24,1980,Showa,55,376820,185415,191405
1 ,Hokkaido,25_ 29,1980,Showa,55,460048,223093,236955
1 ,Hokkaido,30_ 34,1980,Showa,55,520637,252957,267680
1 ,Hokkaido,35_ 39,1980,Showa,55,424505,204233,220272
1 ,Hokkaido,40_ 44,1980,Showa,55,401796,196248,205548
1 ,Hokkaido,45_ 49,1980,Showa,55,395052,198635,196417
1 ,Hokkaido,50_ 54,1980,Showa,55,347590,174360,173230
1 ,Hokkaido,55_ 59,1980,Showa,55,273003,126069,146934
1 ,Hokkaido,60_ 64,1980,Showa,55,214257,97925,116332
1 ,Hokkaido,65_ 69,1980,Showa,55,176035,81875,94160
1 ,Hokkaido,70_ 74,1980,Showa,55,129016,59491,69525
1 ,Hokkaido,75_ 79,1980,Showa,55,83791,36898,46893
1 ,Hokkaido,80_ 84,1980,Showa,55,42863,17393,25470
1 ,Hokkaido,over_85,1980,Showa,55,20022,7046,12976
1 ,Hokkaido,total,1985,Showa,60,5679439,2766296,2913143
1 ,Hokkaido,0_ 4,1985,Showa,60,352073,180019,172054
1 ,Hokkaido,5_ 9,1985,Showa,60,405226,207356,197870
1 ,Hokkaido,10_ 14,1985,Showa,60,460660,236038,224622
1 ,Hokkaido,15_ 19,1985,Showa,60,412479,209552,202927
1 ,Hokkaido,20_ 24,1985,Showa,60,376187,183074,193113
1 ,Hokkaido,25_ 29,1985,Showa,60,372732,181763,190969
1 ,Hokkaido,30_ 34,1985,Showa,60,455435,221540,233895
1 ,Hokkaido,35_ 39,1985,Showa,60,511932,247804,264128
1 ,Hokkaido,40_ 44,1985,Showa,60,414669,198446,216223
1 ,Hokkaido,45_ 49,1985,Showa,60,390732,189084,201648
1 ,Hokkaido,50_ 54,1985,Showa,60,382461,190166,192295
1 ,Hokkaido,55_ 59,1985,Showa,60,334193,165329,168864
1 ,Hokkaido,60_ 64,1985,Showa,60,259909,117754,142155
1 ,Hokkaido,65_ 69,1985,Showa,60,198792,88156,110636
1 ,Hokkaido,70_ 74,1985,Showa,60,156177,69628,86549
1 ,Hokkaido,75_ 79,1985,Showa,60,105601,45579,60022
1 ,Hokkaido,80_ 84,1985,Showa,60,58524,23514,35010
1 ,Hokkaido,over_85,1985,Showa,60,30393,10718,19675
1 ,Hokkaido,total,1990,Heisei,2,5643647,2722988,2920659
1 ,Hokkaido,0_ 4,1990,Heisei,2,291820,149665,142155
1 ,Hokkaido,5_ 9,1990,Heisei,2,345826,176765,169061
1 ,Hokkaido,10_ 14,1990,Heisei,2,396605,202723,193882
1 ,Hokkaido,15_ 19,1990,Heisei,2,443367,226108,217259
1 ,Hokkaido,20_ 24,1990,Heisei,2,364934,176755,188179
1 ,Hokkaido,25_ 29,1990,Heisei,2,355206,169103,186103
1 ,Hokkaido,30_ 34,1990,Heisei,2,361257,175788,185469
1 ,Hokkaido,35_ 39,1990,Heisei,2,442849,214554,228295
1 ,Hokkaido,40_ 44,1990,Heisei,2,495423,238040,257383
1 ,Hokkaido,45_ 49,1990,Heisei,2,399372,189040,210332
1 ,Hokkaido,50_ 54,1990,Heisei,2,375525,179254,196271
1 ,Hokkaido,55_ 59,1990,Heisei,2,367435,179827,187608
1 ,Hokkaido,60_ 64,1990,Heisei,2,319349,155306,164043
1 ,Hokkaido,65_ 69,1990,Heisei,2,243496,107647,135849
1 ,Hokkaido,70_ 74,1990,Heisei,2,178838,76346,102492
1 ,Hokkaido,75_ 79,1990,Heisei,2,130516,54756,75760
1 ,Hokkaido,80_ 84,1990,Heisei,2,76827,30103,46724
1 ,Hokkaido,over_85,1990,Heisei,2,45204,15394,29810
1 ,Hokkaido,total,1995,Heisei,7,5692321,2736844,2955477
1 ,Hokkaido,0_ 4,1995,Heisei,7,260027,132618,127409
1 ,Hokkaido,5_ 9,1995,Heisei,7,294029,150901,143128
1 ,Hokkaido,10_ 14,1995,Heisei,7,344617,176055,168562
1 ,Hokkaido,15_ 19,1995,Heisei,7,394609,201737,192872
1 ,Hokkaido,20_ 24,1995,Heisei,7,415477,207782,207695
1 ,Hokkaido,25_ 29,1995,Heisei,7,359523,172479,187044
1 ,Hokkaido,30_ 34,1995,Heisei,7,359859,173236,186623
1 ,Hokkaido,35_ 39,1995,Heisei,7,362359,177080,185279
1 ,Hokkaido,40_ 44,1995,Heisei,7,441130,214022,227108
1 ,Hokkaido,45_ 49,1995,Heisei,7,490810,235671,255139
1 ,Hokkaido,50_ 54,1995,Heisei,7,393416,185470,207946
1 ,Hokkaido,55_ 59,1995,Heisei,7,368787,174462,194325
1 ,Hokkaido,60_ 64,1995,Heisei,7,356898,172580,184318
1 ,Hokkaido,65_ 69,1995,Heisei,7,302906,143846,159060
1 ,Hokkaido,70_ 74,1995,Heisei,7,223036,94498,128538
1 ,Hokkaido,75_ 79,1995,Heisei,7,153307,61266,92041
1 ,Hokkaido,80_ 84,1995,Heisei,7,99044,37741,61303
1 ,Hokkaido,over_85,1995,Heisei,7,66634,21643,44991
1 ,Hokkaido,total,2000,Heisei,12,5683062,2719389,2963673
1 ,Hokkaido,0_ 4,2000,Heisei,12,238264,121481,116783
1 ,Hokkaido,5_ 9,2000,Heisei,12,260721,132985,127736
1 ,Hokkaido,10_ 14,2000,Heisei,12,293367,150621,142746
1 ,Hokkaido,15_ 19,2000,Heisei,12,341843,175008,166835
1 ,Hokkaido,20_ 24,2000,Heisei,12,358051,179696,178355
1 ,Hokkaido,25_ 29,2000,Heisei,12,398170,195963,202207
1 ,Hokkaido,30_ 34,2000,Heisei,12,358152,172198,185954
1 ,Hokkaido,35_ 39,2000,Heisei,12,357383,172185,185198
1 ,Hokkaido,40_ 44,2000,Heisei,12,358952,174914,184038
1 ,Hokkaido,45_ 49,2000,Heisei,12,434070,209920,224150
1 ,Hokkaido,50_ 54,2000,Heisei,12,481382,229636,251746
1 ,Hokkaido,55_ 59,2000,Heisei,12,385065,179583,205482
1 ,Hokkaido,60_ 64,2000,Heisei,12,359834,168237,191597
1 ,Hokkaido,65_ 69,2000,Heisei,12,339288,160468,178820
1 ,Hokkaido,70_ 74,2000,Heisei,12,278834,127800,151034
1 ,Hokkaido,75_ 79,2000,Heisei,12,195597,78377,117220
1 ,Hokkaido,80_ 84,2000,Heisei,12,121093,44180,76913
1 ,Hokkaido,over_85,2000,Heisei,12,96740,30334,66406
1 ,Hokkaido,total,2005,Heisei,17,5627737,2675033,2952704
1 ,Hokkaido,0_ 4,2005,Heisei,17,220680,112055,108625
1 ,Hokkaido,5_ 9,2005,Heisei,17,238798,122052,116746
1 ,Hokkaido,10_ 14,2005,Heisei,17,259579,132431,127148
1 ,Hokkaido,15_ 19,2005,Heisei,17,292235,150839,141396
1 ,Hokkaido,20_ 24,2005,Heisei,17,314753,159089,155664
1 ,Hokkaido,25_ 29,2005,Heisei,17,343983,169948,174035
1 ,Hokkaido,30_ 34,2005,Heisei,17,398071,196201,201870
1 ,Hokkaido,35_ 39,2005,Heisei,17,357532,172188,185344
1 ,Hokkaido,40_ 44,2005,Heisei,17,354700,170573,184127
1 ,Hokkaido,45_ 49,2005,Heisei,17,354399,172033,182366
1 ,Hokkaido,50_ 54,2005,Heisei,17,428459,205963,222496
1 ,Hokkaido,55_ 59,2005,Heisei,17,473433,223790,249643
1 ,Hokkaido,60_ 64,2005,Heisei,17,378499,174908,203591
1 ,Hokkaido,65_ 69,2005,Heisei,17,346334,159124,187210
1 ,Hokkaido,70_ 74,2005,Heisei,17,316115,144875,171240
1 ,Hokkaido,75_ 79,2005,Heisei,17,247983,107585,140398
1 ,Hokkaido,80_ 84,2005,Heisei,17,161033,58803,102230
1 ,Hokkaido,over_85,2005,Heisei,17,134227,39218,95009
1 ,Hokkaido,total,2010,Heisei,22,5506419,2603345,2903074
1 ,Hokkaido,0_ 4,2010,Heisei,22,200977,102766,98211
1 ,Hokkaido,5_ 9,2010,Heisei,22,219180,111287,107893
1 ,Hokkaido,10_ 14,2010,Heisei,22,237155,121300,115855
1 ,Hokkaido,15_ 19,2010,Heisei,22,258530,132356,126174
1 ,Hokkaido,20_ 24,2010,Heisei,22,264185,133097,131088
1 ,Hokkaido,25_ 29,2010,Heisei,22,289677,142807,146870
1 ,Hokkaido,30_ 34,2010,Heisei,22,338063,166953,171110
1 ,Hokkaido,35_ 39,2010,Heisei,22,393511,194191,199320
1 ,Hokkaido,40_ 44,2010,Heisei,22,354218,170760,183458
1 ,Hokkaido,45_ 49,2010,Heisei,22,349792,168184,181608
1 ,Hokkaido,50_ 54,2010,Heisei,22,349171,168649,180522
1 ,Hokkaido,55_ 59,2010,Heisei,22,420687,200857,219830
1 ,Hokkaido,60_ 64,2010,Heisei,22,464335,217737,246598
1 ,Hokkaido,65_ 69,2010,Heisei,22,363599,164977,198622
1 ,Hokkaido,70_ 74,2010,Heisei,22,324351,144832,179519
1 ,Hokkaido,75_ 79,2010,Heisei,22,283815,123747,160068
1 ,Hokkaido,80_ 84,2010,Heisei,22,206637,81736,124901
1 ,Hokkaido,over_85,2010,Heisei,22,179666,51849,127817
1 ,Hokkaido,total,2015,Heisei,27,5381733,2537089,2844644
1 ,Hokkaido,0_ 4,2015,Heisei,27,186010,95022,90988
1 ,Hokkaido,5_ 9,2015,Heisei,27,202269,103549,98720
1 ,Hokkaido,10_ 14,2015,Heisei,27,220017,111816,108201
1 ,Hokkaido,15_ 19,2015,Heisei,27,239098,123196,115902
1 ,Hokkaido,20_ 24,2015,Heisei,27,234274,117965,116309
1 ,Hokkaido,25_ 29,2015,Heisei,27,247587,123076,124511
1 ,Hokkaido,30_ 34,2015,Heisei,27,287674,141876,145798
1 ,Hokkaido,35_ 39,2015,Heisei,27,337369,166514,170855
1 ,Hokkaido,40_ 44,2015,Heisei,27,391243,193093,198150
1 ,Hokkaido,45_ 49,2015,Heisei,27,350794,169252,181542
1 ,Hokkaido,50_ 54,2015,Heisei,27,345836,165634,180202
1 ,Hokkaido,55_ 59,2015,Heisei,27,343884,165353,178531
1 ,Hokkaido,60_ 64,2015,Heisei,27,413045,195920,217125
1 ,Hokkaido,65_ 69,2015,Heisei,27,448646,207461,241185
1 ,Hokkaido,70_ 74,2015,Heisei,27,341850,151031,190819
1 ,Hokkaido,75_ 79,2015,Heisei,27,293306,124921,168385
1 ,Hokkaido,80_ 84,2015,Heisei,27,238663,95987,142676
1 ,Hokkaido,over_85,2015,Heisei,27,235922,71886,164036
2 ,Aomori,total,1920,Taisho,9,756454,381293,375161
2 ,Aomori,0_ 4,1920,Taisho,9,114948,57807,57141
2 ,Aomori,5_ 9,1920,Taisho,9,103541,52614,50927
2 ,Aomori,10_ 14,1920,Taisho,9,90021,46153,43868
2 ,Aomori,15_ 19,1920,Taisho,9,73746,37391,36355
2 ,Aomori,20_ 24,1920,Taisho,9,63189,33343,29846
2 ,Aomori,25_ 29,1920,Taisho,9,53161,26443,26718
2 ,Aomori,30_ 34,1920,Taisho,9,46544,22996,23548
2 ,Aomori,35_ 39,1920,Taisho,9,43255,21450,21805
2 ,Aomori,40_ 44,1920,Taisho,9,38845,19754,19091
2 ,Aomori,45_ 49,1920,Taisho,9,30495,15376,15119
2 ,Aomori,50_ 54,1920,Taisho,9,26363,13301,13062
2 ,Aomori,55_ 59,1920,Taisho,9,20645,10450,10195
2 ,Aomori,60_ 64,1920,Taisho,9,18371,9114,9257
2 ,Aomori,65_ 69,1920,Taisho,9,15376,7308,8068
2 ,Aomori,70_ 74,1920,Taisho,9,10430,4763,5667
2 ,Aomori,75_ 79,1920,Taisho,9,5478,2360,3118
2 ,Aomori,over_80,1920,Taisho,9,2046,670,1376
2 ,Aomori,total,1925,Taisho,14,812977,408770,404207
2 ,Aomori,0_ 4,1925,Taisho,14,128337,64660,63677
2 ,Aomori,5_ 9,1925,Taisho,14,106108,53198,52910
2 ,Aomori,10_ 14,1925,Taisho,14,98712,50549,48163
2 ,Aomori,15_ 19,1925,Taisho,14,80740,40900,39840
2 ,Aomori,20_ 24,1925,Taisho,14,69094,35633,33461
2 ,Aomori,25_ 29,1925,Taisho,14,56313,28433,27880
2 ,Aomori,30_ 34,1925,Taisho,14,50388,25489,24899
2 ,Aomori,35_ 39,1925,Taisho,14,44379,22194,22185
2 ,Aomori,40_ 44,1925,Taisho,14,40646,20326,20320
2 ,Aomori,45_ 49,1925,Taisho,14,36533,18463,18070
2 ,Aomori,50_ 54,1925,Taisho,14,27901,13930,13971
2 ,Aomori,55_ 59,1925,Taisho,14,23559,11736,11823
2 ,Aomori,60_ 64,1925,Taisho,14,17585,8680,8905
2 ,Aomori,65_ 69,1925,Taisho,14,14100,6702,7398
2 ,Aomori,70_ 74,1925,Taisho,14,10359,4557,5802
2 ,Aomori,75_ 79,1925,Taisho,14,5584,2339,3245
2 ,Aomori,80_ 84,1925,Taisho,14,2185,856,1329
2 ,Aomori,over_85,1925,Taisho,14,454,125,329
2 ,Aomori,total,1930,Showa,5,879914,441441,438473
2 ,Aomori,0_ 4,1930,Showa,5,139364,70439,68925
2 ,Aomori,5_ 9,1930,Showa,5,119886,60531,59355
2 ,Aomori,10_ 14,1930,Showa,5,101461,50918,50543
2 ,Aomori,15_ 19,1930,Showa,5,89401,45303,44098
2 ,Aomori,20_ 24,1930,Showa,5,75051,38640,36411
2 ,Aomori,25_ 29,1930,Showa,5,62322,31483,30839
2 ,Aomori,30_ 34,1930,Showa,5,52687,26520,26167
2 ,Aomori,35_ 39,1930,Showa,5,47909,24327,23582
2 ,Aomori,40_ 44,1930,Showa,5,41830,20975,20855
2 ,Aomori,45_ 49,1930,Showa,5,38417,19076,19341
2 ,Aomori,50_ 54,1930,Showa,5,33658,16862,16796
2 ,Aomori,55_ 59,1930,Showa,5,25179,12407,12772
2 ,Aomori,60_ 64,1930,Showa,5,20244,9788,10456
2 ,Aomori,65_ 69,1930,Showa,5,13947,6603,7344
2 ,Aomori,70_ 74,1930,Showa,5,9666,4244,5422
2 ,Aomori,75_ 79,1930,Showa,5,5833,2245,3588
2 ,Aomori,over_80,1930,Showa,5,3059,1080,1979
2 ,Aomori,total,1935,Showa,10,967129,484277,482852
2 ,Aomori,0_ 4,1935,Showa,10,154619,78052,76567
2 ,Aomori,5_ 9,1935,Showa,10,131713,66600,65113
2 ,Aomori,10_ 14,1935,Showa,10,116363,58761,57602
2 ,Aomori,15_ 19,1935,Showa,10,91735,45790,45945
2 ,Aomori,20_ 24,1935,Showa,10,82126,41644,40482
2 ,Aomori,25_ 29,1935,Showa,10,69687,35009,34678
2 ,Aomori,30_ 34,1935,Showa,10,60147,30469,29678
2 ,Aomori,35_ 39,1935,Showa,10,50902,25781,25121
2 ,Aomori,40_ 44,1935,Showa,10,45716,23327,22389
2 ,Aomori,45_ 49,1935,Showa,10,39788,19892,19896
2 ,Aomori,50_ 54,1935,Showa,10,35959,17765,18194
2 ,Aomori,55_ 59,1935,Showa,10,30716,15143,15573
2 ,Aomori,60_ 64,1935,Showa,10,22079,10605,11474
2 ,Aomori,65_ 69,1935,Showa,10,16499,7639,8860
2 ,Aomori,70_ 74,1935,Showa,10,9952,4421,5531
2 ,Aomori,75_ 79,1935,Showa,10,5645,2214,3431
2 ,Aomori,over_80,1935,Showa,10,3483,1165,2318
2 ,Aomori,total,1940,Showa,15,1000372,496517,503855
2 ,Aomori,0_ 4,1940,Showa,15,145017,73579,71438
2 ,Aomori,5_ 9,1940,Showa,15,142362,71809,70553
2 ,Aomori,10_ 14,1940,Showa,15,125243,63447,61796
2 ,Aomori,15_ 19,1940,Showa,15,97870,47663,50207
2 ,Aomori,20_ 24,1940,Showa,15,77893,38840,39053
2 ,Aomori,25_ 29,1940,Showa,15,70855,34723,36132
2 ,Aomori,30_ 34,1940,Showa,15,63136,31126,32010
2 ,Aomori,35_ 39,1940,Showa,15,56035,27975,28060
2 ,Aomori,40_ 44,1940,Showa,15,47798,23974,23824
2 ,Aomori,45_ 49,1940,Showa,15,42839,21692,21147
2 ,Aomori,50_ 54,1940,Showa,15,36641,18154,18487
2 ,Aomori,55_ 59,1940,Showa,15,32092,15500,16592
2 ,Aomori,60_ 64,1940,Showa,15,26114,12386,13728
2 ,Aomori,65_ 69,1940,Showa,15,17074,7756,9318
2 ,Aomori,70_ 74,1940,Showa,15,10976,4701,6275
2 ,Aomori,75_ 79,1940,Showa,15,5461,2207,3254
2 ,Aomori,80_ 84,1940,Showa,15,2168,740,1428
2 ,Aomori,over_85,1940,Showa,15,791,243,548
2 ,Aomori,total,1945,Showa,20,1083250,511798,571452
2 ,Aomori,1_ 5,1945,Showa,20,152552,77155,75397
2 ,Aomori,6_ 10,1945,Showa,20,143369,72573,70796
2 ,Aomori,11_ 15,1945,Showa,20,145704,73448,72256
2 ,Aomori,16_ 20,1945,Showa,20,122498,59871,62627
2 ,Aomori,21_ 25,1945,Showa,20,81075,29967,51108
2 ,Aomori,26_ 30,1945,Showa,20,62928,22054,40874
2 ,Aomori,31_ 35,1945,Showa,20,65060,27623,37437
2 ,Aomori,36_ 40,1945,Showa,20,62469,29743,32726
2 ,Aomori,41_ 45,1945,Showa,20,55446,27666,27780
2 ,Aomori,46_ 50,1945,Showa,20,46999,23456,23543
2 ,Aomori,51_ 55,1945,Showa,20,40877,20654,20223
2 ,Aomori,56_ 60,1945,Showa,20,34408,16765,17643
2 ,Aomori,61_ 65,1945,Showa,20,27760,12971,14789
2 ,Aomori,66_ 70,1945,Showa,20,20708,9299,11409
2 ,Aomori,71_ 75,1945,Showa,20,12459,5213,7246
2 ,Aomori,76_ 80,1945,Showa,20,5926,2287,3639
2 ,Aomori,81_ 85,1945,Showa,20,2275,820,1455
2 ,Aomori,86以上,1945,Showa,20,737,233,504
2 ,Aomori,total,1950,Showa,25,1282867,635547,647320
2 ,Aomori,0_ 4,1950,Showa,25,196357,99886,96471
2 ,Aomori,5_ 9,1950,Showa,25,155546,78885,76661
2 ,Aomori,10_ 14,1950,Showa,25,146500,74341,72159
2 ,Aomori,15_ 19,1950,Showa,25,143960,72596,71364
2 ,Aomori,20_ 24,1950,Showa,25,120604,60322,60282
2 ,Aomori,25_ 29,1950,Showa,25,92548,43118,49430
2 ,Aomori,30_ 34,1950,Showa,25,76285,35388,40897
2 ,Aomori,35_ 39,1950,Showa,25,72744,35601,37143
2 ,Aomori,40_ 44,1950,Showa,25,63084,31585,31499
2 ,Aomori,45_ 49,1950,Showa,25,54519,27720,26799
2 ,Aomori,50_ 54,1950,Showa,25,44651,22498,22153
2 ,Aomori,55_ 59,1950,Showa,25,38388,19227,19161
2 ,Aomori,60_ 64,1950,Showa,25,30181,14361,15820
2 ,Aomori,65_ 69,1950,Showa,25,22227,9978,12249
2 ,Aomori,70_ 74,1950,Showa,25,14478,6084,8394
2 ,Aomori,75_ 79,1950,Showa,25,7073,2710,4363
2 ,Aomori,over_80,1950,Showa,25,3431,1109,2322
2 ,Aomori,total,1955,Showa,30,1382523,678837,703686
2 ,Aomori,0_ 4,1955,Showa,30,178332,91014,87318
2 ,Aomori,5_ 9,1955,Showa,30,191921,97707,94214
2 ,Aomori,10_ 14,1955,Showa,30,153923,77826,76097
2 ,Aomori,15_ 19,1955,Showa,30,137212,67994,69218
2 ,Aomori,20_ 24,1955,Showa,30,130707,62242,68465
2 ,Aomori,25_ 29,1955,Showa,30,113474,55546,57928
2 ,Aomori,30_ 34,1955,Showa,30,89813,41597,48216
2 ,Aomori,35_ 39,1955,Showa,30,73550,33991,39559
2 ,Aomori,40_ 44,1955,Showa,30,70080,34156,35924
2 ,Aomori,45_ 49,1955,Showa,30,60605,30042,30563
2 ,Aomori,50_ 54,1955,Showa,30,51600,25961,25639
2 ,Aomori,55_ 59,1955,Showa,30,41638,20689,20949
2 ,Aomori,60_ 64,1955,Showa,30,34217,16648,17569
2 ,Aomori,65_ 69,1955,Showa,30,25063,11485,13578
2 ,Aomori,70_ 74,1955,Showa,30,16558,6992,9566
2 ,Aomori,75_ 79,1955,Showa,30,9209,3468,5741
2 ,Aomori,80_ 84,1955,Showa,30,3503,1181,2322
2 ,Aomori,over_85,1955,Showa,30,1095,289,806
2 ,Aomori,total,1960,Showa,35,1426606,694037,732569
2 ,Aomori,0_ 4,1960,Showa,35,146482,74260,72222
2 ,Aomori,5_ 9,1960,Showa,35,176606,90079,86527
2 ,Aomori,10_ 14,1960,Showa,35,190309,96826,93483
2 ,Aomori,15_ 19,1960,Showa,35,130156,62881,67275
2 ,Aomori,20_ 24,1960,Showa,35,117131,54515,62616
2 ,Aomori,25_ 29,1960,Showa,35,123335,59237,64098
2 ,Aomori,30_ 34,1960,Showa,35,110085,53997,56088
2 ,Aomori,35_ 39,1960,Showa,35,87090,40128,46962
2 ,Aomori,40_ 44,1960,Showa,35,70986,32494,38492
2 ,Aomori,45_ 49,1960,Showa,35,67021,32292,34729
2 ,Aomori,50_ 54,1960,Showa,35,57342,28064,29278
2 ,Aomori,55_ 59,1960,Showa,35,48164,23816,24348
2 ,Aomori,60_ 64,1960,Showa,35,37528,18077,19451
2 ,Aomori,65_ 69,1960,Showa,35,28852,13436,15416
2 ,Aomori,70_ 74,1960,Showa,35,18868,8026,10842
2 ,Aomori,75_ 79,1960,Showa,35,10596,4033,6563
2 ,Aomori,80_ 84,1960,Showa,35,4555,1465,3090
2 ,Aomori,over_85,1960,Showa,35,1500,411,1089
2 ,Aomori,total,1965,Showa,40,1416591,682972,733619
2 ,Aomori,0_ 4,1965,Showa,40,130920,66989,63931
2 ,Aomori,5_ 9,1965,Showa,40,143525,72363,71162
2 ,Aomori,10_ 14,1965,Showa,40,172623,87721,84902
2 ,Aomori,15_ 19,1965,Showa,40,149800,73921,75879
2 ,Aomori,20_ 24,1965,Showa,40,101369,45576,55793
2 ,Aomori,25_ 29,1965,Showa,40,109281,51469,57812
2 ,Aomori,30_ 34,1965,Showa,40,118165,56893,61272
2 ,Aomori,35_ 39,1965,Showa,40,105733,51661,54072
2 ,Aomori,40_ 44,1965,Showa,40,83323,37906,45417
2 ,Aomori,45_ 49,1965,Showa,40,67378,30278,37100
2 ,Aomori,50_ 54,1965,Showa,40,63040,29845,33195
2 ,Aomori,55_ 59,1965,Showa,40,53124,25520,27604
2 ,Aomori,60_ 64,1965,Showa,40,43308,20740,22568
2 ,Aomori,65_ 69,1965,Showa,40,31964,14775,17189
2 ,Aomori,70_ 74,1965,Showa,40,22603,9965,12638
2 ,Aomori,75_ 79,1965,Showa,40,12612,4914,7698
2 ,Aomori,80_ 84,1965,Showa,40,5571,1813,3758
2 ,Aomori,over_85,1965,Showa,40,2252,623,1629
2 ,Aomori,total,1970,Showa,45,1427520,685477,742043
2 ,Aomori,0_ 4,1970,Showa,45,123352,63034,60318
2 ,Aomori,5_ 9,1970,Showa,45,131260,67205,64055
2 ,Aomori,10_ 14,1970,Showa,45,142271,71632,70639
2 ,Aomori,15_ 19,1970,Showa,45,136695,67744,68951
2 ,Aomori,20_ 24,1970,Showa,45,121345,56007,65338
2 ,Aomori,25_ 29,1970,Showa,45,102136,48040,54096
2 ,Aomori,30_ 34,1970,Showa,45,108495,51558,56937
2 ,Aomori,35_ 39,1970,Showa,45,115909,55894,60015
2 ,Aomori,40_ 44,1970,Showa,45,102263,49999,52264
2 ,Aomori,45_ 49,1970,Showa,45,80768,36558,44210
2 ,Aomori,50_ 54,1970,Showa,45,64779,29050,35729
2 ,Aomori,55_ 59,1970,Showa,45,59068,27609,31459
2 ,Aomori,60_ 64,1970,Showa,45,48777,22729,26048
2 ,Aomori,65_ 69,1970,Showa,45,38274,17592,20682
2 ,Aomori,70_ 74,1970,Showa,45,26175,11267,14908
2 ,Aomori,75_ 79,1970,Showa,45,15845,6328,9517
2 ,Aomori,80_ 84,1970,Showa,45,7185,2419,4766
2 ,Aomori,over_85,1970,Showa,45,2923,812,2111
2 ,Aomori,total,1975,Showa,50,1468646,707232,761414
2 ,Aomori,0_ 4,1975,Showa,50,124365,63327,61038
2 ,Aomori,5_ 9,1975,Showa,50,124903,63929,60974
2 ,Aomori,10_ 14,1975,Showa,50,130950,66993,63957
2 ,Aomori,15_ 19,1975,Showa,50,119219,59365,59854
2 ,Aomori,20_ 24,1975,Showa,50,110191,52172,58019
2 ,Aomori,25_ 29,1975,Showa,50,126199,61862,64337
2 ,Aomori,30_ 34,1975,Showa,50,104367,49970,54397
2 ,Aomori,35_ 39,1975,Showa,50,107838,51408,56430
2 ,Aomori,40_ 44,1975,Showa,50,114170,55046,59124
2 ,Aomori,45_ 49,1975,Showa,50,100141,48700,51441
2 ,Aomori,50_ 54,1975,Showa,50,77458,34764,42694
2 ,Aomori,55_ 59,1975,Showa,50,61613,27147,34466
2 ,Aomori,60_ 64,1975,Showa,50,56345,25836,30509
2 ,Aomori,65_ 69,1975,Showa,50,44675,20158,24517
2 ,Aomori,70_ 74,1975,Showa,50,32535,14018,18517
2 ,Aomori,75_ 79,1975,Showa,50,19750,7818,11932
2 ,Aomori,80_ 84,1975,Showa,50,9758,3500,6258
2 ,Aomori,over_85,1975,Showa,50,4034,1149,2885
2 ,Aomori,total,1980,Showa,55,1523907,735444,788463
2 ,Aomori,0_ 4,1980,Showa,55,112171,57449,54722
2 ,Aomori,5_ 9,1980,Showa,55,128051,65182,62869
2 ,Aomori,10_ 14,1980,Showa,55,126232,64564,61668
2 ,Aomori,15_ 19,1980,Showa,55,116892,59243,57649
2 ,Aomori,20_ 24,1980,Showa,55,99932,48056,51876
2 ,Aomori,25_ 29,1980,Showa,55,119729,58793,60936
2 ,Aomori,30_ 34,1980,Showa,55,130230,64790,65440
2 ,Aomori,35_ 39,1980,Showa,55,105728,50918,54810
2 ,Aomori,40_ 44,1980,Showa,55,107093,51189,55904
2 ,Aomori,45_ 49,1980,Showa,55,111534,53376,58158
2 ,Aomori,50_ 54,1980,Showa,55,97465,46876,50589
2 ,Aomori,55_ 59,1980,Showa,55,75058,33229,41829
2 ,Aomori,60_ 64,1980,Showa,55,59125,25678,33447
2 ,Aomori,65_ 69,1980,Showa,55,51880,23226,28654
2 ,Aomori,70_ 74,1980,Showa,55,38815,16621,22194
2 ,Aomori,75_ 79,1980,Showa,55,25245,9994,15251
2 ,Aomori,80_ 84,1980,Showa,55,12780,4452,8328
2 ,Aomori,over_85,1980,Showa,55,5796,1714,4082
2 ,Aomori,total,1985,Showa,60,1524448,731439,793009
2 ,Aomori,0_ 4,1985,Showa,60,98778,50740,48038
2 ,Aomori,5_ 9,1985,Showa,60,112465,57670,54795
2 ,Aomori,10_ 14,1985,Showa,60,127311,64759,62552
2 ,Aomori,15_ 19,1985,Showa,60,111294,56297,54997
2 ,Aomori,20_ 24,1985,Showa,60,90408,43594,46814
2 ,Aomori,25_ 29,1985,Showa,60,100590,48763,51827
2 ,Aomori,30_ 34,1985,Showa,60,118712,58340,60372
2 ,Aomori,35_ 39,1985,Showa,60,128121,63307,64814
2 ,Aomori,40_ 44,1985,Showa,60,102523,48960,53563
2 ,Aomori,45_ 49,1985,Showa,60,103021,48609,54412
2 ,Aomori,50_ 54,1985,Showa,60,107269,50613,56656
2 ,Aomori,55_ 59,1985,Showa,60,93343,44208,49135
2 ,Aomori,60_ 64,1985,Showa,60,72048,31485,40563
2 ,Aomori,65_ 69,1985,Showa,60,55164,23330,31834
2 ,Aomori,70_ 74,1985,Showa,60,46220,19731,26489
2 ,Aomori,75_ 79,1985,Showa,60,31417,12361,19056
2 ,Aomori,80_ 84,1985,Showa,60,17135,6159,10976
2 ,Aomori,over_85,1985,Showa,60,8611,2502,6109
2 ,Aomori,total,1990,Heisei,2,1482873,704758,778115
2 ,Aomori,0_ 4,1990,Heisei,2,80368,41102,39266
2 ,Aomori,5_ 9,1990,Heisei,2,97852,50223,47629
2 ,Aomori,10_ 14,1990,Heisei,2,110862,56829,54033
2 ,Aomori,15_ 19,1990,Heisei,2,110529,55680,54849
2 ,Aomori,20_ 24,1990,Heisei,2,79813,38742,41071
2 ,Aomori,25_ 29,1990,Heisei,2,86833,41638,45195
2 ,Aomori,30_ 34,1990,Heisei,2,97415,46985,50430
2 ,Aomori,35_ 39,1990,Heisei,2,115269,56148,59121
2 ,Aomori,40_ 44,1990,Heisei,2,123320,60262,63058
2 ,Aomori,45_ 49,1990,Heisei,2,97683,45981,51702
2 ,Aomori,50_ 54,1990,Heisei,2,98133,45523,52610
2 ,Aomori,55_ 59,1990,Heisei,2,102354,47256,55098
2 ,Aomori,60_ 64,1990,Heisei,2,89455,41551,47904
2 ,Aomori,65_ 69,1990,Heisei,2,68035,28835,39200
2 ,Aomori,70_ 74,1990,Heisei,2,50050,20227,29823
2 ,Aomori,75_ 79,1990,Heisei,2,38500,15249,23251
2 ,Aomori,80_ 84,1990,Heisei,2,22558,7981,14577
2 ,Aomori,over_85,1990,Heisei,2,12633,3799,8834
2 ,Aomori,total,1995,Heisei,7,1481663,704189,777474
2 ,Aomori,0_ 4,1995,Heisei,7,72195,36776,35419
2 ,Aomori,5_ 9,1995,Heisei,7,82433,42037,40396
2 ,Aomori,10_ 14,1995,Heisei,7,97786,50125,47661
2 ,Aomori,15_ 19,1995,Heisei,7,101529,51707,49822
2 ,Aomori,20_ 24,1995,Heisei,7,89199,44932,44267
2 ,Aomori,25_ 29,1995,Heisei,7,83845,40822,43023
2 ,Aomori,30_ 34,1995,Heisei,7,89994,43910,46084
2 ,Aomori,35_ 39,1995,Heisei,7,98625,47998,50627
2 ,Aomori,40_ 44,1995,Heisei,7,114908,56383,58525
2 ,Aomori,45_ 49,1995,Heisei,7,121605,59549,62056
2 ,Aomori,50_ 54,1995,Heisei,7,95745,44740,51005
2 ,Aomori,55_ 59,1995,Heisei,7,95826,43968,51858
2 ,Aomori,60_ 64,1995,Heisei,7,100035,45652,54383
2 ,Aomori,65_ 69,1995,Heisei,7,85455,38758,46697
2 ,Aomori,70_ 74,1995,Heisei,7,62394,25340,37054
2 ,Aomori,75_ 79,1995,Heisei,7,42512,15770,26742
2 ,Aomori,80_ 84,1995,Heisei,7,28427,9919,18508
2 ,Aomori,over_85,1995,Heisei,7,17957,5063,12894
2 ,Aomori,total,2000,Heisei,12,1475728,702573,773155
2 ,Aomori,0_ 4,2000,Heisei,12,66182,33727,32455
2 ,Aomori,5_ 9,2000,Heisei,12,74333,37838,36495
2 ,Aomori,10_ 14,2000,Heisei,12,82626,42110,40516
2 ,Aomori,15_ 19,2000,Heisei,12,90446,46338,44108
2 ,Aomori,20_ 24,2000,Heisei,12,83011,42560,40451
2 ,Aomori,25_ 29,2000,Heisei,12,90363,45332,45031
2 ,Aomori,30_ 34,2000,Heisei,12,87273,42977,44296
2 ,Aomori,35_ 39,2000,Heisei,12,91897,45177,46720
2 ,Aomori,40_ 44,2000,Heisei,12,98801,48425,50376
2 ,Aomori,45_ 49,2000,Heisei,12,114017,56186,57831
2 ,Aomori,50_ 54,2000,Heisei,12,119930,58701,61229
2 ,Aomori,55_ 59,2000,Heisei,12,94161,43731,50430
2 ,Aomori,60_ 64,2000,Heisei,12,94762,43210,51552
2 ,Aomori,65_ 69,2000,Heisei,12,96613,43422,53191
2 ,Aomori,70_ 74,2000,Heisei,12,78886,34316,44570
2 ,Aomori,75_ 79,2000,Heisei,12,54005,20409,33596
2 ,Aomori,80_ 84,2000,Heisei,12,32547,10749,21798
2 ,Aomori,over_85,2000,Heisei,12,25048,6887,18161
2 ,Aomori,total,2005,Heisei,17,1436657,679077,757580
2 ,Aomori,0_ 4,2005,Heisei,17,58032,29521,28511
2 ,Aomori,5_ 9,2005,Heisei,17,66901,34216,32685
2 ,Aomori,10_ 14,2005,Heisei,17,74026,37648,36378
2 ,Aomori,15_ 19,2005,Heisei,17,76025,38769,37256
2 ,Aomori,20_ 24,2005,Heisei,17,71705,36292,35413
2 ,Aomori,25_ 29,2005,Heisei,17,79639,40124,39515
2 ,Aomori,30_ 34,2005,Heisei,17,89863,44797,45066
2 ,Aomori,35_ 39,2005,Heisei,17,86530,42307,44223
2 ,Aomori,40_ 44,2005,Heisei,17,90621,44364,46257
2 ,Aomori,45_ 49,2005,Heisei,17,96704,46966,49738
2 ,Aomori,50_ 54,2005,Heisei,17,110894,54034,56860
2 ,Aomori,55_ 59,2005,Heisei,17,116476,56266,60210
2 ,Aomori,60_ 64,2005,Heisei,17,92399,42489,49910
2 ,Aomori,65_ 69,2005,Heisei,17,90975,40922,50053
2 ,Aomori,70_ 74,2005,Heisei,17,89676,38829,50847
2 ,Aomori,75_ 79,2005,Heisei,17,69229,28137,41092
2 ,Aomori,80_ 84,2005,Heisei,17,43308,14613,28695
2 ,Aomori,over_85,2005,Heisei,17,33374,8571,24803
2 ,Aomori,total,2010,Heisei,22,1373339,646141,727198
2 ,Aomori,0_ 4,2010,Heisei,22,48461,24618,23843
2 ,Aomori,5_ 9,2010,Heisei,22,57358,29270,28088
2 ,Aomori,10_ 14,2010,Heisei,22,66023,33697,32326
2 ,Aomori,15_ 19,2010,Heisei,22,67308,34303,33005
2 ,Aomori,20_ 24,2010,Heisei,22,56205,28329,27876
2 ,Aomori,25_ 29,2010,Heisei,22,65738,33175,32563
2 ,Aomori,30_ 34,2010,Heisei,22,77699,39124,38575
2 ,Aomori,35_ 39,2010,Heisei,22,88118,43825,44293
2 ,Aomori,40_ 44,2010,Heisei,22,85099,41593,43506
2 ,Aomori,45_ 49,2010,Heisei,22,88299,43032,45267
2 ,Aomori,50_ 54,2010,Heisei,22,94027,45375,48652
2 ,Aomori,55_ 59,2010,Heisei,22,107612,51844,55768
2 ,Aomori,60_ 64,2010,Heisei,22,113482,54288,59194
2 ,Aomori,65_ 69,2010,Heisei,22,88421,39992,48429
2 ,Aomori,70_ 74,2010,Heisei,22,84694,36738,47956
2 ,Aomori,75_ 79,2010,Heisei,22,79301,32240,47061
2 ,Aomori,80_ 84,2010,Heisei,22,55704,20233,35471
2 ,Aomori,over_85,2010,Heisei,22,44648,11433,33215
2 ,Aomori,total,2015,Heisei,27,1308265,614694,693571
2 ,Aomori,0_ 4,2015,Heisei,27,42943,21983,20960
2 ,Aomori,5_ 9,2015,Heisei,27,48296,24551,23745
2 ,Aomori,10_ 14,2015,Heisei,27,56969,29127,27842
2 ,Aomori,15_ 19,2015,Heisei,27,60960,31176,29784
2 ,Aomori,20_ 24,2015,Heisei,27,50486,25928,24558
2 ,Aomori,25_ 29,2015,Heisei,27,53303,27101,26202
2 ,Aomori,30_ 34,2015,Heisei,27,65011,32674,32337
2 ,Aomori,35_ 39,2015,Heisei,27,76138,38168,37970
2 ,Aomori,40_ 44,2015,Heisei,27,86583,42830,43753
2 ,Aomori,45_ 49,2015,Heisei,27,83018,40358,42660
2 ,Aomori,50_ 54,2015,Heisei,27,86140,41830,44310
2 ,Aomori,55_ 59,2015,Heisei,27,91592,43800,47792
2 ,Aomori,60_ 64,2015,Heisei,27,104636,49931,54705
2 ,Aomori,65_ 69,2015,Heisei,27,108925,51459,57466
2 ,Aomori,70_ 74,2015,Heisei,27,82671,36303,46368
2 ,Aomori,75_ 79,2015,Heisei,27,75431,31045,44386
2 ,Aomori,80_ 84,2015,Heisei,27,65066,24011,41055
2 ,Aomori,over_85,2015,Heisei,27,58847,16019,42828
3 ,Iwate,total,1920,Taisho,9,845540,421069,424471
3 ,Iwate,0_ 4,1920,Taisho,9,124419,62684,61735
3 ,Iwate,5_ 9,1920,Taisho,9,106416,54204,52212
3 ,Iwate,10_ 14,1920,Taisho,9,90905,46071,44834
3 ,Iwate,15_ 19,1920,Taisho,9,77633,39182,38451
3 ,Iwate,20_ 24,1920,Taisho,9,63023,30388,32635
3 ,Iwate,25_ 29,1920,Taisho,9,56470,28096,28374
3 ,Iwate,30_ 34,1920,Taisho,9,54597,26666,27931
3 ,Iwate,35_ 39,1920,Taisho,9,51781,25706,26075
3 ,Iwate,40_ 44,1920,Taisho,9,46056,22961,23095
3 ,Iwate,45_ 49,1920,Taisho,9,36819,18405,18414
3 ,Iwate,50_ 54,1920,Taisho,9,31679,15918,15761
3 ,Iwate,55_ 59,1920,Taisho,9,27927,13842,14085
3 ,Iwate,60_ 64,1920,Taisho,9,25472,12463,13009
3 ,Iwate,65_ 69,1920,Taisho,9,22802,10969,11833
3 ,Iwate,70_ 74,1920,Taisho,9,16213,7642,8571
3 ,Iwate,75_ 79,1920,Taisho,9,9350,4257,5093
3 ,Iwate,over_80,1920,Taisho,9,3978,1615,2363
3 ,Iwate,total,1925,Taisho,14,900984,448637,452347
3 ,Iwate,0_ 4,1925,Taisho,14,138066,69907,68159
3 ,Iwate,5_ 9,1925,Taisho,14,113979,57489,56490
3 ,Iwate,10_ 14,1925,Taisho,14,102051,52007,50044
3 ,Iwate,15_ 19,1925,Taisho,14,81731,40949,40782
3 ,Iwate,20_ 24,1925,Taisho,14,69254,33870,35384
3 ,Iwate,25_ 29,1925,Taisho,14,60780,30077,30703
3 ,Iwate,30_ 34,1925,Taisho,14,53809,27020,26789
3 ,Iwate,35_ 39,1925,Taisho,14,52248,25812,26436
3 ,Iwate,40_ 44,1925,Taisho,14,49188,24573,24615
3 ,Iwate,45_ 49,1925,Taisho,14,43374,21575,21799
3 ,Iwate,50_ 54,1925,Taisho,14,33921,16857,17064
3 ,Iwate,55_ 59,1925,Taisho,14,28227,13974,14253
3 ,Iwate,60_ 64,1925,Taisho,14,24025,11520,12505
3 ,Iwate,65_ 69,1925,Taisho,14,20086,9535,10551
3 ,Iwate,70_ 74,1925,Taisho,14,15788,7264,8524
3 ,Iwate,75_ 79,1925,Taisho,14,9336,4132,5204
3 ,Iwate,80_ 84,1925,Taisho,14,4111,1696,2415
3 ,Iwate,over_85,1925,Taisho,14,1010,380,630
3 ,Iwate,total,1930,Showa,5,975771,486925,488846
3 ,Iwate,0_ 4,1930,Showa,5,150943,76179,74764
3 ,Iwate,5_ 9,1930,Showa,5,128715,65364,63351
3 ,Iwate,10_ 14,1930,Showa,5,109656,55379,54277
3 ,Iwate,15_ 19,1930,Showa,5,92872,47079,45793
3 ,Iwate,20_ 24,1930,Showa,5,74347,36684,37663
3 ,Iwate,25_ 29,1930,Showa,5,67097,33743,33354
3 ,Iwate,30_ 34,1930,Showa,5,58616,29431,29185
3 ,Iwate,35_ 39,1930,Showa,5,52337,26444,25893
3 ,Iwate,40_ 44,1930,Showa,5,49891,24838,25053
3 ,Iwate,45_ 49,1930,Showa,5,46501,23163,23338
3 ,Iwate,50_ 54,1930,Showa,5,40433,20011,20422
3 ,Iwate,55_ 59,1930,Showa,5,30755,15039,15716
3 ,Iwate,60_ 64,1930,Showa,5,24403,11690,12713
3 ,Iwate,65_ 69,1930,Showa,5,19269,8933,10336
3 ,Iwate,70_ 74,1930,Showa,5,14341,6457,7884
3 ,Iwate,75_ 79,1930,Showa,5,9625,4138,5487
3 ,Iwate,over_80,1930,Showa,5,5970,2353,3617
3 ,Iwate,total,1935,Showa,10,1046111,519485,526626
3 ,Iwate,0_ 4,1935,Showa,10,158711,80265,78446
3 ,Iwate,5_ 9,1935,Showa,10,141837,71480,70357
3 ,Iwate,10_ 14,1935,Showa,10,123819,63022,60797
3 ,Iwate,15_ 19,1935,Showa,10,96994,48309,48685
3 ,Iwate,20_ 24,1935,Showa,10,81459,39015,42444
3 ,Iwate,25_ 29,1935,Showa,10,71081,35166,35915
3 ,Iwate,30_ 34,1935,Showa,10,64617,32377,32240
3 ,Iwate,35_ 39,1935,Showa,10,56303,28379,27924
3 ,Iwate,40_ 44,1935,Showa,10,49502,25104,24398
3 ,Iwate,45_ 49,1935,Showa,10,47087,23332,23755
3 ,Iwate,50_ 54,1935,Showa,10,43137,21293,21844
3 ,Iwate,55_ 59,1935,Showa,10,36609,17817,18792
3 ,Iwate,60_ 64,1935,Showa,10,26650,12696,13954
3 ,Iwate,65_ 69,1935,Showa,10,19440,8972,10468
3 ,Iwate,70_ 74,1935,Showa,10,13970,6175,7795
3 ,Iwate,75_ 79,1935,Showa,10,8680,3684,4996
3 ,Iwate,over_80,1935,Showa,10,6215,2399,3816
3 ,Iwate,total,1940,Showa,15,1095671,544185,551486
3 ,Iwate,0_ 4,1940,Showa,15,156612,79659,76953
3 ,Iwate,5_ 9,1940,Showa,15,147987,74955,73032
3 ,Iwate,10_ 14,1940,Showa,15,135475,68439,67036
3 ,Iwate,15_ 19,1940,Showa,15,103295,51050,52245
3 ,Iwate,20_ 24,1940,Showa,15,86375,43323,43052
3 ,Iwate,25_ 29,1940,Showa,15,76064,37309,38755
3 ,Iwate,30_ 34,1940,Showa,15,66646,32712,33934
3 ,Iwate,35_ 39,1940,Showa,15,61377,30495,30882
3 ,Iwate,40_ 44,1940,Showa,15,53279,26648,26631
3 ,Iwate,45_ 49,1940,Showa,15,46465,23450,23015
3 ,Iwate,50_ 54,1940,Showa,15,43410,21230,22180
3 ,Iwate,55_ 59,1940,Showa,15,38817,18889,19928
3 ,Iwate,60_ 64,1940,Showa,15,31351,14861,16490
3 ,Iwate,65_ 69,1940,Showa,15,21231,9741,11490
3 ,Iwate,70_ 74,1940,Showa,15,13577,5937,7640
3 ,Iwate,75_ 79,1940,Showa,15,8286,3445,4841
3 ,Iwate,80_ 84,1940,Showa,15,3799,1479,2320
3 ,Iwate,over_85,1940,Showa,15,1614,554,1060
3 ,Iwate,total,1945,Showa,20,1227789,579741,648048
3 ,Iwate,1_ 5,1945,Showa,20,168199,85274,82925
3 ,Iwate,6_ 10,1945,Showa,20,161837,82261,79576
3 ,Iwate,11_ 15,1945,Showa,20,157675,79696,77979
3 ,Iwate,16_ 20,1945,Showa,20,136175,66456,69719
3 ,Iwate,21_ 25,1945,Showa,20,91647,33403,58244
3 ,Iwate,26_ 30,1945,Showa,20,73967,26462,47505
3 ,Iwate,31_ 35,1945,Showa,20,72807,30565,42242
3 ,Iwate,36_ 40,1945,Showa,20,69507,32838,36669
3 ,Iwate,41_ 45,1945,Showa,20,63047,31430,31617
3 ,Iwate,46_ 50,1945,Showa,20,54551,27388,27163
3 ,Iwate,51_ 55,1945,Showa,20,46492,23450,23042
3 ,Iwate,56_ 60,1945,Showa,20,41540,20210,21330
3 ,Iwate,61_ 65,1945,Showa,20,34812,16353,18459
3 ,Iwate,66_ 70,1945,Showa,20,26327,11903,14424
3 ,Iwate,71_ 75,1945,Showa,20,16366,7085,9281
3 ,Iwate,76_ 80,1945,Showa,20,7767,3104,4663
3 ,Iwate,81_ 85,1945,Showa,20,3772,1423,2349
3 ,Iwate,86以上,1945,Showa,20,1301,440,861
3 ,Iwate,total,1950,Showa,25,1346728,664000,682728
3 ,Iwate,0_ 4,1950,Showa,25,192553,97877,94676
3 ,Iwate,5_ 9,1950,Showa,25,160559,81249,79310
3 ,Iwate,10_ 14,1950,Showa,25,155613,79326,76287
3 ,Iwate,15_ 19,1950,Showa,25,146002,73993,72009
3 ,Iwate,20_ 24,1950,Showa,25,124931,61483,63448
3 ,Iwate,25_ 29,1950,Showa,25,96842,44299,52543
3 ,Iwate,30_ 34,1950,Showa,25,81491,37119,44372
3 ,Iwate,35_ 39,1950,Showa,25,76490,36808,39682
3 ,Iwate,40_ 44,1950,Showa,25,66410,32917,33493
3 ,Iwate,45_ 49,1950,Showa,25,59468,30106,29362
3 ,Iwate,50_ 54,1950,Showa,25,49618,25115,24503
3 ,Iwate,55_ 59,1950,Showa,25,41597,20866,20731
3 ,Iwate,60_ 64,1950,Showa,25,35616,16933,18683
3 ,Iwate,65_ 69,1950,Showa,25,27253,12469,14784
3 ,Iwate,70_ 74,1950,Showa,25,17952,7811,10141
3 ,Iwate,75_ 79,1950,Showa,25,9280,3779,5501
3 ,Iwate,over_80,1950,Showa,25,4981,1825,3156
3 ,Iwate,total,1955,Showa,30,1427097,698563,728534
3 ,Iwate,0_ 4,1955,Showa,30,178007,90587,87420
3 ,Iwate,5_ 9,1955,Showa,30,186704,95014,91690
3 ,Iwate,10_ 14,1955,Showa,30,158081,80128,77953
3 ,Iwate,15_ 19,1955,Showa,30,140101,69281,70820
3 ,Iwate,20_ 24,1955,Showa,30,127877,60811,67066
3 ,Iwate,25_ 29,1955,Showa,30,118746,58049,60697
3 ,Iwate,30_ 34,1955,Showa,30,93691,42725,50966
3 ,Iwate,35_ 39,1955,Showa,30,78597,35697,42900
3 ,Iwate,40_ 44,1955,Showa,30,73820,35380,38440
3 ,Iwate,45_ 49,1955,Showa,30,63679,31395,32284
3 ,Iwate,50_ 54,1955,Showa,30,56179,28233,27946
3 ,Iwate,55_ 59,1955,Showa,30,46247,23099,23148
3 ,Iwate,60_ 64,1955,Showa,30,36979,18256,18723
3 ,Iwate,65_ 69,1955,Showa,30,29525,13640,15885
3 ,Iwate,70_ 74,1955,Showa,30,20644,9108,11536
3 ,Iwate,75_ 79,1955,Showa,30,11651,4772,6879
3 ,Iwate,80_ 84,1955,Showa,30,4833,1803,3030
3 ,Iwate,over_85,1955,Showa,30,1725,580,1145
3 ,Iwate,total,1960,Showa,35,1448517,702697,745820
3 ,Iwate,0_ 4,1960,Showa,35,140650,71589,69061
3 ,Iwate,5_ 9,1960,Showa,35,175900,89441,86459
3 ,Iwate,10_ 14,1960,Showa,35,185232,94267,90965
3 ,Iwate,15_ 19,1960,Showa,35,125412,60261,65151
3 ,Iwate,20_ 24,1960,Showa,35,113912,52166,61746
3 ,Iwate,25_ 29,1960,Showa,35,120717,57373,63344
3 ,Iwate,30_ 34,1960,Showa,35,115981,56980,59001
3 ,Iwate,35_ 39,1960,Showa,35,91793,41923,49870
3 ,Iwate,40_ 44,1960,Showa,35,76585,34812,41773
3 ,Iwate,45_ 49,1960,Showa,35,71068,33980,37088
3 ,Iwate,50_ 54,1960,Showa,35,60658,29775,30883
3 ,Iwate,55_ 59,1960,Showa,35,52595,26134,26461
3 ,Iwate,60_ 64,1960,Showa,35,41771,20421,21350
3 ,Iwate,65_ 69,1960,Showa,35,31495,14983,16512
3 ,Iwate,70_ 74,1960,Showa,35,22741,10029,12712
3 ,Iwate,75_ 79,1960,Showa,35,13582,5609,7973
3 ,Iwate,80_ 84,1960,Showa,35,6119,2202,3917
3 ,Iwate,over_85,1960,Showa,35,2306,752,1554
3 ,Iwate,total,1965,Showa,40,1411118,679497,731621
3 ,Iwate,0_ 4,1965,Showa,40,120557,61724,58833
3 ,Iwate,5_ 9,1965,Showa,40,137130,69701,67429
3 ,Iwate,10_ 14,1965,Showa,40,171834,87334,84500
3 ,Iwate,15_ 19,1965,Showa,40,140517,70288,70229
3 ,Iwate,20_ 24,1965,Showa,40,92540,40871,51669
3 ,Iwate,25_ 29,1965,Showa,40,104347,48122,56225
3 ,Iwate,30_ 34,1965,Showa,40,114906,54794,60112
3 ,Iwate,35_ 39,1965,Showa,40,111448,54338,57110
3 ,Iwate,40_ 44,1965,Showa,40,88115,39873,48242
3 ,Iwate,45_ 49,1965,Showa,40,73016,32752,40264
3 ,Iwate,50_ 54,1965,Showa,40,67030,31688,35342
3 ,Iwate,55_ 59,1965,Showa,40,56180,27147,29033
3 ,Iwate,60_ 64,1965,Showa,40,47451,22973,24478
3 ,Iwate,65_ 69,1965,Showa,40,35830,16886,18944
3 ,Iwate,70_ 74,1965,Showa,40,24641,11139,13502
3 ,Iwate,75_ 79,1965,Showa,40,15380,6312,9068
3 ,Iwate,80_ 84,1965,Showa,40,7109,2617,4492
3 ,Iwate,over_85,1965,Showa,40,3087,938,2149
3 ,Iwate,total,1970,Showa,45,1371383,658458,712925
3 ,Iwate,0_ 4,1970,Showa,45,108151,55493,52658
3 ,Iwate,5_ 9,1970,Showa,45,119296,61074,58222
3 ,Iwate,10_ 14,1970,Showa,45,134671,68318,66353
3 ,Iwate,15_ 19,1970,Showa,45,126625,63738,62887
3 ,Iwate,20_ 24,1970,Showa,45,102261,47392,54869
3 ,Iwate,25_ 29,1970,Showa,45,92157,42918,49239
3 ,Iwate,30_ 34,1970,Showa,45,102616,48271,54345
3 ,Iwate,35_ 39,1970,Showa,45,111771,53454,58317
3 ,Iwate,40_ 44,1970,Showa,45,105899,51494,54405
3 ,Iwate,45_ 49,1970,Showa,45,84694,38028,46666
3 ,Iwate,50_ 54,1970,Showa,45,69485,30955,38530
3 ,Iwate,55_ 59,1970,Showa,45,61661,28769,32892
3 ,Iwate,60_ 64,1970,Showa,45,51626,24301,27325
3 ,Iwate,65_ 69,1970,Showa,45,41600,19395,22205
3 ,Iwate,70_ 74,1970,Showa,45,29193,13125,16068
3 ,Iwate,75_ 79,1970,Showa,45,17358,7308,10050
3 ,Iwate,80_ 84,1970,Showa,45,8717,3249,5468
3 ,Iwate,over_85,1970,Showa,45,3602,1176,2426
3 ,Iwate,total,1975,Showa,50,1385563,668193,717370
3 ,Iwate,0_ 4,1975,Showa,50,110259,56409,53850
3 ,Iwate,5_ 9,1975,Showa,50,109469,56214,53255
3 ,Iwate,10_ 14,1975,Showa,50,118646,60765,57881
3 ,Iwate,15_ 19,1975,Showa,50,106822,54362,52460
3 ,Iwate,20_ 24,1975,Showa,50,93129,44583,48546
3 ,Iwate,25_ 29,1975,Showa,50,108895,53651,55244
3 ,Iwate,30_ 34,1975,Showa,50,95086,45745,49341
3 ,Iwate,35_ 39,1975,Showa,50,102348,48492,53856
3 ,Iwate,40_ 44,1975,Showa,50,110500,52845,57655
3 ,Iwate,45_ 49,1975,Showa,50,104985,50994,53991
3 ,Iwate,50_ 54,1975,Showa,50,81615,36544,45071
3 ,Iwate,55_ 59,1975,Showa,50,66250,29177,37073
3 ,Iwate,60_ 64,1975,Showa,50,59044,27077,31967
3 ,Iwate,65_ 69,1975,Showa,50,46603,21279,25324
3 ,Iwate,70_ 74,1975,Showa,50,35053,15521,19532
3 ,Iwate,75_ 79,1975,Showa,50,21308,8863,12445
3 ,Iwate,80_ 84,1975,Showa,50,10627,4034,6593
3 ,Iwate,over_85,1975,Showa,50,4806,1565,3241
3 ,Iwate,total,1980,Showa,55,1421927,688460,733467
3 ,Iwate,0_ 4,1980,Showa,55,102771,52658,50113
3 ,Iwate,5_ 9,1980,Showa,55,113133,57897,55236
3 ,Iwate,10_ 14,1980,Showa,55,110110,56465,53645
3 ,Iwate,15_ 19,1980,Showa,55,101109,52299,48810
3 ,Iwate,20_ 24,1980,Showa,55,82506,40987,41519
3 ,Iwate,25_ 29,1980,Showa,55,105870,52649,53221
3 ,Iwate,30_ 34,1980,Showa,55,112943,57014,55929
3 ,Iwate,35_ 39,1980,Showa,55,96210,46459,49751
3 ,Iwate,40_ 44,1980,Showa,55,101462,48050,53412
3 ,Iwate,45_ 49,1980,Showa,55,108170,51393,56777
3 ,Iwate,50_ 54,1980,Showa,55,102075,49076,52999
3 ,Iwate,55_ 59,1980,Showa,55,78782,34835,43947
3 ,Iwate,60_ 64,1980,Showa,55,63261,27491,35770
3 ,Iwate,65_ 69,1980,Showa,55,54484,24404,30080
3 ,Iwate,70_ 74,1980,Showa,55,40712,17801,22911
3 ,Iwate,75_ 79,1980,Showa,55,27439,11414,16025
3 ,Iwate,80_ 84,1980,Showa,55,14047,5251,8796
3 ,Iwate,over_85,1980,Showa,55,6718,2230,4488
3 ,Iwate,total,1985,Showa,60,1433611,691740,741871
3 ,Iwate,0_ 4,1985,Showa,60,90872,46496,44376
3 ,Iwate,5_ 9,1985,Showa,60,103755,53055,50700
3 ,Iwate,10_ 14,1985,Showa,60,113173,57957,55216
3 ,Iwate,15_ 19,1985,Showa,60,95965,49177,46788
3 ,Iwate,20_ 24,1985,Showa,60,76119,37865,38254
3 ,Iwate,25_ 29,1985,Showa,60,89716,44532,45184
3 ,Iwate,30_ 34,1985,Showa,60,107283,53883,53400
3 ,Iwate,35_ 39,1985,Showa,60,112506,56722,55784
3 ,Iwate,40_ 44,1985,Showa,60,94687,45545,49142
3 ,Iwate,45_ 49,1985,Showa,60,99263,46634,52629
3 ,Iwate,50_ 54,1985,Showa,60,105306,49544,55762
3 ,Iwate,55_ 59,1985,Showa,60,98742,46969,51773
3 ,Iwate,60_ 64,1985,Showa,60,75838,33080,42758
3 ,Iwate,65_ 69,1985,Showa,60,59347,25221,34126
3 ,Iwate,70_ 74,1985,Showa,60,48609,20982,27627
3 ,Iwate,75_ 79,1985,Showa,60,33332,13600,19732
3 ,Iwate,80_ 84,1985,Showa,60,19121,7205,11916
3 ,Iwate,over_85,1985,Showa,60,9977,3273,6704
3 ,Iwate,total,1990,Heisei,2,1416928,680197,736731
3 ,Iwate,0_ 4,1990,Heisei,2,76288,38845,37443
3 ,Iwate,5_ 9,1990,Heisei,2,90576,46322,44254
3 ,Iwate,10_ 14,1990,Heisei,2,102946,52678,50268
3 ,Iwate,15_ 19,1990,Heisei,2,99219,50736,48483
3 ,Iwate,20_ 24,1990,Heisei,2,70730,34784,35946
3 ,Iwate,25_ 29,1990,Heisei,2,79629,39423,40206
3 ,Iwate,30_ 34,1990,Heisei,2,89258,44584,44674
3 ,Iwate,35_ 39,1990,Heisei,2,106073,53329,52744
3 ,Iwate,40_ 44,1990,Heisei,2,110411,55402,55009
3 ,Iwate,45_ 49,1990,Heisei,2,92108,43998,48110
3 ,Iwate,50_ 54,1990,Heisei,2,96408,44862,51546
3 ,Iwate,55_ 59,1990,Heisei,2,102120,47521,54599
3 ,Iwate,60_ 64,1990,Heisei,2,95096,44559,50537
3 ,Iwate,65_ 69,1990,Heisei,2,71817,30638,41179
3 ,Iwate,70_ 74,1990,Heisei,2,54003,22052,31951
3 ,Iwate,75_ 79,1990,Heisei,2,40992,16638,24354
3 ,Iwate,80_ 84,1990,Heisei,2,24286,8947,15339
3 ,Iwate,over_85,1990,Heisei,2,14639,4658,9981
3 ,Iwate,total,1995,Heisei,7,1419505,681986,737519
3 ,Iwate,0_ 4,1995,Heisei,7,69091,35237,33854
3 ,Iwate,5_ 9,1995,Heisei,7,78388,40034,38354
3 ,Iwate,10_ 14,1995,Heisei,7,91531,46803,44728
3 ,Iwate,15_ 19,1995,Heisei,7,92977,47575,45402
3 ,Iwate,20_ 24,1995,Heisei,7,79658,40513,39145
3 ,Iwate,25_ 29,1995,Heisei,7,76664,37992,38672
3 ,Iwate,30_ 34,1995,Heisei,7,83113,41778,41335
3 ,Iwate,35_ 39,1995,Heisei,7,91242,45893,45349
3 ,Iwate,40_ 44,1995,Heisei,7,106742,53899,52843
3 ,Iwate,45_ 49,1995,Heisei,7,109635,55150,54485
3 ,Iwate,50_ 54,1995,Heisei,7,90851,43191,47660
3 ,Iwate,55_ 59,1995,Heisei,7,94692,43707,50985
3 ,Iwate,60_ 64,1995,Heisei,7,99601,45921,53680
3 ,Iwate,65_ 69,1995,Heisei,7,90960,41814,49146
3 ,Iwate,70_ 74,1995,Heisei,7,66250,27210,39040
3 ,Iwate,75_ 79,1995,Heisei,7,46460,17663,28797
3 ,Iwate,80_ 84,1995,Heisei,7,31019,11364,19655
3 ,Iwate,over_85,1995,Heisei,7,20567,6195,14372
3 ,Iwate,total,2000,Heisei,12,1416180,681238,734942
3 ,Iwate,0_ 4,2000,Heisei,12,62847,32488,30359
3 ,Iwate,5_ 9,2000,Heisei,12,70553,36022,34531
3 ,Iwate,10_ 14,2000,Heisei,12,79070,40335,38735
3 ,Iwate,15_ 19,2000,Heisei,12,83845,42663,41182
3 ,Iwate,20_ 24,2000,Heisei,12,76343,38915,37428
3 ,Iwate,25_ 29,2000,Heisei,12,85232,43623,41609
3 ,Iwate,30_ 34,2000,Heisei,12,79712,39902,39810
3 ,Iwate,35_ 39,2000,Heisei,12,84657,42730,41927
3 ,Iwate,40_ 44,2000,Heisei,12,91882,46367,45515
3 ,Iwate,45_ 49,2000,Heisei,12,106079,53671,52408
3 ,Iwate,50_ 54,2000,Heisei,12,108522,54528,53994
3 ,Iwate,55_ 59,2000,Heisei,12,89729,42451,47278
3 ,Iwate,60_ 64,2000,Heisei,12,93176,42674,50502
3 ,Iwate,65_ 69,2000,Heisei,12,95946,43540,52406
3 ,Iwate,70_ 74,2000,Heisei,12,84122,37324,46798
3 ,Iwate,75_ 79,2000,Heisei,12,58094,22460,35634
3 ,Iwate,80_ 84,2000,Heisei,12,36407,12553,23854
3 ,Iwate,over_85,2000,Heisei,12,29419,8631,20788
3 ,Iwate,total,2005,Heisei,17,1385041,663580,721461
3 ,Iwate,0_ 4,2005,Heisei,17,57024,29082,27942
3 ,Iwate,5_ 9,2005,Heisei,17,63180,32665,30515
3 ,Iwate,10_ 14,2005,Heisei,17,70374,35980,34394
3 ,Iwate,15_ 19,2005,Heisei,17,72432,36898,35534
3 ,Iwate,20_ 24,2005,Heisei,17,65658,32911,32747
3 ,Iwate,25_ 29,2005,Heisei,17,76206,38652,37554
3 ,Iwate,30_ 34,2005,Heisei,17,84334,42910,41424
3 ,Iwate,35_ 39,2005,Heisei,17,79012,39372,39640
3 ,Iwate,40_ 44,2005,Heisei,17,83813,42144,41669
3 ,Iwate,45_ 49,2005,Heisei,17,90471,45454,45017
3 ,Iwate,50_ 54,2005,Heisei,17,104315,52539,51776
3 ,Iwate,55_ 59,2005,Heisei,17,106347,52931,53416
3 ,Iwate,60_ 64,2005,Heisei,17,87665,41024,46641
3 ,Iwate,65_ 69,2005,Heisei,17,89603,40454,49149
3 ,Iwate,70_ 74,2005,Heisei,17,89468,39295,50173
3 ,Iwate,75_ 79,2005,Heisei,17,74653,31222,43431
3 ,Iwate,80_ 84,2005,Heisei,17,47252,16529,30723
3 ,Iwate,over_85,2005,Heisei,17,38981,10703,28278
3 ,Iwate,total,2010,Heisei,22,1330147,634971,695176
3 ,Iwate,0_ 4,2010,Heisei,22,49685,25518,24167
3 ,Iwate,5_ 9,2010,Heisei,22,56532,28769,27763
3 ,Iwate,10_ 14,2010,Heisei,22,62587,32325,30262
3 ,Iwate,15_ 19,2010,Heisei,22,64637,32981,31656
3 ,Iwate,20_ 24,2010,Heisei,22,54739,27378,27361
3 ,Iwate,25_ 29,2010,Heisei,22,63878,32259,31619
3 ,Iwate,30_ 34,2010,Heisei,22,74898,38026,36872
3 ,Iwate,35_ 39,2010,Heisei,22,83067,42364,40703
3 ,Iwate,40_ 44,2010,Heisei,22,77956,38810,39146
3 ,Iwate,45_ 49,2010,Heisei,22,82114,41090,41024
3 ,Iwate,50_ 54,2010,Heisei,22,88648,44248,44400
3 ,Iwate,55_ 59,2010,Heisei,22,101897,50811,51086
3 ,Iwate,60_ 64,2010,Heisei,22,103946,51193,52753
3 ,Iwate,65_ 69,2010,Heisei,22,84522,38949,45573
3 ,Iwate,70_ 74,2010,Heisei,22,83864,36775,47089
3 ,Iwate,75_ 79,2010,Heisei,22,80110,33355,46755
3 ,Iwate,80_ 84,2010,Heisei,22,60973,23112,37861
3 ,Iwate,over_85,2010,Heisei,22,51029,13849,37180
3 ,Iwate,total,2015,Heisei,27,1279594,615584,664010
3 ,Iwate,0_ 4,2015,Heisei,27,44460,22711,21749
3 ,Iwate,5_ 9,2015,Heisei,27,50138,25709,24429
3 ,Iwate,10_ 14,2015,Heisei,27,56394,28802,27592
3 ,Iwate,15_ 19,2015,Heisei,27,58332,30252,28080
3 ,Iwate,20_ 24,2015,Heisei,27,49304,25177,24127
3 ,Iwate,25_ 29,2015,Heisei,27,54657,28149,26508
3 ,Iwate,30_ 34,2015,Heisei,27,64890,32975,31915
3 ,Iwate,35_ 39,2015,Heisei,27,75923,38776,37147
3 ,Iwate,40_ 44,2015,Heisei,27,83625,43092,40533
3 ,Iwate,45_ 49,2015,Heisei,27,77997,39353,38644
3 ,Iwate,50_ 54,2015,Heisei,27,81816,41417,40399
3 ,Iwate,55_ 59,2015,Heisei,27,88069,44184,43885
3 ,Iwate,60_ 64,2015,Heisei,27,100273,49990,50283
3 ,Iwate,65_ 69,2015,Heisei,27,100241,49011,51230
3 ,Iwate,70_ 74,2015,Heisei,27,78913,35493,43420
3 ,Iwate,75_ 79,2015,Heisei,27,75157,31540,43617
3 ,Iwate,80_ 84,2015,Heisei,27,66196,25379,40817
3 ,Iwate,over_85,2015,Heisei,27,66066,19142,46924
4 ,Miyagi,total,1920,Taisho,9,961768,485309,476459
4 ,Miyagi,0_ 4,1920,Taisho,9,143989,72625,71364
4 ,Miyagi,5_ 9,1920,Taisho,9,126166,63670,62496
4 ,Miyagi,10_ 14,1920,Taisho,9,106854,54732,52122
4 ,Miyagi,15_ 19,1920,Taisho,9,91240,47770,43470
4 ,Miyagi,20_ 24,1920,Taisho,9,77587,41321,36266
4 ,Miyagi,25_ 29,1920,Taisho,9,65874,33696,32178
4 ,Miyagi,30_ 34,1920,Taisho,9,62559,31678,30881
4 ,Miyagi,35_ 39,1920,Taisho,9,55611,27382,28229
4 ,Miyagi,40_ 44,1920,Taisho,9,50904,25264,25640
4 ,Miyagi,45_ 49,1920,Taisho,9,40936,20212,20724
4 ,Miyagi,50_ 54,1920,Taisho,9,36806,18306,18500
4 ,Miyagi,55_ 59,1920,Taisho,9,30811,15165,15646
4 ,Miyagi,60_ 64,1920,Taisho,9,26525,12939,13586
4 ,Miyagi,65_ 69,1920,Taisho,9,22135,10339,11796
4 ,Miyagi,70_ 74,1920,Taisho,9,14060,6379,7681
4 ,Miyagi,75_ 79,1920,Taisho,9,7046,2859,4187
4 ,Miyagi,over_80,1920,Taisho,9,2665,972,1693
4 ,Miyagi,total,1925,Taisho,14,1044036,525191,518845
4 ,Miyagi,0_ 4,1925,Taisho,14,164567,83005,81562
4 ,Miyagi,5_ 9,1925,Taisho,14,136746,69031,67715
4 ,Miyagi,10_ 14,1925,Taisho,14,122286,62491,59795
4 ,Miyagi,15_ 19,1925,Taisho,14,100375,52505,47870
4 ,Miyagi,20_ 24,1925,Taisho,14,82202,42375,39827
4 ,Miyagi,25_ 29,1925,Taisho,14,69600,35344,34256
4 ,Miyagi,30_ 34,1925,Taisho,14,63426,32417,31009
4 ,Miyagi,35_ 39,1925,Taisho,14,60788,30898,29890
4 ,Miyagi,40_ 44,1925,Taisho,14,53329,26398,26931
4 ,Miyagi,45_ 49,1925,Taisho,14,48698,24119,24579
4 ,Miyagi,50_ 54,1925,Taisho,14,38020,18621,19399
4 ,Miyagi,55_ 59,1925,Taisho,14,32724,15944,16780
4 ,Miyagi,60_ 64,1925,Taisho,14,25680,12153,13527
4 ,Miyagi,65_ 69,1925,Taisho,14,20137,9289,10848
4 ,Miyagi,70_ 74,1925,Taisho,14,14681,6358,8323
4 ,Miyagi,75_ 79,1925,Taisho,14,7456,3035,4421
4 ,Miyagi,80_ 84,1925,Taisho,14,2725,1007,1718
4 ,Miyagi,over_85,1925,Taisho,14,596,201,395
4 ,Miyagi,total,1930,Showa,5,1142784,575335,567449
4 ,Miyagi,0_ 4,1930,Showa,5,178887,89985,88902
4 ,Miyagi,5_ 9,1930,Showa,5,155650,78527,77123
4 ,Miyagi,10_ 14,1930,Showa,5,131646,66994,64652
4 ,Miyagi,15_ 19,1930,Showa,5,115950,60261,55689
4 ,Miyagi,20_ 24,1930,Showa,5,91594,47472,44122
4 ,Miyagi,25_ 29,1930,Showa,5,76761,39045,37716
4 ,Miyagi,30_ 34,1930,Showa,5,67536,34465,33071
4 ,Miyagi,35_ 39,1930,Showa,5,61869,31914,29955
4 ,Miyagi,40_ 44,1930,Showa,5,58572,29961,28611
4 ,Miyagi,45_ 49,1930,Showa,5,50809,25171,25638
4 ,Miyagi,50_ 54,1930,Showa,5,45049,22216,22833
4 ,Miyagi,55_ 59,1930,Showa,5,34228,16550,17678
4 ,Miyagi,60_ 64,1930,Showa,5,27964,13146,14818
4 ,Miyagi,65_ 69,1930,Showa,5,20303,9124,11179
4 ,Miyagi,70_ 74,1930,Showa,5,13647,5841,7806
4 ,Miyagi,75_ 79,1930,Showa,5,8164,3233,4931
4 ,Miyagi,over_80,1930,Showa,5,4155,1430,2725
4 ,Miyagi,total,1935,Showa,10,1234801,622973,611828
4 ,Miyagi,0_ 4,1935,Showa,10,186899,94498,92401
4 ,Miyagi,5_ 9,1935,Showa,10,170447,85693,84754
4 ,Miyagi,10_ 14,1935,Showa,10,150315,76679,73636
4 ,Miyagi,15_ 19,1935,Showa,10,120475,63560,56915
4 ,Miyagi,20_ 24,1935,Showa,10,101073,51588,49485
4 ,Miyagi,25_ 29,1935,Showa,10,83457,42387,41070
4 ,Miyagi,30_ 34,1935,Showa,10,73895,37717,36178
4 ,Miyagi,35_ 39,1935,Showa,10,65357,33508,31849
4 ,Miyagi,40_ 44,1935,Showa,10,59744,30943,28801
4 ,Miyagi,45_ 49,1935,Showa,10,55972,28649,27323
4 ,Miyagi,50_ 54,1935,Showa,10,47467,23360,24107
4 ,Miyagi,55_ 59,1935,Showa,10,40815,19812,21003
4 ,Miyagi,60_ 64,1935,Showa,10,29609,13901,15708
4 ,Miyagi,65_ 69,1935,Showa,10,21966,9803,12163
4 ,Miyagi,70_ 74,1935,Showa,10,14433,6070,8363
4 ,Miyagi,75_ 79,1935,Showa,10,7901,3074,4827
4 ,Miyagi,over_80,1935,Showa,10,4976,1731,3245
4 ,Miyagi,total,1940,Showa,15,1270988,637745,633243
4 ,Miyagi,0_ 4,1940,Showa,15,179721,90939,88782
4 ,Miyagi,5_ 9,1940,Showa,15,175388,88670,86718
4 ,Miyagi,10_ 14,1940,Showa,15,161953,81978,79975
4 ,Miyagi,15_ 19,1940,Showa,15,127842,65716,62126
4 ,Miyagi,20_ 24,1940,Showa,15,98664,52483,46181
4 ,Miyagi,25_ 29,1940,Showa,15,84477,41332,43145
4 ,Miyagi,30_ 34,1940,Showa,15,75606,37464,38142
4 ,Miyagi,35_ 39,1940,Showa,15,69284,34715,34569
4 ,Miyagi,40_ 44,1940,Showa,15,61309,31137,30172
4 ,Miyagi,45_ 49,1940,Showa,15,55878,28748,27130
4 ,Miyagi,50_ 54,1940,Showa,15,51542,26056,25486
4 ,Miyagi,55_ 59,1940,Showa,15,42562,20539,22023
4 ,Miyagi,60_ 64,1940,Showa,15,34821,16300,18521
4 ,Miyagi,65_ 69,1940,Showa,15,23477,10461,13016
4 ,Miyagi,70_ 74,1940,Showa,15,15295,6353,8942
4 ,Miyagi,75_ 79,1940,Showa,15,8411,3241,5170
4 ,Miyagi,80_ 84,1940,Showa,15,3433,1200,2233
4 ,Miyagi,over_85,1940,Showa,15,1316,406,910
4 ,Miyagi,total,1945,Showa,20,1462254,684453,777801
4 ,Miyagi,1_ 5,1945,Showa,20,198970,100783,98187
4 ,Miyagi,6_ 10,1945,Showa,20,197911,100317,97594
4 ,Miyagi,11_ 15,1945,Showa,20,195487,98737,96750
4 ,Miyagi,16_ 20,1945,Showa,20,170081,83847,86234
4 ,Miyagi,21_ 25,1945,Showa,20,110101,39160,70941
4 ,Miyagi,26_ 30,1945,Showa,20,83451,28390,55061
4 ,Miyagi,31_ 35,1945,Showa,20,81087,30873,50214
4 ,Miyagi,36_ 40,1945,Showa,20,80604,37164,43440
4 ,Miyagi,41_ 45,1945,Showa,20,73007,35621,37386
4 ,Miyagi,46_ 50,1945,Showa,20,64209,32119,32090
4 ,Miyagi,51_ 55,1945,Showa,20,56688,28736,27952
4 ,Miyagi,56_ 60,1945,Showa,20,50820,25226,25594
4 ,Miyagi,61_ 65,1945,Showa,20,39063,18173,20890
4 ,Miyagi,66_ 70,1945,Showa,20,29455,12923,16532
4 ,Miyagi,71_ 75,1945,Showa,20,17678,7361,10317
4 ,Miyagi,76_ 80,1945,Showa,20,8882,3378,5504
4 ,Miyagi,81_ 85,1945,Showa,20,3644,1294,2350
4 ,Miyagi,86以上,1945,Showa,20,1116,351,765
4 ,Miyagi,total,1950,Showa,25,1663442,828879,834563
4 ,Miyagi,0_ 4,1950,Showa,25,229807,117075,112732
4 ,Miyagi,5_ 9,1950,Showa,25,196720,100025,96695
4 ,Miyagi,10_ 14,1950,Showa,25,193747,98163,95584
4 ,Miyagi,15_ 19,1950,Showa,25,186020,95858,90162
4 ,Miyagi,20_ 24,1950,Showa,25,168543,88886,79657
4 ,Miyagi,25_ 29,1950,Showa,25,124196,58948,65248
4 ,Miyagi,30_ 34,1950,Showa,25,99233,46358,52875
4 ,Miyagi,35_ 39,1950,Showa,25,91667,42981,48686
4 ,Miyagi,40_ 44,1950,Showa,25,80427,39705,40722
4 ,Miyagi,45_ 49,1950,Showa,25,70258,35272,34986
4 ,Miyagi,50_ 54,1950,Showa,25,59607,30150,29457
4 ,Miyagi,55_ 59,1950,Showa,25,51743,26039,25704
4 ,Miyagi,60_ 64,1950,Showa,25,43893,21285,22608
4 ,Miyagi,65_ 69,1950,Showa,25,30909,13882,17027
4 ,Miyagi,70_ 74,1950,Showa,25,20582,8488,12094
4 ,Miyagi,75_ 79,1950,Showa,25,10517,3977,6540
4 ,Miyagi,over_80,1950,Showa,25,5512,1749,3763
4 ,Miyagi,total,1955,Showa,30,1727065,846404,880661
4 ,Miyagi,0_ 4,1955,Showa,30,205046,104509,100537
4 ,Miyagi,5_ 9,1955,Showa,30,221774,113076,108698
4 ,Miyagi,10_ 14,1955,Showa,30,192778,97907,94871
4 ,Miyagi,15_ 19,1955,Showa,30,177519,88856,88663
4 ,Miyagi,20_ 24,1955,Showa,30,159855,77015,82840
4 ,Miyagi,25_ 29,1955,Showa,30,145108,70680,74428
4 ,Miyagi,30_ 34,1955,Showa,30,116706,54209,62497
4 ,Miyagi,35_ 39,1955,Showa,30,93976,43189,50787
4 ,Miyagi,40_ 44,1955,Showa,30,87656,40698,46958
4 ,Miyagi,45_ 49,1955,Showa,30,76907,37739,39168
4 ,Miyagi,50_ 54,1955,Showa,30,66357,33103,33254
4 ,Miyagi,55_ 59,1955,Showa,30,55381,27654,27727
4 ,Miyagi,60_ 64,1955,Showa,30,46325,22941,23384
4 ,Miyagi,65_ 69,1955,Showa,30,36721,17305,19416
4 ,Miyagi,70_ 74,1955,Showa,30,23594,9945,13649
4 ,Miyagi,75_ 79,1955,Showa,30,13759,5149,8610
4 ,Miyagi,80_ 84,1955,Showa,30,5655,1898,3757
4 ,Miyagi,over_85,1955,Showa,30,1941,528,1413
4 ,Miyagi,total,1960,Showa,35,1743195,848579,894616
4 ,Miyagi,0_ 4,1960,Showa,35,161496,82683,78813
4 ,Miyagi,5_ 9,1960,Showa,35,202788,103325,99463
4 ,Miyagi,10_ 14,1960,Showa,35,220213,112248,107965
4 ,Miyagi,15_ 19,1960,Showa,35,158577,78186,80391
4 ,Miyagi,20_ 24,1960,Showa,35,143304,67716,75588
4 ,Miyagi,25_ 29,1960,Showa,35,146217,70334,75883
4 ,Miyagi,30_ 34,1960,Showa,35,140587,68811,71776
4 ,Miyagi,35_ 39,1960,Showa,35,113556,52566,60990
4 ,Miyagi,40_ 44,1960,Showa,35,91344,41729,49615
4 ,Miyagi,45_ 49,1960,Showa,35,84374,38867,45507
4 ,Miyagi,50_ 54,1960,Showa,35,73324,35664,37660
4 ,Miyagi,55_ 59,1960,Showa,35,62263,30702,31561
4 ,Miyagi,60_ 64,1960,Showa,35,50186,24492,25694
4 ,Miyagi,65_ 69,1960,Showa,35,39766,18934,20832
4 ,Miyagi,70_ 74,1960,Showa,35,28811,12812,15999
4 ,Miyagi,75_ 79,1960,Showa,35,16088,6208,9880
4 ,Miyagi,80_ 84,1960,Showa,35,7554,2492,5062
4 ,Miyagi,over_85,1960,Showa,35,2747,810,1937
4 ,Miyagi,total,1965,Showa,40,1753126,854043,899083
4 ,Miyagi,0_ 4,1965,Showa,40,142301,72529,69772
4 ,Miyagi,5_ 9,1965,Showa,40,160106,81338,78768
4 ,Miyagi,10_ 14,1965,Showa,40,201223,101940,99283
4 ,Miyagi,15_ 19,1965,Showa,40,187421,96356,91065
4 ,Miyagi,20_ 24,1965,Showa,40,132699,64336,68363
4 ,Miyagi,25_ 29,1965,Showa,40,133726,63829,69897
4 ,Miyagi,30_ 34,1965,Showa,40,143997,69956,74041
4 ,Miyagi,35_ 39,1965,Showa,40,138255,67724,70531
4 ,Miyagi,40_ 44,1965,Showa,40,110903,51205,59698
4 ,Miyagi,45_ 49,1965,Showa,40,88536,40268,48268
4 ,Miyagi,50_ 54,1965,Showa,40,80682,36965,43717
4 ,Miyagi,55_ 59,1965,Showa,40,69011,33438,35573
4 ,Miyagi,60_ 64,1965,Showa,40,56637,27338,29299
4 ,Miyagi,65_ 69,1965,Showa,40,43223,20360,22863
4 ,Miyagi,70_ 74,1965,Showa,40,31728,14239,17489
4 ,Miyagi,75_ 79,1965,Showa,40,19953,8194,11759
4 ,Miyagi,80_ 84,1965,Showa,40,8805,2951,5854
4 ,Miyagi,over_85,1965,Showa,40,3920,1077,2843
4 ,Miyagi,total,1970,Showa,45,1819223,889036,930187
4 ,Miyagi,0_ 4,1970,Showa,45,141917,72819,69098
4 ,Miyagi,5_ 9,1970,Showa,45,145017,74170,70847
4 ,Miyagi,10_ 14,1970,Showa,45,161900,82480,79420
4 ,Miyagi,15_ 19,1970,Showa,45,180805,92516,88289
4 ,Miyagi,20_ 24,1970,Showa,45,173744,86354,87390
4 ,Miyagi,25_ 29,1970,Showa,45,135486,66768,68718
4 ,Miyagi,30_ 34,1970,Showa,45,138015,67150,70865
4 ,Miyagi,35_ 39,1970,Showa,45,145266,70929,74337
4 ,Miyagi,40_ 44,1970,Showa,45,135287,66663,68624
4 ,Miyagi,45_ 49,1970,Showa,45,109825,50551,59274
4 ,Miyagi,50_ 54,1970,Showa,45,86249,39188,47061
4 ,Miyagi,55_ 59,1970,Showa,45,75860,34584,41276
4 ,Miyagi,60_ 64,1970,Showa,45,64174,30466,33708
4 ,Miyagi,65_ 69,1970,Showa,45,50648,23588,27060
4 ,Miyagi,70_ 74,1970,Showa,45,35958,15880,20078
4 ,Miyagi,75_ 79,1970,Showa,45,22600,9271,13329
4 ,Miyagi,80_ 84,1970,Showa,45,11584,4282,7302
4 ,Miyagi,over_85,1970,Showa,45,4888,1377,3511
4 ,Miyagi,total,1975,Showa,50,1955267,960245,995022
4 ,Miyagi,0_ 4,1975,Showa,50,165017,84486,80531
4 ,Miyagi,5_ 9,1975,Showa,50,147669,75685,71984
4 ,Miyagi,10_ 14,1975,Showa,50,148267,75833,72434
4 ,Miyagi,15_ 19,1975,Showa,50,158881,82075,76806
4 ,Miyagi,20_ 24,1975,Showa,50,172342,86726,85616
4 ,Miyagi,25_ 29,1975,Showa,50,176603,89003,87600
4 ,Miyagi,30_ 34,1975,Showa,50,144016,72403,71613
4 ,Miyagi,35_ 39,1975,Showa,50,141905,69548,72357
4 ,Miyagi,40_ 44,1975,Showa,50,147043,72041,75002
4 ,Miyagi,45_ 49,1975,Showa,50,137209,67182,70027
4 ,Miyagi,50_ 54,1975,Showa,50,107763,49459,58304
4 ,Miyagi,55_ 59,1975,Showa,50,83849,37739,46110
4 ,Miyagi,60_ 64,1975,Showa,50,74021,33083,40938
4 ,Miyagi,65_ 69,1975,Showa,50,59120,27216,31904
4 ,Miyagi,70_ 74,1975,Showa,50,43068,18925,24143
4 ,Miyagi,75_ 79,1975,Showa,50,27028,11102,15926
4 ,Miyagi,80_ 84,1975,Showa,50,14190,5264,8926
4 ,Miyagi,over_85,1975,Showa,50,6604,2055,4549
4 ,Miyagi,total,1980,Showa,55,2082320,1025903,1056417
4 ,Miyagi,0_ 4,1980,Showa,55,160137,82342,77795
4 ,Miyagi,5_ 9,1980,Showa,55,169826,87023,82803
4 ,Miyagi,10_ 14,1980,Showa,55,150589,77284,73305
4 ,Miyagi,15_ 19,1980,Showa,55,153089,79673,73416
4 ,Miyagi,20_ 24,1980,Showa,55,155650,79213,76437
4 ,Miyagi,25_ 29,1980,Showa,55,172560,86390,86170
4 ,Miyagi,30_ 34,1980,Showa,55,181843,92512,89331
4 ,Miyagi,35_ 39,1980,Showa,55,147252,74249,73003
4 ,Miyagi,40_ 44,1980,Showa,55,143022,70171,72851
4 ,Miyagi,45_ 49,1980,Showa,55,145676,71041,74635
4 ,Miyagi,50_ 54,1980,Showa,55,134666,65493,69173
4 ,Miyagi,55_ 59,1980,Showa,55,105397,47970,57427
4 ,Miyagi,60_ 64,1980,Showa,55,80342,35589,44753
4 ,Miyagi,65_ 69,1980,Showa,55,68533,29866,38667
4 ,Miyagi,70_ 74,1980,Showa,55,51667,22739,28928
4 ,Miyagi,75_ 79,1980,Showa,55,33795,13865,19930
4 ,Miyagi,80_ 84,1980,Showa,55,17620,6534,11086
4 ,Miyagi,over_85,1980,Showa,55,9074,2889,6185
4 ,Miyagi,total,1985,Showa,60,2176295,1071741,1104554
4 ,Miyagi,0_ 4,1985,Showa,60,147629,75465,72164
4 ,Miyagi,5_ 9,1985,Showa,60,162178,83395,78783
4 ,Miyagi,10_ 14,1985,Showa,60,171092,87623,83469
4 ,Miyagi,15_ 19,1985,Showa,60,157236,82129,75107
4 ,Miyagi,20_ 24,1985,Showa,60,151990,78421,73569
4 ,Miyagi,25_ 29,1985,Showa,60,149398,74427,74971
4 ,Miyagi,30_ 34,1985,Showa,60,174503,87835,86668
4 ,Miyagi,35_ 39,1985,Showa,60,182716,92844,89872
4 ,Miyagi,40_ 44,1985,Showa,60,146171,73469,72702
4 ,Miyagi,45_ 49,1985,Showa,60,140915,68776,72139
4 ,Miyagi,50_ 54,1985,Showa,60,142334,68668,73666
4 ,Miyagi,55_ 59,1985,Showa,60,131549,63292,68257
4 ,Miyagi,60_ 64,1985,Showa,60,102008,45737,56271
4 ,Miyagi,65_ 69,1985,Showa,60,75760,32794,42966
4 ,Miyagi,70_ 74,1985,Showa,60,61691,25855,35836
4 ,Miyagi,75_ 79,1985,Showa,60,42269,17530,24739
4 ,Miyagi,80_ 84,1985,Showa,60,23430,8760,14670
4 ,Miyagi,over_85,1985,Showa,60,12307,3950,8357
4 ,Miyagi,total,1990,Heisei,2,2248558,1105103,1143455
4 ,Miyagi,0_ 4,1990,Heisei,2,125972,64808,61164
4 ,Miyagi,5_ 9,1990,Heisei,2,149685,76364,73321
4 ,Miyagi,10_ 14,1990,Heisei,2,163656,84208,79448
4 ,Miyagi,15_ 19,1990,Heisei,2,180590,93697,86893
4 ,Miyagi,20_ 24,1990,Heisei,2,155551,80003,75548
4 ,Miyagi,25_ 29,1990,Heisei,2,141180,70037,71143
4 ,Miyagi,30_ 34,1990,Heisei,2,150179,74930,75249
4 ,Miyagi,35_ 39,1990,Heisei,2,175203,87945,87258
4 ,Miyagi,40_ 44,1990,Heisei,2,182764,92626,90138
4 ,Miyagi,45_ 49,1990,Heisei,2,144505,72554,71951
4 ,Miyagi,50_ 54,1990,Heisei,2,137975,66795,71180
4 ,Miyagi,55_ 59,1990,Heisei,2,139499,66554,72945
4 ,Miyagi,60_ 64,1990,Heisei,2,128003,60767,67236
4 ,Miyagi,65_ 69,1990,Heisei,2,96768,42311,54457
4 ,Miyagi,70_ 74,1990,Heisei,2,69297,28932,40365
4 ,Miyagi,75_ 79,1990,Heisei,2,52080,20568,31512
4 ,Miyagi,80_ 84,1990,Heisei,2,30934,11669,19265
4 ,Miyagi,over_85,1990,Heisei,2,17680,5575,12105
4 ,Miyagi,total,1995,Heisei,7,2328739,1144739,1184000
4 ,Miyagi,0_ 4,1995,Heisei,7,112943,57682,55261
4 ,Miyagi,5_ 9,1995,Heisei,7,129302,66496,62806
4 ,Miyagi,10_ 14,1995,Heisei,7,152086,77656,74430
4 ,Miyagi,15_ 19,1995,Heisei,7,177343,92387,84956
4 ,Miyagi,20_ 24,1995,Heisei,7,186104,96211,89893
4 ,Miyagi,25_ 29,1995,Heisei,7,149852,75344,74508
4 ,Miyagi,30_ 34,1995,Heisei,7,146428,73317,73111
4 ,Miyagi,35_ 39,1995,Heisei,7,154138,77235,76903
4 ,Miyagi,40_ 44,1995,Heisei,7,178671,89942,88729
4 ,Miyagi,45_ 49,1995,Heisei,7,184458,94003,90455
4 ,Miyagi,50_ 54,1995,Heisei,7,144500,72472,72028
4 ,Miyagi,55_ 59,1995,Heisei,7,137258,65999,71259
4 ,Miyagi,60_ 64,1995,Heisei,7,136782,64492,72290
4 ,Miyagi,65_ 69,1995,Heisei,7,122529,56973,65556
4 ,Miyagi,70_ 74,1995,Heisei,7,89847,37855,51992
4 ,Miyagi,75_ 79,1995,Heisei,7,59639,23503,36136
4 ,Miyagi,80_ 84,1995,Heisei,7,39691,14234,25457
4 ,Miyagi,over_85,1995,Heisei,7,25814,8079,17735
4 ,Miyagi,total,2000,Heisei,12,2365320,1158622,1206698
4 ,Miyagi,0_ 4,2000,Heisei,12,108870,55969,52901
4 ,Miyagi,5_ 9,2000,Heisei,12,114417,58440,55977
4 ,Miyagi,10_ 14,2000,Heisei,12,130229,66964,63265
4 ,Miyagi,15_ 19,2000,Heisei,12,161535,82984,78551
4 ,Miyagi,20_ 24,2000,Heisei,12,175751,90616,85135
4 ,Miyagi,25_ 29,2000,Heisei,12,174455,88171,86284
4 ,Miyagi,30_ 34,2000,Heisei,12,150618,75700,74918
4 ,Miyagi,35_ 39,2000,Heisei,12,147411,73769,73642
4 ,Miyagi,40_ 44,2000,Heisei,12,155461,77955,77506
4 ,Miyagi,45_ 49,2000,Heisei,12,178016,89501,88515
4 ,Miyagi,50_ 54,2000,Heisei,12,181886,92236,89650
4 ,Miyagi,55_ 59,2000,Heisei,12,142004,70479,71525
4 ,Miyagi,60_ 64,2000,Heisei,12,134689,64065,70624
4 ,Miyagi,65_ 69,2000,Heisei,12,131286,60647,70639
4 ,Miyagi,70_ 74,2000,Heisei,12,113809,51009,62800
4 ,Miyagi,75_ 79,2000,Heisei,12,79320,31534,47786
4 ,Miyagi,80_ 84,2000,Heisei,12,47234,16852,30382
4 ,Miyagi,over_85,2000,Heisei,12,37507,11185,26322
4 ,Miyagi,total,2005,Heisei,17,2360218,1149172,1211046
4 ,Miyagi,0_ 4,2005,Heisei,17,102468,52383,50085
4 ,Miyagi,5_ 9,2005,Heisei,17,109051,56000,53051
4 ,Miyagi,10_ 14,2005,Heisei,17,114310,58403,55907
4 ,Miyagi,15_ 19,2005,Heisei,17,137317,71027,66290
4 ,Miyagi,20_ 24,2005,Heisei,17,154392,78364,76028
4 ,Miyagi,25_ 29,2005,Heisei,17,158573,79743,78830
4 ,Miyagi,30_ 34,2005,Heisei,17,169631,85492,84139
4 ,Miyagi,35_ 39,2005,Heisei,17,148558,74474,74084
4 ,Miyagi,40_ 44,2005,Heisei,17,145995,72660,73335
4 ,Miyagi,45_ 49,2005,Heisei,17,152673,75868,76805
4 ,Miyagi,50_ 54,2005,Heisei,17,174224,86856,87368
4 ,Miyagi,55_ 59,2005,Heisei,17,177938,89070,88868
4 ,Miyagi,60_ 64,2005,Heisei,17,138786,68078,70708
4 ,Miyagi,65_ 69,2005,Heisei,17,129858,60751,69107
4 ,Miyagi,70_ 74,2005,Heisei,17,122766,54986,67780
4 ,Miyagi,75_ 79,2005,Heisei,17,101796,43267,58529
4 ,Miyagi,80_ 84,2005,Heisei,17,65098,23579,41519
4 ,Miyagi,over_85,2005,Heisei,17,50994,14472,36522
4 ,Miyagi,total,2010,Heisei,22,2348165,1139566,1208599
4 ,Miyagi,0_ 4,2010,Heisei,22,95732,48942,46790
4 ,Miyagi,5_ 9,2010,Heisei,22,103182,52904,50278
4 ,Miyagi,10_ 14,2010,Heisei,22,109287,56178,53109
4 ,Miyagi,15_ 19,2010,Heisei,22,120010,61644,58366
4 ,Miyagi,20_ 24,2010,Heisei,22,130179,66160,64019
4 ,Miyagi,25_ 29,2010,Heisei,22,139463,69025,70438
4 ,Miyagi,30_ 34,2010,Heisei,22,155284,77845,77439
4 ,Miyagi,35_ 39,2010,Heisei,22,168478,84752,83726
4 ,Miyagi,40_ 44,2010,Heisei,22,147981,74091,73890
4 ,Miyagi,45_ 49,2010,Heisei,22,144490,71761,72729
4 ,Miyagi,50_ 54,2010,Heisei,22,150253,74322,75931
4 ,Miyagi,55_ 59,2010,Heisei,22,171163,84503,86660
4 ,Miyagi,60_ 64,2010,Heisei,22,174337,86413,87924
4 ,Miyagi,65_ 69,2010,Heisei,22,133960,64670,69290
4 ,Miyagi,70_ 74,2010,Heisei,22,121978,55414,66564
4 ,Miyagi,75_ 79,2010,Heisei,22,110599,46921,63678
4 ,Miyagi,80_ 84,2010,Heisei,22,84105,32589,51516
4 ,Miyagi,over_85,2010,Heisei,22,70152,19982,50170
4 ,Miyagi,total,2015,Heisei,27,2333899,1140167,1193732
4 ,Miyagi,0_ 4,2015,Heisei,27,88787,45446,43341
4 ,Miyagi,5_ 9,2015,Heisei,27,95243,48735,46508
4 ,Miyagi,10_ 14,2015,Heisei,27,101973,52310,49663
4 ,Miyagi,15_ 19,2015,Heisei,27,113969,59017,54952
4 ,Miyagi,20_ 24,2015,Heisei,27,116391,60134,56257
4 ,Miyagi,25_ 29,2015,Heisei,27,120512,61305,59207
4 ,Miyagi,30_ 34,2015,Heisei,27,135196,67504,67692
4 ,Miyagi,35_ 39,2015,Heisei,27,152236,76838,75398
4 ,Miyagi,40_ 44,2015,Heisei,27,166058,84267,81791
4 ,Miyagi,45_ 49,2015,Heisei,27,145597,73791,71806
4 ,Miyagi,50_ 54,2015,Heisei,27,142740,71728,71012
4 ,Miyagi,55_ 59,2015,Heisei,27,148606,73858,74748
4 ,Miyagi,60_ 64,2015,Heisei,27,169017,83552,85465
4 ,Miyagi,65_ 69,2015,Heisei,27,168177,82609,85568
4 ,Miyagi,70_ 74,2015,Heisei,27,125280,59089,66191
4 ,Miyagi,75_ 79,2015,Heisei,27,110556,48155,62401
4 ,Miyagi,80_ 84,2015,Heisei,27,92973,36613,56360
4 ,Miyagi,over_85,2015,Heisei,27,91254,27600,63654
5 ,Akita,total,1920,Taisho,9,898537,453682,444855
5 ,Akita,0_ 4,1920,Taisho,9,133918,68034,65884
5 ,Akita,5_ 9,1920,Taisho,9,118230,60684,57546
5 ,Akita,10_ 14,1920,Taisho,9,103946,54245,49701
5 ,Akita,15_ 19,1920,Taisho,9,87870,45227,42643
5 ,Akita,20_ 24,1920,Taisho,9,71127,35189,35938
5 ,Akita,25_ 29,1920,Taisho,9,63249,31835,31414
5 ,Akita,30_ 34,1920,Taisho,9,54680,27651,27029
5 ,Akita,35_ 39,1920,Taisho,9,51397,25385,26012
5 ,Akita,40_ 44,1920,Taisho,9,47161,23701,23460
5 ,Akita,45_ 49,1920,Taisho,9,42232,21133,21099
5 ,Akita,50_ 54,1920,Taisho,9,38309,19088,19221
5 ,Akita,55_ 59,1920,Taisho,9,26302,13129,13173
5 ,Akita,60_ 64,1920,Taisho,9,23273,11413,11860
5 ,Akita,65_ 69,1920,Taisho,9,17916,8448,9468
5 ,Akita,70_ 74,1920,Taisho,9,11531,5275,6256
5 ,Akita,75_ 79,1920,Taisho,9,5460,2478,2982
5 ,Akita,over_80,1920,Taisho,9,1936,767,1169
5 ,Akita,total,1925,Taisho,14,936408,470737,465671
5 ,Akita,0_ 4,1925,Taisho,14,146125,74267,71858
5 ,Akita,5_ 9,1925,Taisho,14,124263,63172,61091
5 ,Akita,10_ 14,1925,Taisho,14,110724,57598,53126
5 ,Akita,15_ 19,1925,Taisho,14,89891,46476,43415
5 ,Akita,20_ 24,1925,Taisho,14,74156,36022,38134
5 ,Akita,25_ 29,1925,Taisho,14,66158,32846,33312
5 ,Akita,30_ 34,1925,Taisho,14,59053,29720,29333
5 ,Akita,35_ 39,1925,Taisho,14,51119,26073,25046
5 ,Akita,40_ 44,1925,Taisho,14,47295,23615,23680
5 ,Akita,45_ 49,1925,Taisho,14,43160,21558,21602
5 ,Akita,50_ 54,1925,Taisho,14,37536,18657,18879
5 ,Akita,55_ 59,1925,Taisho,14,32749,15993,16756
5 ,Akita,60_ 64,1925,Taisho,14,20936,10061,10875
5 ,Akita,65_ 69,1925,Taisho,14,15955,7398,8557
5 ,Akita,70_ 74,1925,Taisho,14,10221,4388,5833
5 ,Akita,75_ 79,1925,Taisho,14,5096,2134,2962
5 ,Akita,80_ 84,1925,Taisho,14,1628,653,975
5 ,Akita,over_85,1925,Taisho,14,343,106,237
5 ,Akita,total,1930,Showa,5,987706,495009,492697
5 ,Akita,0_ 4,1930,Showa,5,156674,79189,77485
5 ,Akita,5_ 9,1930,Showa,5,136291,69470,66821
5 ,Akita,10_ 14,1930,Showa,5,115713,59443,56270
5 ,Akita,15_ 19,1930,Showa,5,95514,49020,46494
5 ,Akita,20_ 24,1930,Showa,5,76228,37438,38790
5 ,Akita,25_ 29,1930,Showa,5,69414,34316,35098
5 ,Akita,30_ 34,1930,Showa,5,62393,31236,31157
5 ,Akita,35_ 39,1930,Showa,5,55774,28255,27519
5 ,Akita,40_ 44,1930,Showa,5,47653,24476,23177
5 ,Akita,45_ 49,1930,Showa,5,43766,21747,22019
5 ,Akita,50_ 54,1930,Showa,5,38602,19124,19478
5 ,Akita,55_ 59,1930,Showa,5,32339,15665,16674
5 ,Akita,60_ 64,1930,Showa,5,26130,12246,13884
5 ,Akita,65_ 69,1930,Showa,5,14803,6710,8093
5 ,Akita,70_ 74,1930,Showa,5,9495,4098,5397
5 ,Akita,75_ 79,1930,Showa,5,4824,1841,2983
5 ,Akita,over_80,1930,Showa,5,2093,735,1358
5 ,Akita,total,1935,Showa,10,1037744,519249,518495
5 ,Akita,0_ 4,1935,Showa,10,162338,82471,79867
5 ,Akita,5_ 9,1935,Showa,10,146530,74235,72295
5 ,Akita,10_ 14,1935,Showa,10,126934,65514,61420
5 ,Akita,15_ 19,1935,Showa,10,95230,49226,46004
5 ,Akita,20_ 24,1935,Showa,10,78204,37833,40371
5 ,Akita,25_ 29,1935,Showa,10,70587,34718,35869
5 ,Akita,30_ 34,1935,Showa,10,65927,32470,33457
5 ,Akita,35_ 39,1935,Showa,10,59204,29673,29531
5 ,Akita,40_ 44,1935,Showa,10,52514,26806,25708
5 ,Akita,45_ 49,1935,Showa,10,44523,22942,21581
5 ,Akita,50_ 54,1935,Showa,10,39829,19601,20228
5 ,Akita,55_ 59,1935,Showa,10,33695,16318,17377
5 ,Akita,60_ 64,1935,Showa,10,26511,12416,14095
5 ,Akita,65_ 69,1935,Showa,10,19112,8398,10714
5 ,Akita,70_ 74,1935,Showa,10,9441,4027,5414
5 ,Akita,75_ 79,1935,Showa,10,4854,1860,2994
5 ,Akita,over_80,1935,Showa,10,2311,741,1570
5 ,Akita,total,1940,Showa,15,1052147,523911,528236
5 ,Akita,0_ 4,1940,Showa,15,150759,76404,74355
5 ,Akita,5_ 9,1940,Showa,15,150169,76308,73861
5 ,Akita,10_ 14,1940,Showa,15,135969,69333,66636
5 ,Akita,15_ 19,1940,Showa,15,99137,49842,49295
5 ,Akita,20_ 24,1940,Showa,15,81095,42399,38696
5 ,Akita,25_ 29,1940,Showa,15,69298,33402,35896
5 ,Akita,30_ 34,1940,Showa,15,64038,30954,33084
5 ,Akita,35_ 39,1940,Showa,15,60787,29514,31273
5 ,Akita,40_ 44,1940,Showa,15,54711,27154,27557
5 ,Akita,45_ 49,1940,Showa,15,47980,24269,23711
5 ,Akita,50_ 54,1940,Showa,15,39784,20129,19655
5 ,Akita,55_ 59,1940,Showa,15,34010,16305,17705
5 ,Akita,60_ 64,1940,Showa,15,26988,12420,14568
5 ,Akita,65_ 69,1940,Showa,15,19070,8357,10713
5 ,Akita,70_ 74,1940,Showa,15,11674,4693,6981
5 ,Akita,75_ 79,1940,Showa,15,4605,1806,2799
5 ,Akita,80_ 84,1940,Showa,15,1608,503,1105
5 ,Akita,over_85,1940,Showa,15,456,115,341
5 ,Akita,total,1945,Showa,20,1211871,574732,637139
5 ,Akita,1_ 5,1945,Showa,20,164240,83121,81119
5 ,Akita,6_ 10,1945,Showa,20,161219,81630,79589
5 ,Akita,11_ 15,1945,Showa,20,161507,81967,79540
5 ,Akita,16_ 20,1945,Showa,20,141680,70239,71441
5 ,Akita,21_ 25,1945,Showa,20,91755,34203,57552
5 ,Akita,26_ 30,1945,Showa,20,72795,26801,45994
5 ,Akita,31_ 35,1945,Showa,20,70738,29293,41445
5 ,Akita,36_ 40,1945,Showa,20,70000,33213,36787
5 ,Akita,41_ 45,1945,Showa,20,64794,32275,32519
5 ,Akita,46_ 50,1945,Showa,20,56871,28800,28071
5 ,Akita,51_ 55,1945,Showa,20,47682,24236,23446
5 ,Akita,56_ 60,1945,Showa,20,38181,18846,19335
5 ,Akita,61_ 65,1945,Showa,20,29338,13450,15888
5 ,Akita,66_ 70,1945,Showa,20,20890,9042,11848
5 ,Akita,71_ 75,1945,Showa,20,12346,4865,7481
5 ,Akita,76_ 80,1945,Showa,20,5780,2110,3670
5 ,Akita,81_ 85,1945,Showa,20,1656,543,1113
5 ,Akita,86以上,1945,Showa,20,399,98,301
5 ,Akita,total,1950,Showa,25,1309031,646445,662586
5 ,Akita,0_ 4,1950,Showa,25,186919,94987,91932
5 ,Akita,5_ 9,1950,Showa,25,157280,79682,77598
5 ,Akita,10_ 14,1950,Showa,25,156783,79604,77179
5 ,Akita,15_ 19,1950,Showa,25,146518,74824,71694
5 ,Akita,20_ 24,1950,Showa,25,121230,59030,62200
5 ,Akita,25_ 29,1950,Showa,25,93336,42866,50470
5 ,Akita,30_ 34,1950,Showa,25,79478,37193,42285
5 ,Akita,35_ 39,1950,Showa,25,73805,35436,38369
5 ,Akita,40_ 44,1950,Showa,25,66342,33057,33285
5 ,Akita,45_ 49,1950,Showa,25,60329,30377,29952
5 ,Akita,50_ 54,1950,Showa,25,50981,25849,25132
5 ,Akita,55_ 59,1950,Showa,25,41801,20947,20854
5 ,Akita,60_ 64,1950,Showa,25,30682,14772,15910
5 ,Akita,65_ 69,1950,Showa,25,21395,9445,11950
5 ,Akita,70_ 74,1950,Showa,25,12940,5197,7743
5 ,Akita,75_ 79,1950,Showa,25,6458,2335,4123
5 ,Akita,over_80,1950,Showa,25,2711,821,1890
5 ,Akita,total,1955,Showa,30,1348871,660066,688805
5 ,Akita,0_ 4,1955,Showa,30,159259,81213,78046
5 ,Akita,5_ 9,1955,Showa,30,180922,91909,89013
5 ,Akita,10_ 14,1955,Showa,30,153568,77802,75766
5 ,Akita,15_ 19,1955,Showa,30,135689,67401,68288
5 ,Akita,20_ 24,1955,Showa,30,120494,57203,63291
5 ,Akita,25_ 29,1955,Showa,30,111423,53959,57464
5 ,Akita,30_ 34,1955,Showa,30,89227,40908,48319
5 ,Akita,35_ 39,1955,Showa,30,76016,35432,40584
5 ,Akita,40_ 44,1955,Showa,30,70029,33486,36543
5 ,Akita,45_ 49,1955,Showa,30,62832,31074,31758
5 ,Akita,50_ 54,1955,Showa,30,56341,28056,28285
5 ,Akita,55_ 59,1955,Showa,30,46388,23004,23384
5 ,Akita,60_ 64,1955,Showa,30,36040,17523,18517
5 ,Akita,65_ 69,1955,Showa,30,24109,11099,13010
5 ,Akita,70_ 74,1955,Showa,30,15065,6128,8937
5 ,Akita,75_ 79,1955,Showa,30,7647,2702,4945
5 ,Akita,80_ 84,1955,Showa,30,2956,940,2016
5 ,Akita,over_85,1955,Showa,30,853,221,632
5 ,Akita,total,1960,Showa,35,1335580,644671,690909
5 ,Akita,0_ 4,1960,Showa,35,121339,61982,59357
5 ,Akita,5_ 9,1960,Showa,35,157635,80381,77254
5 ,Akita,10_ 14,1960,Showa,35,178955,90878,88077
5 ,Akita,15_ 19,1960,Showa,35,116826,55850,60976
5 ,Akita,20_ 24,1960,Showa,35,102662,45814,56848
5 ,Akita,25_ 29,1960,Showa,35,109923,52216,57707
5 ,Akita,30_ 34,1960,Showa,35,107313,52076,55237
5 ,Akita,35_ 39,1960,Showa,35,86856,39589,47267
5 ,Akita,40_ 44,1960,Showa,35,73528,34143,39385
5 ,Akita,45_ 49,1960,Showa,35,67029,31834,35195
5 ,Akita,50_ 54,1960,Showa,35,59087,28841,30246
5 ,Akita,55_ 59,1960,Showa,35,51738,25229,26509
5 ,Akita,60_ 64,1960,Showa,35,41115,19716,21399
5 ,Akita,65_ 69,1960,Showa,35,29588,13690,15898
5 ,Akita,70_ 74,1960,Showa,35,17655,7538,10117
5 ,Akita,75_ 79,1960,Showa,35,9238,3401,5837
5 ,Akita,80_ 84,1960,Showa,35,3755,1150,2605
5 ,Akita,over_85,1960,Showa,35,1338,343,995
5 ,Akita,total,1965,Showa,40,1279835,614429,665406
5 ,Akita,0_ 4,1965,Showa,40,99613,50782,48831
5 ,Akita,5_ 9,1965,Showa,40,118880,60545,58335
5 ,Akita,10_ 14,1965,Showa,40,154664,78611,76053
5 ,Akita,15_ 19,1965,Showa,40,132037,65623,66414
5 ,Akita,20_ 24,1965,Showa,40,80831,35372,45459
5 ,Akita,25_ 29,1965,Showa,40,92642,42771,49871
5 ,Akita,30_ 34,1965,Showa,40,105585,50744,54841
5 ,Akita,35_ 39,1965,Showa,40,104261,50557,53704
5 ,Akita,40_ 44,1965,Showa,40,83534,37924,45610
5 ,Akita,45_ 49,1965,Showa,40,70518,32395,38123
5 ,Akita,50_ 54,1965,Showa,40,63115,29681,33434
5 ,Akita,55_ 59,1965,Showa,40,54402,26106,28296
5 ,Akita,60_ 64,1965,Showa,40,45875,21746,24129
5 ,Akita,65_ 69,1965,Showa,40,33983,15606,18377
5 ,Akita,70_ 74,1965,Showa,40,22371,9764,12607
5 ,Akita,75_ 79,1965,Showa,40,11096,4247,6849
5 ,Akita,80_ 84,1965,Showa,40,4618,1472,3146
5 ,Akita,over_85,1965,Showa,40,1810,483,1327
5 ,Akita,total,1970,Showa,45,1241376,593232,648144
5 ,Akita,0_ 4,1970,Showa,45,86107,44103,42004
5 ,Akita,5_ 9,1970,Showa,45,99610,50751,48859
5 ,Akita,10_ 14,1970,Showa,45,117569,59931,57638
5 ,Akita,15_ 19,1970,Showa,45,117478,58615,58863
5 ,Akita,20_ 24,1970,Showa,45,96670,44109,52561
5 ,Akita,25_ 29,1970,Showa,45,81543,38588,42955
5 ,Akita,30_ 34,1970,Showa,45,91888,43197,48691
5 ,Akita,35_ 39,1970,Showa,45,103485,49703,53782
5 ,Akita,40_ 44,1970,Showa,45,100379,48527,51852
5 ,Akita,45_ 49,1970,Showa,45,80961,36541,44420
5 ,Akita,50_ 54,1970,Showa,45,67245,30719,36526
5 ,Akita,55_ 59,1970,Showa,45,58440,27120,31320
5 ,Akita,60_ 64,1970,Showa,45,49449,23061,26388
5 ,Akita,65_ 69,1970,Showa,45,39644,17947,21697
5 ,Akita,70_ 74,1970,Showa,45,27180,11632,15548
5 ,Akita,75_ 79,1970,Showa,45,15330,6011,9319
5 ,Akita,80_ 84,1970,Showa,45,6080,2057,4023
5 ,Akita,over_85,1970,Showa,45,2318,620,1698
5 ,Akita,total,1975,Showa,50,1232481,590492,641989
5 ,Akita,0_ 4,1975,Showa,50,88012,44893,43119
5 ,Akita,5_ 9,1975,Showa,50,86708,44325,42383
5 ,Akita,10_ 14,1975,Showa,50,99088,50586,48502
5 ,Akita,15_ 19,1975,Showa,50,95423,48215,47208
5 ,Akita,20_ 24,1975,Showa,50,84672,39961,44711
5 ,Akita,25_ 29,1975,Showa,50,99269,49162,50107
5 ,Akita,30_ 34,1975,Showa,50,82390,39877,42513
5 ,Akita,35_ 39,1975,Showa,50,90996,42888,48108
5 ,Akita,40_ 44,1975,Showa,50,101909,48871,53038
5 ,Akita,45_ 49,1975,Showa,50,98524,47291,51233
5 ,Akita,50_ 54,1975,Showa,50,77445,34564,42881
5 ,Akita,55_ 59,1975,Showa,50,63610,28731,34879
5 ,Akita,60_ 64,1975,Showa,50,55221,25036,30185
5 ,Akita,65_ 69,1975,Showa,50,44338,19995,24343
5 ,Akita,70_ 74,1975,Showa,50,32844,14070,18774
5 ,Akita,75_ 79,1975,Showa,50,19851,7915,11936
5 ,Akita,80_ 84,1975,Showa,50,8885,3163,5722
5 ,Akita,over_85,1975,Showa,50,3254,926,2328
5 ,Akita,total,1980,Showa,55,1256745,603403,653342
5 ,Akita,0_ 4,1980,Showa,55,85602,44173,41429
5 ,Akita,5_ 9,1980,Showa,55,90290,45957,44333
5 ,Akita,10_ 14,1980,Showa,55,87385,44667,42718
5 ,Akita,15_ 19,1980,Showa,55,85816,43632,42184
5 ,Akita,20_ 24,1980,Showa,55,73841,35519,38322
5 ,Akita,25_ 29,1980,Showa,55,95025,46883,48142
5 ,Akita,30_ 34,1980,Showa,55,102520,51792,50728
5 ,Akita,35_ 39,1980,Showa,55,82729,40102,42627
5 ,Akita,40_ 44,1980,Showa,55,90348,42423,47925
5 ,Akita,45_ 49,1980,Showa,55,99711,47450,52261
5 ,Akita,50_ 54,1980,Showa,55,96057,45646,50411
5 ,Akita,55_ 59,1980,Showa,55,74775,33004,41771
5 ,Akita,60_ 64,1980,Showa,55,60490,26932,33558
5 ,Akita,65_ 69,1980,Showa,55,50852,22501,28351
5 ,Akita,70_ 74,1980,Showa,55,38249,16463,21786
5 ,Akita,75_ 79,1980,Showa,55,25215,10017,15198
5 ,Akita,80_ 84,1980,Showa,55,12621,4570,8051
5 ,Akita,over_85,1980,Showa,55,5138,1619,3519
5 ,Akita,total,1985,Showa,60,1254032,599591,654441
5 ,Akita,0_ 4,1985,Showa,60,74332,38012,36320
5 ,Akita,5_ 9,1985,Showa,60,85883,44374,41509
5 ,Akita,10_ 14,1985,Showa,60,90187,45887,44300
5 ,Akita,15_ 19,1985,Showa,60,76409,38862,37547
5 ,Akita,20_ 24,1985,Showa,60,62094,29484,32610
5 ,Akita,25_ 29,1985,Showa,60,78886,38568,40318
5 ,Akita,30_ 34,1985,Showa,60,95179,47518,47661
5 ,Akita,35_ 39,1985,Showa,60,101628,51091,50537
5 ,Akita,40_ 44,1985,Showa,60,81326,39160,42166
5 ,Akita,45_ 49,1985,Showa,60,88092,41057,47035
5 ,Akita,50_ 54,1985,Showa,60,96866,45517,51349
5 ,Akita,55_ 59,1985,Showa,60,92785,43566,49219
5 ,Akita,60_ 64,1985,Showa,60,72208,31394,40814
5 ,Akita,65_ 69,1985,Showa,60,56670,24723,31947
5 ,Akita,70_ 74,1985,Showa,60,45231,19221,26010
5 ,Akita,75_ 79,1985,Showa,60,30891,12350,18541
5 ,Akita,80_ 84,1985,Showa,60,17054,6146,10908
5 ,Akita,over_85,1985,Showa,60,8240,2617,5623
5 ,Akita,total,1990,Heisei,2,1227478,584678,642800
5 ,Akita,0_ 4,1990,Heisei,2,60560,31025,29535
5 ,Akita,5_ 9,1990,Heisei,2,73871,37846,36025
5 ,Akita,10_ 14,1990,Heisei,2,85206,44048,41158
5 ,Akita,15_ 19,1990,Heisei,2,78919,40149,38770
5 ,Akita,20_ 24,1990,Heisei,2,54079,26461,27618
5 ,Akita,25_ 29,1990,Heisei,2,64918,31257,33661
5 ,Akita,30_ 34,1990,Heisei,2,77797,38335,39462
5 ,Akita,35_ 39,1990,Heisei,2,93822,46793,47029
5 ,Akita,40_ 44,1990,Heisei,2,99447,49804,49643
5 ,Akita,45_ 49,1990,Heisei,2,78626,37494,41132
5 ,Akita,50_ 54,1990,Heisei,2,85182,39137,46045
5 ,Akita,55_ 59,1990,Heisei,2,93539,43319,50220
5 ,Akita,60_ 64,1990,Heisei,2,89511,41368,48143
5 ,Akita,65_ 69,1990,Heisei,2,68121,29012,39109
5 ,Akita,70_ 74,1990,Heisei,2,51370,21516,29854
5 ,Akita,75_ 79,1990,Heisei,2,37732,15089,22643
5 ,Akita,80_ 84,1990,Heisei,2,22136,7903,14233
5 ,Akita,over_85,1990,Heisei,2,12214,3861,8353
5 ,Akita,total,1995,Heisei,7,1213667,577535,636132
5 ,Akita,0_ 4,1995,Heisei,7,52874,26977,25897
5 ,Akita,5_ 9,1995,Heisei,7,61862,31688,30174
5 ,Akita,10_ 14,1995,Heisei,7,74108,37928,36180
5 ,Akita,15_ 19,1995,Heisei,7,76324,39707,36617
5 ,Akita,20_ 24,1995,Heisei,7,60914,30716,30198
5 ,Akita,25_ 29,1995,Heisei,7,58983,28918,30065
5 ,Akita,30_ 34,1995,Heisei,7,67532,33168,34364
5 ,Akita,35_ 39,1995,Heisei,7,78915,39080,39835
5 ,Akita,40_ 44,1995,Heisei,7,93892,46907,46985
5 ,Akita,45_ 49,1995,Heisei,7,98309,49192,49117
5 ,Akita,50_ 54,1995,Heisei,7,77414,36696,40718
5 ,Akita,55_ 59,1995,Heisei,7,83570,38108,45462
5 ,Akita,60_ 64,1995,Heisei,7,91130,41709,49421
5 ,Akita,65_ 69,1995,Heisei,7,85394,38532,46862
5 ,Akita,70_ 74,1995,Heisei,7,62688,25567,37121
5 ,Akita,75_ 79,1995,Heisei,7,43797,17071,26726
5 ,Akita,80_ 84,1995,Heisei,7,28180,10234,17946
5 ,Akita,over_85,1995,Heisei,7,17623,5220,12403
5 ,Akita,total,2000,Heisei,12,1189279,564556,624723
5 ,Akita,0_ 4,2000,Heisei,12,47061,24007,23054
5 ,Akita,5_ 9,2000,Heisei,12,53929,27569,26360
5 ,Akita,10_ 14,2000,Heisei,12,62105,31835,30270
5 ,Akita,15_ 19,2000,Heisei,12,66266,34140,32126
5 ,Akita,20_ 24,2000,Heisei,12,58832,30453,28379
5 ,Akita,25_ 29,2000,Heisei,12,65128,32778,32350
5 ,Akita,30_ 34,2000,Heisei,12,61100,30300,30800
5 ,Akita,35_ 39,2000,Heisei,12,68529,33685,34844
5 ,Akita,40_ 44,2000,Heisei,12,78962,39182,39780
5 ,Akita,45_ 49,2000,Heisei,12,92625,46239,46386
5 ,Akita,50_ 54,2000,Heisei,12,96697,48121,48576
5 ,Akita,55_ 59,2000,Heisei,12,75961,35694,40267
5 ,Akita,60_ 64,2000,Heisei,12,82152,37095,45057
5 ,Akita,65_ 69,2000,Heisei,12,87300,39177,48123
5 ,Akita,70_ 74,2000,Heisei,12,78713,34099,44614
5 ,Akita,75_ 79,2000,Heisei,12,54634,20850,33784
5 ,Akita,80_ 84,2000,Heisei,12,33739,11757,21982
5 ,Akita,over_85,2000,Heisei,12,25378,7455,17923
5 ,Akita,total,2005,Heisei,17,1145501,540539,604962
5 ,Akita,0_ 4,2005,Heisei,17,40875,20837,20038
5 ,Akita,5_ 9,2005,Heisei,17,47734,24374,23360
5 ,Akita,10_ 14,2005,Heisei,17,53898,27585,26313
5 ,Akita,15_ 19,2005,Heisei,17,54989,28284,26705
5 ,Akita,20_ 24,2005,Heisei,17,48817,24921,23896
5 ,Akita,25_ 29,2005,Heisei,17,59269,30275,28994
5 ,Akita,30_ 34,2005,Heisei,17,64754,32500,32254
5 ,Akita,35_ 39,2005,Heisei,17,60821,30070,30751
5 ,Akita,40_ 44,2005,Heisei,17,67800,33258,34542
5 ,Akita,45_ 49,2005,Heisei,17,77484,38243,39241
5 ,Akita,50_ 54,2005,Heisei,17,91054,45180,45874
5 ,Akita,55_ 59,2005,Heisei,17,94755,46751,48004
5 ,Akita,60_ 64,2005,Heisei,17,74545,34741,39804
5 ,Akita,65_ 69,2005,Heisei,17,79029,35091,43938
5 ,Akita,70_ 74,2005,Heisei,17,81294,35191,46103
5 ,Akita,75_ 79,2005,Heisei,17,69652,28331,41321
5 ,Akita,80_ 84,2005,Heisei,17,44071,15206,28865
5 ,Akita,over_85,2005,Heisei,17,34147,9414,24733
5 ,Akita,total,2010,Heisei,22,1085997,509926,576071
5 ,Akita,0_ 4,2010,Heisei,22,35808,18353,17455
5 ,Akita,5_ 9,2010,Heisei,22,40828,20792,20036
5 ,Akita,10_ 14,2010,Heisei,22,47425,24190,23235
5 ,Akita,15_ 19,2010,Heisei,22,47154,24140,23014
5 ,Akita,20_ 24,2010,Heisei,22,38110,19215,18895
5 ,Akita,25_ 29,2010,Heisei,22,47960,24314,23646
5 ,Akita,30_ 34,2010,Heisei,22,58600,30041,28559
5 ,Akita,35_ 39,2010,Heisei,22,63760,31984,31776
5 ,Akita,40_ 44,2010,Heisei,22,60062,29681,30381
5 ,Akita,45_ 49,2010,Heisei,22,66534,32504,34030
5 ,Akita,50_ 54,2010,Heisei,22,75834,37224,38610
5 ,Akita,55_ 59,2010,Heisei,22,88920,43616,45304
5 ,Akita,60_ 64,2010,Heisei,22,92699,45349,47350
5 ,Akita,65_ 69,2010,Heisei,22,71496,32717,38779
5 ,Akita,70_ 74,2010,Heisei,22,73936,31848,42088
5 ,Akita,75_ 79,2010,Heisei,22,72676,29737,42939
5 ,Akita,80_ 84,2010,Heisei,22,56552,20655,35897
5 ,Akita,over_85,2010,Heisei,22,45790,12327,33463
5 ,Akita,total,2015,Heisei,27,1023119,480336,542783
5 ,Akita,0_ 4,2015,Heisei,27,30148,15361,14787
5 ,Akita,5_ 9,2015,Heisei,27,35693,18357,17336
5 ,Akita,10_ 14,2015,Heisei,27,40200,20419,19781
5 ,Akita,15_ 19,2015,Heisei,27,41948,21506,20442
5 ,Akita,20_ 24,2015,Heisei,27,32642,16952,15690
5 ,Akita,25_ 29,2015,Heisei,27,37798,19217,18581
5 ,Akita,30_ 34,2015,Heisei,27,47415,24117,23298
5 ,Akita,35_ 39,2015,Heisei,27,57799,29486,28313
5 ,Akita,40_ 44,2015,Heisei,27,62676,31292,31384
5 ,Akita,45_ 49,2015,Heisei,27,58721,28941,29780
5 ,Akita,50_ 54,2015,Heisei,27,65049,31647,33402
5 ,Akita,55_ 59,2015,Heisei,27,74334,36265,38069
5 ,Akita,60_ 64,2015,Heisei,27,86855,42170,44685
5 ,Akita,65_ 69,2015,Heisei,27,89176,43086,46090
5 ,Akita,70_ 74,2015,Heisei,27,66977,29908,37069
5 ,Akita,75_ 79,2015,Heisei,27,66525,27288,39237
5 ,Akita,80_ 84,2015,Heisei,27,60142,22573,37569
5 ,Akita,over_85,2015,Heisei,27,60481,16970,43511
6 ,Yamagata,total,1920,Taisho,9,968925,478328,490597
6 ,Yamagata,0_ 4,1920,Taisho,9,136614,68393,68221
6 ,Yamagata,5_ 9,1920,Taisho,9,126456,63710,62746
6 ,Yamagata,10_ 14,1920,Taisho,9,109146,54950,54196
6 ,Yamagata,15_ 19,1920,Taisho,9,94689,47366,47323
6 ,Yamagata,20_ 24,1920,Taisho,9,74395,36620,37775
6 ,Yamagata,25_ 29,1920,Taisho,9,65747,32777,32970
6 ,Yamagata,30_ 34,1920,Taisho,9,62772,31047,31725
6 ,Yamagata,35_ 39,1920,Taisho,9,58078,28231,29847
6 ,Yamagata,40_ 44,1920,Taisho,9,54372,26799,27573
6 ,Yamagata,45_ 49,1920,Taisho,9,44546,22128,22418
6 ,Yamagata,50_ 54,1920,Taisho,9,40751,19953,20798
6 ,Yamagata,55_ 59,1920,Taisho,9,31344,15089,16255
6 ,Yamagata,60_ 64,1920,Taisho,9,26436,12429,14007
6 ,Yamagata,65_ 69,1920,Taisho,9,21133,9590,11543
6 ,Yamagata,70_ 74,1920,Taisho,9,13539,5809,7730
6 ,Yamagata,75_ 79,1920,Taisho,9,6310,2523,3787
6 ,Yamagata,over_80,1920,Taisho,9,2597,914,1683
6 ,Yamagata,total,1925,Taisho,14,1027297,506303,520994
6 ,Yamagata,0_ 4,1925,Taisho,14,155349,77968,77381
6 ,Yamagata,5_ 9,1925,Taisho,14,127421,63799,63622
6 ,Yamagata,10_ 14,1925,Taisho,14,121468,61328,60140
6 ,Yamagata,15_ 19,1925,Taisho,14,99327,49756,49571
6 ,Yamagata,20_ 24,1925,Taisho,14,81765,39757,42008
6 ,Yamagata,25_ 29,1925,Taisho,14,69520,34617,34903
6 ,Yamagata,30_ 34,1925,Taisho,14,61533,30691,30842
6 ,Yamagata,35_ 39,1925,Taisho,14,59516,29521,29995
6 ,Yamagata,40_ 44,1925,Taisho,14,54799,26749,28050
6 ,Yamagata,45_ 49,1925,Taisho,14,50929,24907,26022
6 ,Yamagata,50_ 54,1925,Taisho,14,40753,19987,20766
6 ,Yamagata,55_ 59,1925,Taisho,14,35728,17122,18606
6 ,Yamagata,60_ 64,1925,Taisho,14,26059,12065,13994
6 ,Yamagata,65_ 69,1925,Taisho,14,19706,8715,10991
6 ,Yamagata,70_ 74,1925,Taisho,14,13608,5686,7922
6 ,Yamagata,75_ 79,1925,Taisho,14,6994,2709,4285
6 ,Yamagata,80_ 84,1925,Taisho,14,2304,777,1527
6 ,Yamagata,over_85,1925,Taisho,14,518,149,369
6 ,Yamagata,total,1930,Showa,5,1080034,532377,547657
6 ,Yamagata,0_ 4,1930,Showa,5,163515,82066,81449
6 ,Yamagata,5_ 9,1930,Showa,5,144307,72528,71779
6 ,Yamagata,10_ 14,1930,Showa,5,120954,60661,60293
6 ,Yamagata,15_ 19,1930,Showa,5,106667,54187,52480
6 ,Yamagata,20_ 24,1930,Showa,5,83076,40532,42544
6 ,Yamagata,25_ 29,1930,Showa,5,75517,37076,38441
6 ,Yamagata,30_ 34,1930,Showa,5,65426,32651,32775
6 ,Yamagata,35_ 39,1930,Showa,5,58637,29316,29321
6 ,Yamagata,40_ 44,1930,Showa,5,56465,28065,28400
6 ,Yamagata,45_ 49,1930,Showa,5,51307,24925,26382
6 ,Yamagata,50_ 54,1930,Showa,5,46555,22572,23983
6 ,Yamagata,55_ 59,1930,Showa,5,35902,17150,18752
6 ,Yamagata,60_ 64,1930,Showa,5,29439,13445,15994
6 ,Yamagata,65_ 69,1930,Showa,5,19450,8499,10951
6 ,Yamagata,70_ 74,1930,Showa,5,12702,5115,7587
6 ,Yamagata,75_ 79,1930,Showa,5,6843,2551,4292
6 ,Yamagata,over_80,1930,Showa,5,3272,1038,2234
6 ,Yamagata,total,1935,Showa,10,1116822,549060,567762
6 ,Yamagata,0_ 4,1935,Showa,10,163772,82560,81212
6 ,Yamagata,5_ 9,1935,Showa,10,153834,77022,76812
6 ,Yamagata,10_ 14,1935,Showa,10,135454,68528,66926
6 ,Yamagata,15_ 19,1935,Showa,10,98432,49439,48993
6 ,Yamagata,20_ 24,1935,Showa,10,84114,40448,43666
6 ,Yamagata,25_ 29,1935,Showa,10,74676,36254,38422
6 ,Yamagata,30_ 34,1935,Showa,10,71762,35175,36587
6 ,Yamagata,35_ 39,1935,Showa,10,62388,31146,31242
6 ,Yamagata,40_ 44,1935,Showa,10,55607,27817,27790
6 ,Yamagata,45_ 49,1935,Showa,10,53173,26350,26823
6 ,Yamagata,50_ 54,1935,Showa,10,47091,22668,24423
6 ,Yamagata,55_ 59,1935,Showa,10,41402,19575,21827
6 ,Yamagata,60_ 64,1935,Showa,10,30057,13866,16191
6 ,Yamagata,65_ 69,1935,Showa,10,22053,9506,12547
6 ,Yamagata,70_ 74,1935,Showa,10,12795,5162,7633
6 ,Yamagata,75_ 79,1935,Showa,10,6721,2434,4287
6 ,Yamagata,over_80,1935,Showa,10,3491,1110,2381
6 ,Yamagata,total,1940,Showa,15,1119267,548353,570914
6 ,Yamagata,0_ 4,1940,Showa,15,153611,77496,76115
6 ,Yamagata,5_ 9,1940,Showa,15,152023,76482,75541
6 ,Yamagata,10_ 14,1940,Showa,15,142801,72212,70589
6 ,Yamagata,15_ 19,1940,Showa,15,102781,50377,52404
6 ,Yamagata,20_ 24,1940,Showa,15,81685,42070,39615
6 ,Yamagata,25_ 29,1940,Showa,15,71780,34150,37630
6 ,Yamagata,30_ 34,1940,Showa,15,67783,32102,35681
6 ,Yamagata,35_ 39,1940,Showa,15,66438,31987,34451
6 ,Yamagata,40_ 44,1940,Showa,15,57773,28491,29282
6 ,Yamagata,45_ 49,1940,Showa,15,51700,25496,26204
6 ,Yamagata,50_ 54,1940,Showa,15,48397,23676,24721
6 ,Yamagata,55_ 59,1940,Showa,15,41375,19332,22043
6 ,Yamagata,60_ 64,1940,Showa,15,34411,15673,18738
6 ,Yamagata,65_ 69,1940,Showa,15,22462,9735,12727
6 ,Yamagata,70_ 74,1940,Showa,15,14277,5647,8630
6 ,Yamagata,75_ 79,1940,Showa,15,6632,2409,4223
6 ,Yamagata,80_ 84,1940,Showa,15,2548,794,1754
6 ,Yamagata,over_85,1940,Showa,15,787,223,564
6 ,Yamagata,total,1945,Showa,20,1326350,612300,714050
6 ,Yamagata,1_ 5,1945,Showa,20,176027,89053,86974
6 ,Yamagata,6_ 10,1945,Showa,20,172686,86942,85744
6 ,Yamagata,11_ 15,1945,Showa,20,169587,85439,84148
6 ,Yamagata,16_ 20,1945,Showa,20,150146,72119,78027
6 ,Yamagata,21_ 25,1945,Showa,20,99472,34023,65449
6 ,Yamagata,26_ 30,1945,Showa,20,76512,25432,51080
6 ,Yamagata,31_ 35,1945,Showa,20,78413,30913,47500
6 ,Yamagata,36_ 40,1945,Showa,20,76668,34625,42043
6 ,Yamagata,41_ 45,1945,Showa,20,72508,35310,37198
6 ,Yamagata,46_ 50,1945,Showa,20,61747,30720,31027
6 ,Yamagata,51_ 55,1945,Showa,20,52340,25997,26343
6 ,Yamagata,56_ 60,1945,Showa,20,47294,22682,24612
6 ,Yamagata,61_ 65,1945,Showa,20,37582,16895,20687
6 ,Yamagata,66_ 70,1945,Showa,20,28337,12095,16242
6 ,Yamagata,71_ 75,1945,Showa,20,16026,6349,9677
6 ,Yamagata,76_ 80,1945,Showa,20,7670,2694,4976
6 ,Yamagata,81_ 85,1945,Showa,20,2639,830,1809
6 ,Yamagata,86以上,1945,Showa,20,696,182,514
6 ,Yamagata,total,1950,Showa,25,1357347,660555,696792
6 ,Yamagata,0_ 4,1950,Showa,25,174404,89426,84978
6 ,Yamagata,5_ 9,1950,Showa,25,158875,80450,78425
6 ,Yamagata,10_ 14,1950,Showa,25,160391,80938,79453
6 ,Yamagata,15_ 19,1950,Showa,25,147672,74026,73646
6 ,Yamagata,20_ 24,1950,Showa,25,126455,60967,65488
6 ,Yamagata,25_ 29,1950,Showa,25,97959,43843,54116
6 ,Yamagata,30_ 34,1950,Showa,25,79679,36514,43165
6 ,Yamagata,35_ 39,1950,Showa,25,78216,36977,41239
6 ,Yamagata,40_ 44,1950,Showa,25,70713,34043,36670
6 ,Yamagata,45_ 49,1950,Showa,25,66102,32589,33513
6 ,Yamagata,50_ 54,1950,Showa,25,54793,27354,27439
6 ,Yamagata,55_ 59,1950,Showa,25,45492,22286,23206
6 ,Yamagata,60_ 64,1950,Showa,25,38659,18079,20580
6 ,Yamagata,65_ 69,1950,Showa,25,27563,11773,15790
6 ,Yamagata,70_ 74,1950,Showa,25,18015,7118,10897
6 ,Yamagata,75_ 79,1950,Showa,25,8387,2997,5390
6 ,Yamagata,over_80,1950,Showa,25,3910,1149,2761
6 ,Yamagata,total,1955,Showa,30,1353649,651737,701912
6 ,Yamagata,0_ 4,1955,Showa,30,147494,75385,72109
6 ,Yamagata,5_ 9,1955,Showa,30,166235,85220,81015
6 ,Yamagata,10_ 14,1955,Showa,30,153298,77619,75679
6 ,Yamagata,15_ 19,1955,Showa,30,133943,64945,68998
6 ,Yamagata,20_ 24,1955,Showa,30,115629,52745,62884
6 ,Yamagata,25_ 29,1955,Showa,30,110469,52127,58342
6 ,Yamagata,30_ 34,1955,Showa,30,91364,40907,50457
6 ,Yamagata,35_ 39,1955,Showa,30,74929,34283,40646
6 ,Yamagata,40_ 44,1955,Showa,30,74110,34915,39195
6 ,Yamagata,45_ 49,1955,Showa,30,66911,32048,34863
6 ,Yamagata,50_ 54,1955,Showa,30,62009,30353,31656
6 ,Yamagata,55_ 59,1955,Showa,30,50126,24774,25352
6 ,Yamagata,60_ 64,1955,Showa,30,39935,19016,20919
6 ,Yamagata,65_ 69,1955,Showa,30,31204,14018,17186
6 ,Yamagata,70_ 74,1955,Showa,30,19839,7892,11947
6 ,Yamagata,75_ 79,1955,Showa,30,10981,3959,7022
6 ,Yamagata,80_ 84,1955,Showa,30,3979,1229,2750
6 ,Yamagata,over_85,1955,Showa,30,1192,302,890
6 ,Yamagata,total,1960,Showa,35,1320664,630997,689667
6 ,Yamagata,0_ 4,1960,Showa,35,113821,58177,55644
6 ,Yamagata,5_ 9,1960,Showa,35,144984,74110,70874
6 ,Yamagata,10_ 14,1960,Showa,35,163771,83958,79813
6 ,Yamagata,15_ 19,1960,Showa,35,115811,55118,60693
6 ,Yamagata,20_ 24,1960,Showa,35,99216,43798,55418
6 ,Yamagata,25_ 29,1960,Showa,35,103434,48784,54650
6 ,Yamagata,30_ 34,1960,Showa,35,105948,50645,55303
6 ,Yamagata,35_ 39,1960,Showa,35,88473,39493,48980
6 ,Yamagata,40_ 44,1960,Showa,35,72309,32844,39465
6 ,Yamagata,45_ 49,1960,Showa,35,70913,33233,37680
6 ,Yamagata,50_ 54,1960,Showa,35,63182,30009,33173
6 ,Yamagata,55_ 59,1960,Showa,35,57564,27734,29830
6 ,Yamagata,60_ 64,1960,Showa,35,44749,21500,23249
6 ,Yamagata,65_ 69,1960,Showa,35,33221,15205,18016
6 ,Yamagata,70_ 74,1960,Showa,35,23420,9723,13697
6 ,Yamagata,75_ 79,1960,Showa,35,12708,4530,8178
6 ,Yamagata,80_ 84,1960,Showa,35,5450,1703,3747
6 ,Yamagata,over_85,1960,Showa,35,1690,433,1257
6 ,Yamagata,total,1965,Showa,40,1263103,605185,657918
6 ,Yamagata,0_ 4,1965,Showa,40,94913,48615,46298
6 ,Yamagata,5_ 9,1965,Showa,40,111075,56693,54382
6 ,Yamagata,10_ 14,1965,Showa,40,142584,72619,69965
6 ,Yamagata,15_ 19,1965,Showa,40,126487,63812,62675
6 ,Yamagata,20_ 24,1965,Showa,40,79733,35771,43962
6 ,Yamagata,25_ 29,1965,Showa,40,86366,40697,45669
6 ,Yamagata,30_ 34,1965,Showa,40,98851,47602,51249
6 ,Yamagata,35_ 39,1965,Showa,40,102877,49378,53499
6 ,Yamagata,40_ 44,1965,Showa,40,85758,38304,47454
6 ,Yamagata,45_ 49,1965,Showa,40,69609,31638,37971
6 ,Yamagata,50_ 54,1965,Showa,40,67257,31437,35820
6 ,Yamagata,55_ 59,1965,Showa,40,58802,27723,31079
6 ,Yamagata,60_ 64,1965,Showa,40,51335,24181,27154
6 ,Yamagata,65_ 69,1965,Showa,40,37970,17479,20491
6 ,Yamagata,70_ 74,1965,Showa,40,25322,10827,14495
6 ,Yamagata,75_ 79,1965,Showa,40,15287,5809,9478
6 ,Yamagata,80_ 84,1965,Showa,40,6318,1959,4359
6 ,Yamagata,over_85,1965,Showa,40,2559,641,1918
6 ,Yamagata,total,1970,Showa,45,1225618,587515,638103
6 ,Yamagata,0_ 4,1970,Showa,45,83359,42884,40475
6 ,Yamagata,5_ 9,1970,Showa,45,94167,48292,45875
6 ,Yamagata,10_ 14,1970,Showa,45,110351,56328,54023
6 ,Yamagata,15_ 19,1970,Showa,45,115261,57940,57321
6 ,Yamagata,20_ 24,1970,Showa,45,94336,44832,49504
6 ,Yamagata,25_ 29,1970,Showa,45,77188,37789,39399
6 ,Yamagata,30_ 34,1970,Showa,45,85054,40987,44067
6 ,Yamagata,35_ 39,1970,Showa,45,96633,46639,49994
6 ,Yamagata,40_ 44,1970,Showa,45,98645,47346,51299
6 ,Yamagata,45_ 49,1970,Showa,45,83585,37016,46569
6 ,Yamagata,50_ 54,1970,Showa,45,66866,30176,36690
6 ,Yamagata,55_ 59,1970,Showa,45,62038,28755,33283
6 ,Yamagata,60_ 64,1970,Showa,45,53597,24580,29017
6 ,Yamagata,65_ 69,1970,Showa,45,45218,20369,24849
6 ,Yamagata,70_ 74,1970,Showa,45,30551,13190,17361
6 ,Yamagata,75_ 79,1970,Showa,45,17388,6736,10652
6 ,Yamagata,80_ 84,1970,Showa,45,8284,2824,5460
6 ,Yamagata,over_85,1970,Showa,45,3097,832,2265
6 ,Yamagata,total,1975,Showa,50,1220302,586918,633384
6 ,Yamagata,0_ 4,1975,Showa,50,88260,44977,43283
6 ,Yamagata,5_ 9,1975,Showa,50,83833,43001,40832
6 ,Yamagata,10_ 14,1975,Showa,50,93842,48106,45736
6 ,Yamagata,15_ 19,1975,Showa,50,92595,46914,45681
6 ,Yamagata,20_ 24,1975,Showa,50,83194,39925,43269
6 ,Yamagata,25_ 29,1975,Showa,50,94069,48047,46022
6 ,Yamagata,30_ 34,1975,Showa,50,78298,39216,39082
6 ,Yamagata,35_ 39,1975,Showa,50,84692,41005,43687
6 ,Yamagata,40_ 44,1975,Showa,50,95721,46215,49506
6 ,Yamagata,45_ 49,1975,Showa,50,98341,46831,51510
6 ,Yamagata,50_ 54,1975,Showa,50,80765,35701,45064
6 ,Yamagata,55_ 59,1975,Showa,50,63848,28613,35235
6 ,Yamagata,60_ 64,1975,Showa,50,59593,27093,32500
6 ,Yamagata,65_ 69,1975,Showa,50,48608,21602,27006
6 ,Yamagata,70_ 74,1975,Showa,50,37680,16066,21614
6 ,Yamagata,75_ 79,1975,Showa,50,22009,8682,13327
6 ,Yamagata,80_ 84,1975,Showa,50,10402,3604,6798
6 ,Yamagata,over_85,1975,Showa,50,4438,1254,3184
6 ,Yamagata,total,1980,Showa,55,1251917,605407,646510
6 ,Yamagata,0_ 4,1980,Showa,55,87122,44631,42491
6 ,Yamagata,5_ 9,1980,Showa,55,90633,46165,44468
6 ,Yamagata,10_ 14,1980,Showa,55,84949,43603,41346
6 ,Yamagata,15_ 19,1980,Showa,55,83916,42923,40993
6 ,Yamagata,20_ 24,1980,Showa,55,73355,35927,37428
6 ,Yamagata,25_ 29,1980,Showa,55,93109,47038,46071
6 ,Yamagata,30_ 34,1980,Showa,55,97991,51262,46729
6 ,Yamagata,35_ 39,1980,Showa,55,79474,39987,39487
6 ,Yamagata,40_ 44,1980,Showa,55,84580,40974,43606
6 ,Yamagata,45_ 49,1980,Showa,55,94149,45245,48904
6 ,Yamagata,50_ 54,1980,Showa,55,96403,45604,50799
6 ,Yamagata,55_ 59,1980,Showa,55,78568,34345,44223
6 ,Yamagata,60_ 64,1980,Showa,55,61067,27074,33993
6 ,Yamagata,65_ 69,1980,Showa,55,54959,24359,30600
6 ,Yamagata,70_ 74,1980,Showa,55,42073,17851,24222
6 ,Yamagata,75_ 79,1980,Showa,55,29174,11502,17672
6 ,Yamagata,80_ 84,1980,Showa,55,14148,5105,9043
6 ,Yamagata,over_85,1980,Showa,55,6239,1806,4433
6 ,Yamagata,total,1985,Showa,60,1261662,609417,652245
6 ,Yamagata,0_ 4,1985,Showa,60,77896,39947,37949
6 ,Yamagata,5_ 9,1985,Showa,60,87205,44713,42492
6 ,Yamagata,10_ 14,1985,Showa,60,90752,46231,44521
6 ,Yamagata,15_ 19,1985,Showa,60,77097,39353,37744
6 ,Yamagata,20_ 24,1985,Showa,60,65909,32282,33627
6 ,Yamagata,25_ 29,1985,Showa,60,78984,39353,39631
6 ,Yamagata,30_ 34,1985,Showa,60,93861,47923,45938
6 ,Yamagata,35_ 39,1985,Showa,60,97571,50929,46642
6 ,Yamagata,40_ 44,1985,Showa,60,78631,39426,39205
6 ,Yamagata,45_ 49,1985,Showa,60,83047,39991,43056
6 ,Yamagata,50_ 54,1985,Showa,60,91936,43837,48099
6 ,Yamagata,55_ 59,1985,Showa,60,93588,43775,49813
6 ,Yamagata,60_ 64,1985,Showa,60,75595,32580,43015
6 ,Yamagata,65_ 69,1985,Showa,60,57088,24759,32329
6 ,Yamagata,70_ 74,1985,Showa,60,49004,20961,28043
6 ,Yamagata,75_ 79,1985,Showa,60,34190,13470,20720
6 ,Yamagata,80_ 84,1985,Showa,60,19808,6989,12819
6 ,Yamagata,over_85,1985,Showa,60,9435,2864,6571
6 ,Yamagata,total,1990,Heisei,2,1258390,607041,651349
6 ,Yamagata,0_ 4,1990,Heisei,2,68403,34951,33452
6 ,Yamagata,5_ 9,1990,Heisei,2,78298,40096,38202
6 ,Yamagata,10_ 14,1990,Heisei,2,87123,44703,42420
6 ,Yamagata,15_ 19,1990,Heisei,2,81919,41651,40268
6 ,Yamagata,20_ 24,1990,Heisei,2,59908,29610,30298
6 ,Yamagata,25_ 29,1990,Heisei,2,68868,34134,34734
6 ,Yamagata,30_ 34,1990,Heisei,2,79582,39972,39610
6 ,Yamagata,35_ 39,1990,Heisei,2,93798,47830,45968
6 ,Yamagata,40_ 44,1990,Heisei,2,96633,50382,46251
6 ,Yamagata,45_ 49,1990,Heisei,2,76948,38394,38554
6 ,Yamagata,50_ 54,1990,Heisei,2,81274,38885,42389
6 ,Yamagata,55_ 59,1990,Heisei,2,89576,42208,47368
6 ,Yamagata,60_ 64,1990,Heisei,2,90694,41767,48927
6 ,Yamagata,65_ 69,1990,Heisei,2,71762,30302,41460
6 ,Yamagata,70_ 74,1990,Heisei,2,51986,21783,30203
6 ,Yamagata,75_ 79,1990,Heisei,2,41441,16648,24793
6 ,Yamagata,80_ 84,1990,Heisei,2,24810,8871,15939
6 ,Yamagata,over_85,1990,Heisei,2,14578,4325,10253
6 ,Yamagata,total,1995,Heisei,7,1256958,607316,649642
6 ,Yamagata,0_ 4,1995,Heisei,7,60414,30819,29595
6 ,Yamagata,5_ 9,1995,Heisei,7,69552,35491,34061
6 ,Yamagata,10_ 14,1995,Heisei,7,78630,40265,38365
6 ,Yamagata,15_ 19,1995,Heisei,7,79743,40986,38757
6 ,Yamagata,20_ 24,1995,Heisei,7,67937,34567,33370
6 ,Yamagata,25_ 29,1995,Heisei,7,64976,32475,32501
6 ,Yamagata,30_ 34,1995,Heisei,7,71395,35726,35669
6 ,Yamagata,35_ 39,1995,Heisei,7,80967,40839,40128
6 ,Yamagata,40_ 44,1995,Heisei,7,94252,48215,46037
6 ,Yamagata,45_ 49,1995,Heisei,7,96353,50356,45997
6 ,Yamagata,50_ 54,1995,Heisei,7,76215,37896,38319
6 ,Yamagata,55_ 59,1995,Heisei,7,80066,38016,42050
6 ,Yamagata,60_ 64,1995,Heisei,7,87347,40702,46645
6 ,Yamagata,65_ 69,1995,Heisei,7,86427,38926,47501
6 ,Yamagata,70_ 74,1995,Heisei,7,66254,27005,39249
6 ,Yamagata,75_ 79,1995,Heisei,7,44780,17641,27139
6 ,Yamagata,80_ 84,1995,Heisei,7,31136,11341,19795
6 ,Yamagata,over_85,1995,Heisei,7,20220,5856,14364
6 ,Yamagata,total,2000,Heisei,12,1244147,601372,642775
6 ,Yamagata,0_ 4,2000,Heisei,12,55564,28472,27092
6 ,Yamagata,5_ 9,2000,Heisei,12,60881,30952,29929
6 ,Yamagata,10_ 14,2000,Heisei,12,69737,35576,34161
6 ,Yamagata,15_ 19,2000,Heisei,12,70929,36434,34495
6 ,Yamagata,20_ 24,2000,Heisei,12,65859,34279,31580
6 ,Yamagata,25_ 29,2000,Heisei,12,71998,36671,35327
6 ,Yamagata,30_ 34,2000,Heisei,12,67204,33766,33438
6 ,Yamagata,35_ 39,2000,Heisei,12,72495,36256,36239
6 ,Yamagata,40_ 44,2000,Heisei,12,81315,40978,40337
6 ,Yamagata,45_ 49,2000,Heisei,12,93686,47923,45763
6 ,Yamagata,50_ 54,2000,Heisei,12,95248,49534,45714
6 ,Yamagata,55_ 59,2000,Heisei,12,74945,36981,37964
6 ,Yamagata,60_ 64,2000,Heisei,12,78421,36843,41578
6 ,Yamagata,65_ 69,2000,Heisei,12,83600,38154,45446
6 ,Yamagata,70_ 74,2000,Heisei,12,80080,34771,45309
6 ,Yamagata,75_ 79,2000,Heisei,12,58377,22539,35838
6 ,Yamagata,80_ 84,2000,Heisei,12,35039,12557,22482
6 ,Yamagata,over_85,2000,Heisei,12,28494,8511,19983
6 ,Yamagata,total,2005,Heisei,17,1216181,585023,631158
6 ,Yamagata,0_ 4,2005,Heisei,17,50562,25744,24818
6 ,Yamagata,5_ 9,2005,Heisei,17,55438,28432,27006
6 ,Yamagata,10_ 14,2005,Heisei,17,60653,30903,29750
6 ,Yamagata,15_ 19,2005,Heisei,17,63299,32284,31015
6 ,Yamagata,20_ 24,2005,Heisei,17,58510,30038,28472
6 ,Yamagata,25_ 29,2005,Heisei,17,67347,34697,32650
6 ,Yamagata,30_ 34,2005,Heisei,17,72051,36297,35754
6 ,Yamagata,35_ 39,2005,Heisei,17,66771,33366,33405
6 ,Yamagata,40_ 44,2005,Heisei,17,71912,35790,36122
6 ,Yamagata,45_ 49,2005,Heisei,17,80208,40148,40060
6 ,Yamagata,50_ 54,2005,Heisei,17,92142,46723,45419
6 ,Yamagata,55_ 59,2005,Heisei,17,93296,48067,45229
6 ,Yamagata,60_ 64,2005,Heisei,17,73494,35812,37682
6 ,Yamagata,65_ 69,2005,Heisei,17,75514,34971,40543
6 ,Yamagata,70_ 74,2005,Heisei,17,78130,34621,43509
6 ,Yamagata,75_ 79,2005,Heisei,17,71343,29315,42028
6 ,Yamagata,80_ 84,2005,Heisei,17,47691,16675,31016
6 ,Yamagata,over_85,2005,Heisei,17,37235,10783,26452
6 ,Yamagata,total,2010,Heisei,22,1168924,560643,608281
6 ,Yamagata,0_ 4,2010,Heisei,22,44727,22992,21735
6 ,Yamagata,5_ 9,2010,Heisei,22,50064,25490,24574
6 ,Yamagata,10_ 14,2010,Heisei,22,54968,28196,26772
6 ,Yamagata,15_ 19,2010,Heisei,22,54898,27867,27031
6 ,Yamagata,20_ 24,2010,Heisei,22,48242,24314,23928
6 ,Yamagata,25_ 29,2010,Heisei,22,57149,29089,28060
6 ,Yamagata,30_ 34,2010,Heisei,22,66445,34173,32272
6 ,Yamagata,35_ 39,2010,Heisei,22,70649,35653,34996
6 ,Yamagata,40_ 44,2010,Heisei,22,65714,32755,32959
6 ,Yamagata,45_ 49,2010,Heisei,22,70659,35053,35606
6 ,Yamagata,50_ 54,2010,Heisei,22,78802,39193,39609
6 ,Yamagata,55_ 59,2010,Heisei,22,90309,45433,44876
6 ,Yamagata,60_ 64,2010,Heisei,22,91243,46540,44703
6 ,Yamagata,65_ 69,2010,Heisei,22,70716,33920,36796
6 ,Yamagata,70_ 74,2010,Heisei,22,70956,31895,39061
6 ,Yamagata,75_ 79,2010,Heisei,22,70441,29754,40687
6 ,Yamagata,80_ 84,2010,Heisei,22,59023,22188,36835
6 ,Yamagata,over_85,2010,Heisei,22,50586,14042,36544
6 ,Yamagata,total,2015,Heisei,27,1123891,540226,583665
6 ,Yamagata,0_ 4,2015,Heisei,27,40221,20421,19800
6 ,Yamagata,5_ 9,2015,Heisei,27,45194,23267,21927
6 ,Yamagata,10_ 14,2015,Heisei,27,50345,25665,24680
6 ,Yamagata,15_ 19,2015,Heisei,27,50953,26193,24760
6 ,Yamagata,20_ 24,2015,Heisei,27,42706,22064,20642
6 ,Yamagata,25_ 29,2015,Heisei,27,48721,24865,23856
6 ,Yamagata,30_ 34,2015,Heisei,27,57869,29443,28426
6 ,Yamagata,35_ 39,2015,Heisei,27,66734,34229,32505
6 ,Yamagata,40_ 44,2015,Heisei,27,70586,35599,34987
6 ,Yamagata,45_ 49,2015,Heisei,27,65223,32489,32734
6 ,Yamagata,50_ 54,2015,Heisei,27,69986,34753,35233
6 ,Yamagata,55_ 59,2015,Heisei,27,77806,38606,39200
6 ,Yamagata,60_ 64,2015,Heisei,27,88752,44297,44455
6 ,Yamagata,65_ 69,2015,Heisei,27,88099,44376,43723
6 ,Yamagata,70_ 74,2015,Heisei,27,66887,31424,35463
6 ,Yamagata,75_ 79,2015,Heisei,27,64562,27847,36715
6 ,Yamagata,80_ 84,2015,Heisei,27,59243,23024,36219
6 ,Yamagata,over_85,2015,Heisei,27,65562,18984,46578
7 ,Fukushima,total,1920,Taisho,9,1362750,673525,689225
7 ,Fukushima,0_ 4,1920,Taisho,9,200124,100356,99768
7 ,Fukushima,5_ 9,1920,Taisho,9,177205,88993,88212
7 ,Fukushima,10_ 14,1920,Taisho,9,151489,75696,75793
7 ,Fukushima,15_ 19,1920,Taisho,9,129891,63642,66249
7 ,Fukushima,20_ 24,1920,Taisho,9,104349,49594,54755
7 ,Fukushima,25_ 29,1920,Taisho,9,96021,47549,48472
7 ,Fukushima,30_ 34,1920,Taisho,9,87524,43237,44287
7 ,Fukushima,35_ 39,1920,Taisho,9,78703,38250,40453
7 ,Fukushima,40_ 44,1920,Taisho,9,75946,37663,38283
7 ,Fukushima,45_ 49,1920,Taisho,9,61409,30840,30569
7 ,Fukushima,50_ 54,1920,Taisho,9,54123,27065,27058
7 ,Fukushima,55_ 59,1920,Taisho,9,43432,21757,21675
7 ,Fukushima,60_ 64,1920,Taisho,9,37400,18698,18702
7 ,Fukushima,65_ 69,1920,Taisho,9,29598,14169,15429
7 ,Fukushima,70_ 74,1920,Taisho,9,20350,9442,10908
7 ,Fukushima,75_ 79,1920,Taisho,9,10307,4577,5730
7 ,Fukushima,over_80,1920,Taisho,9,4879,1997,2882
7 ,Fukushima,total,1925,Taisho,14,1437596,710606,726990
7 ,Fukushima,0_ 4,1925,Taisho,14,221355,110938,110417
7 ,Fukushima,5_ 9,1925,Taisho,14,185239,92989,92250
7 ,Fukushima,10_ 14,1925,Taisho,14,168731,84274,84457
7 ,Fukushima,15_ 19,1925,Taisho,14,133415,65218,68197
7 ,Fukushima,20_ 24,1925,Taisho,14,109742,52845,56897
7 ,Fukushima,25_ 29,1925,Taisho,14,96456,47916,48540
7 ,Fukushima,30_ 34,1925,Taisho,14,88863,44545,44318
7 ,Fukushima,35_ 39,1925,Taisho,14,82398,41199,41199
7 ,Fukushima,40_ 44,1925,Taisho,14,73816,36179,37637
7 ,Fukushima,45_ 49,1925,Taisho,14,71151,35226,35925
7 ,Fukushima,50_ 54,1925,Taisho,14,56375,28106,28269
7 ,Fukushima,55_ 59,1925,Taisho,14,47854,23574,24280
7 ,Fukushima,60_ 64,1925,Taisho,14,36785,17873,18912
7 ,Fukushima,65_ 69,1925,Taisho,14,28589,13775,14814
7 ,Fukushima,70_ 74,1925,Taisho,14,20180,8978,11202
7 ,Fukushima,75_ 79,1925,Taisho,14,11241,4841,6400
7 ,Fukushima,80_ 84,1925,Taisho,14,4236,1691,2545
7 ,Fukushima,over_85,1925,Taisho,14,1170,439,731
7 ,Fukushima,total,1930,Showa,5,1508150,742342,765808
7 ,Fukushima,0_ 4,1930,Showa,5,235672,118787,116885
7 ,Fukushima,5_ 9,1930,Showa,5,204419,102357,102062
7 ,Fukushima,10_ 14,1930,Showa,5,174079,86790,87289
7 ,Fukushima,15_ 19,1930,Showa,5,144086,70490,73596
7 ,Fukushima,20_ 24,1930,Showa,5,109625,52219,57406
7 ,Fukushima,25_ 29,1930,Showa,5,99981,49250,50731
7 ,Fukushima,30_ 34,1930,Showa,5,89486,44170,45316
7 ,Fukushima,35_ 39,1930,Showa,5,83666,41715,41951
7 ,Fukushima,40_ 44,1930,Showa,5,76801,38299,38502
7 ,Fukushima,45_ 49,1930,Showa,5,68486,33296,35190
7 ,Fukushima,50_ 54,1930,Showa,5,64975,31721,33254
7 ,Fukushima,55_ 59,1930,Showa,5,50194,24531,25663
7 ,Fukushima,60_ 64,1930,Showa,5,40533,19271,21262
7 ,Fukushima,65_ 69,1930,Showa,5,28776,13427,15349
7 ,Fukushima,70_ 74,1930,Showa,5,19726,8979,10747
7 ,Fukushima,75_ 79,1930,Showa,5,11321,4632,6689
7 ,Fukushima,over_80,1930,Showa,5,6324,2408,3916
7 ,Fukushima,total,1935,Showa,10,1581563,778732,802831
7 ,Fukushima,0_ 4,1935,Showa,10,238283,120242,118041
7 ,Fukushima,5_ 9,1935,Showa,10,220441,111092,109349
7 ,Fukushima,10_ 14,1935,Showa,10,192471,96210,96261
7 ,Fukushima,15_ 19,1935,Showa,10,142121,69029,73092
7 ,Fukushima,20_ 24,1935,Showa,10,116949,54971,61978
7 ,Fukushima,25_ 29,1935,Showa,10,101677,50080,51597
7 ,Fukushima,30_ 34,1935,Showa,10,96084,47675,48409
7 ,Fukushima,35_ 39,1935,Showa,10,85766,42837,42929
7 ,Fukushima,40_ 44,1935,Showa,10,79419,39950,39469
7 ,Fukushima,45_ 49,1935,Showa,10,72427,36313,36114
7 ,Fukushima,50_ 54,1935,Showa,10,63617,30739,32878
7 ,Fukushima,55_ 59,1935,Showa,10,58503,28284,30219
7 ,Fukushima,60_ 64,1935,Showa,10,43240,20544,22696
7 ,Fukushima,65_ 69,1935,Showa,10,32081,14546,17535
7 ,Fukushima,70_ 74,1935,Showa,10,20398,8998,11400
7 ,Fukushima,75_ 79,1935,Showa,10,11255,4713,6542
7 ,Fukushima,over_80,1935,Showa,10,6831,2509,4322
7 ,Fukushima,total,1940,Showa,15,1625418,799744,825674
7 ,Fukushima,0_ 4,1940,Showa,15,227202,114663,112539
7 ,Fukushima,5_ 9,1940,Showa,15,223322,112672,110650
7 ,Fukushima,10_ 14,1940,Showa,15,208074,104064,104010
7 ,Fukushima,15_ 19,1940,Showa,15,150982,70971,80011
7 ,Fukushima,20_ 24,1940,Showa,15,122356,62390,59966
7 ,Fukushima,25_ 29,1940,Showa,15,104777,51396,53381
7 ,Fukushima,30_ 34,1940,Showa,15,93940,45635,48305
7 ,Fukushima,35_ 39,1940,Showa,15,90780,44752,46028
7 ,Fukushima,40_ 44,1940,Showa,15,80765,40229,40536
7 ,Fukushima,45_ 49,1940,Showa,15,74471,37198,37273
7 ,Fukushima,50_ 54,1940,Showa,15,67362,33444,33918
7 ,Fukushima,55_ 59,1940,Showa,15,56577,26882,29695
7 ,Fukushima,60_ 64,1940,Showa,15,50329,23610,26719
7 ,Fukushima,65_ 69,1940,Showa,15,34194,15515,18679
7 ,Fukushima,70_ 74,1940,Showa,15,22154,9349,12805
7 ,Fukushima,75_ 79,1940,Showa,15,11558,4665,6893
7 ,Fukushima,80_ 84,1940,Showa,15,4778,1749,3029
7 ,Fukushima,over_85,1940,Showa,15,1777,552,1225
7 ,Fukushima,total,1945,Showa,20,1957356,906765,1050591
7 ,Fukushima,1_ 5,1945,Showa,20,271688,137513,134175
7 ,Fukushima,6_ 10,1945,Showa,20,261730,132016,129714
7 ,Fukushima,11_ 15,1945,Showa,20,254202,127837,126365
7 ,Fukushima,16_ 20,1945,Showa,20,216918,105028,111890
7 ,Fukushima,21_ 25,1945,Showa,20,142637,48314,94323
7 ,Fukushima,26_ 30,1945,Showa,20,113546,38573,74973
7 ,Fukushima,31_ 35,1945,Showa,20,111003,42356,68647
7 ,Fukushima,36_ 40,1945,Showa,20,108303,49180,59123
7 ,Fukushima,41_ 45,1945,Showa,20,100596,48828,51768
7 ,Fukushima,46_ 50,1945,Showa,20,87558,43266,44292
7 ,Fukushima,51_ 55,1945,Showa,20,77376,38540,38836
7 ,Fukushima,56_ 60,1945,Showa,20,68328,33027,35301
7 ,Fukushima,61_ 65,1945,Showa,20,53336,24445,28891
7 ,Fukushima,66_ 70,1945,Showa,20,43513,19197,24316
7 ,Fukushima,71_ 75,1945,Showa,20,26642,11237,15405
7 ,Fukushima,76_ 80,1945,Showa,20,13259,5086,8173
7 ,Fukushima,81_ 85,1945,Showa,20,5155,1800,3355
7 ,Fukushima,86以上,1945,Showa,20,1566,522,1044
7 ,Fukushima,total,1950,Showa,25,2062394,1006823,1055571
7 ,Fukushima,0_ 4,1950,Showa,25,288068,146739,141329
7 ,Fukushima,5_ 9,1950,Showa,25,249580,126299,123281
7 ,Fukushima,10_ 14,1950,Showa,25,243190,122822,120368
7 ,Fukushima,15_ 19,1950,Showa,25,222933,111716,111217
7 ,Fukushima,20_ 24,1950,Showa,25,187181,90486,96695
7 ,Fukushima,25_ 29,1950,Showa,25,146589,67021,79568
7 ,Fukushima,30_ 34,1950,Showa,25,120111,54773,65338
7 ,Fukushima,35_ 39,1950,Showa,25,113312,52603,60709
7 ,Fukushima,40_ 44,1950,Showa,25,100931,49001,51930
7 ,Fukushima,45_ 49,1950,Showa,25,91913,45615,46298
7 ,Fukushima,50_ 54,1950,Showa,25,78220,38973,39247
7 ,Fukushima,55_ 59,1950,Showa,25,68793,34016,34777
7 ,Fukushima,60_ 64,1950,Showa,25,57076,27181,29895
7 ,Fukushima,65_ 69,1950,Showa,25,41525,18383,23142
7 ,Fukushima,70_ 74,1950,Showa,25,29719,12496,17223
7 ,Fukushima,75_ 79,1950,Showa,25,15334,6041,9293
7 ,Fukushima,over_80,1950,Showa,25,7813,2612,5201
7 ,Fukushima,total,1955,Showa,30,2095237,1016756,1078481
7 ,Fukushima,0_ 4,1955,Showa,30,258428,131442,126986
7 ,Fukushima,5_ 9,1955,Showa,30,272537,138886,133651
7 ,Fukushima,10_ 14,1955,Showa,30,240364,121553,118811
7 ,Fukushima,15_ 19,1955,Showa,30,198571,95954,102617
7 ,Fukushima,20_ 24,1955,Showa,30,178358,83400,94958
7 ,Fukushima,25_ 29,1955,Showa,30,168750,82177,86573
7 ,Fukushima,30_ 34,1955,Showa,30,137246,63129,74117
7 ,Fukushima,35_ 39,1955,Showa,30,112589,51434,61155
7 ,Fukushima,40_ 44,1955,Showa,30,106502,49343,57159
7 ,Fukushima,45_ 49,1955,Showa,30,94839,45820,49019
7 ,Fukushima,50_ 54,1955,Showa,30,86032,42548,43484
7 ,Fukushima,55_ 59,1955,Showa,30,72314,35700,36614
7 ,Fukushima,60_ 64,1955,Showa,30,60939,29530,31409
7 ,Fukushima,65_ 69,1955,Showa,30,47125,21876,25249
7 ,Fukushima,70_ 74,1955,Showa,30,30993,12980,18013
7 ,Fukushima,75_ 79,1955,Showa,30,19153,7402,11751
7 ,Fukushima,80_ 84,1955,Showa,30,7834,2783,5051
7 ,Fukushima,over_85,1955,Showa,30,2644,789,1855
7 ,Fukushima,total,1960,Showa,35,2051137,986836,1064301
7 ,Fukushima,0_ 4,1960,Showa,35,202378,103049,99329
7 ,Fukushima,5_ 9,1960,Showa,35,252371,128361,124010
7 ,Fukushima,10_ 14,1960,Showa,35,265972,135342,130630
7 ,Fukushima,15_ 19,1960,Showa,35,171046,80909,90137
7 ,Fukushima,20_ 24,1960,Showa,35,145503,64516,80987
7 ,Fukushima,25_ 29,1960,Showa,35,157745,74774,82971
7 ,Fukushima,30_ 34,1960,Showa,35,159955,78332,81623
7 ,Fukushima,35_ 39,1960,Showa,35,131737,60515,71222
7 ,Fukushima,40_ 44,1960,Showa,35,107964,49197,58767
7 ,Fukushima,45_ 49,1960,Showa,35,101189,46653,54536
7 ,Fukushima,50_ 54,1960,Showa,35,89318,42870,46448
7 ,Fukushima,55_ 59,1960,Showa,35,79888,39039,40849
7 ,Fukushima,60_ 64,1960,Showa,35,64645,31206,33439
7 ,Fukushima,65_ 69,1960,Showa,35,51500,24085,27415
7 ,Fukushima,70_ 74,1960,Showa,35,36084,15732,20352
7 ,Fukushima,75_ 79,1960,Showa,35,20308,7802,12506
7 ,Fukushima,80_ 84,1960,Showa,35,9990,3407,6583
7 ,Fukushima,over_85,1960,Showa,35,3544,1047,2497
7 ,Fukushima,total,1965,Showa,40,1983754,954988,1028766
7 ,Fukushima,0_ 4,1965,Showa,40,165931,84625,81306
7 ,Fukushima,5_ 9,1965,Showa,40,197298,99850,97448
7 ,Fukushima,10_ 14,1965,Showa,40,245730,124226,121504
7 ,Fukushima,15_ 19,1965,Showa,40,201080,99988,101092
7 ,Fukushima,20_ 24,1965,Showa,40,123160,55343,67817
7 ,Fukushima,25_ 29,1965,Showa,40,131280,62141,69139
7 ,Fukushima,30_ 34,1965,Showa,40,150831,73066,77765
7 ,Fukushima,35_ 39,1965,Showa,40,154359,75639,78720
7 ,Fukushima,40_ 44,1965,Showa,40,126676,57923,68753
7 ,Fukushima,45_ 49,1965,Showa,40,102815,46561,56254
7 ,Fukushima,50_ 54,1965,Showa,40,94906,43496,51410
7 ,Fukushima,55_ 59,1965,Showa,40,82854,39458,43396
7 ,Fukushima,60_ 64,1965,Showa,40,71697,34335,37362
7 ,Fukushima,65_ 69,1965,Showa,40,55120,25679,29441
7 ,Fukushima,70_ 74,1965,Showa,40,40399,17922,22477
7 ,Fukushima,75_ 79,1965,Showa,40,24305,9793,14512
7 ,Fukushima,80_ 84,1965,Showa,40,10549,3550,6999
7 ,Fukushima,over_85,1965,Showa,40,4764,1393,3371
7 ,Fukushima,total,1970,Showa,45,1946077,936202,1009875
7 ,Fukushima,0_ 4,1970,Showa,45,145328,74216,71112
7 ,Fukushima,5_ 9,1970,Showa,45,166577,85055,81522
7 ,Fukushima,10_ 14,1970,Showa,45,196267,99521,96746
7 ,Fukushima,15_ 19,1970,Showa,45,191791,94556,97235
7 ,Fukushima,20_ 24,1970,Showa,45,148622,70217,78405
7 ,Fukushima,25_ 29,1970,Showa,45,123801,60053,63748
7 ,Fukushima,30_ 34,1970,Showa,45,131421,63522,67899
7 ,Fukushima,35_ 39,1970,Showa,45,149272,72249,77023
7 ,Fukushima,40_ 44,1970,Showa,45,150261,73396,76865
7 ,Fukushima,45_ 49,1970,Showa,45,123320,56169,67151
7 ,Fukushima,50_ 54,1970,Showa,45,99186,44743,54443
7 ,Fukushima,55_ 59,1970,Showa,45,89360,40609,48751
7 ,Fukushima,60_ 64,1970,Showa,45,76142,35470,40672
7 ,Fukushima,65_ 69,1970,Showa,45,62867,28916,33951
7 ,Fukushima,70_ 74,1970,Showa,45,44357,19517,24840
7 ,Fukushima,75_ 79,1970,Showa,45,28282,11515,16767
7 ,Fukushima,80_ 84,1970,Showa,45,13779,4935,8844
7 ,Fukushima,over_85,1970,Showa,45,5444,1543,3901
7 ,Fukushima,total,1975,Showa,50,1970616,953449,1017167
7 ,Fukushima,0_ 4,1975,Showa,50,158471,80930,77541
7 ,Fukushima,5_ 9,1975,Showa,50,148561,75787,72774
7 ,Fukushima,10_ 14,1975,Showa,50,166871,85266,81605
7 ,Fukushima,15_ 19,1975,Showa,50,159373,79386,79987
7 ,Fukushima,20_ 24,1975,Showa,50,142993,68238,74755
7 ,Fukushima,25_ 29,1975,Showa,50,155265,78566,76699
7 ,Fukushima,30_ 34,1975,Showa,50,129018,64792,64226
7 ,Fukushima,35_ 39,1975,Showa,50,133064,64868,68196
7 ,Fukushima,40_ 44,1975,Showa,50,147927,71725,76202
7 ,Fukushima,45_ 49,1975,Showa,50,147921,72068,75853
7 ,Fukushima,50_ 54,1975,Showa,50,120134,54421,65713
7 ,Fukushima,55_ 59,1975,Showa,50,95166,42578,52588
7 ,Fukushima,60_ 64,1975,Showa,50,85300,38179,47121
7 ,Fukushima,65_ 69,1975,Showa,50,69285,31312,37973
7 ,Fukushima,70_ 74,1975,Showa,50,53039,23135,29904
7 ,Fukushima,75_ 79,1975,Showa,50,33104,13403,19701
7 ,Fukushima,80_ 84,1975,Showa,50,17258,6290,10968
7 ,Fukushima,over_85,1975,Showa,50,7670,2376,5294
7 ,Fukushima,total,1980,Showa,55,2035272,990575,1044697
7 ,Fukushima,0_ 4,1980,Showa,55,153395,78368,75027
7 ,Fukushima,5_ 9,1980,Showa,55,163208,83241,79967
7 ,Fukushima,10_ 14,1980,Showa,55,150237,76457,73780
7 ,Fukushima,15_ 19,1980,Showa,55,145490,74079,71411
7 ,Fukushima,20_ 24,1980,Showa,55,125560,60972,64588
7 ,Fukushima,25_ 29,1980,Showa,55,157768,78813,78955
7 ,Fukushima,30_ 34,1980,Showa,55,161967,84134,77833
7 ,Fukushima,35_ 39,1980,Showa,55,131811,66634,65177
7 ,Fukushima,40_ 44,1980,Showa,55,133124,65177,67947
7 ,Fukushima,45_ 49,1980,Showa,55,146261,70691,75570
7 ,Fukushima,50_ 54,1980,Showa,55,145303,70315,74988
7 ,Fukushima,55_ 59,1980,Showa,55,117190,52645,64545
7 ,Fukushima,60_ 64,1980,Showa,55,91127,40278,50849
7 ,Fukushima,65_ 69,1980,Showa,55,78741,34472,44269
7 ,Fukushima,70_ 74,1980,Showa,55,60501,26133,34368
7 ,Fukushima,75_ 79,1980,Showa,55,41342,16939,24403
7 ,Fukushima,80_ 84,1980,Showa,55,21448,7828,13620
7 ,Fukushima,over_85,1980,Showa,55,10672,3315,7357
7 ,Fukushima,total,1985,Showa,60,2080304,1012456,1067848
7 ,Fukushima,0_ 4,1985,Showa,60,141275,72049,69226
7 ,Fukushima,5_ 9,1985,Showa,60,155497,79496,76001
7 ,Fukushima,10_ 14,1985,Showa,60,163995,83596,80399
7 ,Fukushima,15_ 19,1985,Showa,60,135670,68495,67175
7 ,Fukushima,20_ 24,1985,Showa,60,115776,56750,59026
7 ,Fukushima,25_ 29,1985,Showa,60,136774,68032,68742
7 ,Fukushima,30_ 34,1985,Showa,60,160816,81828,78988
7 ,Fukushima,35_ 39,1985,Showa,60,163058,84726,78332
7 ,Fukushima,40_ 44,1985,Showa,60,130914,66147,64767
7 ,Fukushima,45_ 49,1985,Showa,60,131146,63899,67247
7 ,Fukushima,50_ 54,1985,Showa,60,143085,68493,74592
7 ,Fukushima,55_ 59,1985,Showa,60,141366,67596,73770
7 ,Fukushima,60_ 64,1985,Showa,60,112951,49970,62981
7 ,Fukushima,65_ 69,1985,Showa,60,85405,36859,48546
7 ,Fukushima,70_ 74,1985,Showa,60,70512,29598,40914
7 ,Fukushima,75_ 79,1985,Showa,60,49215,19906,29309
7 ,Fukushima,80_ 84,1985,Showa,60,28168,10407,17761
7 ,Fukushima,over_85,1985,Showa,60,14647,4586,10061
7 ,Fukushima,total,1990,Heisei,2,2104058,1024354,1079704
7 ,Fukushima,0_ 4,1990,Heisei,2,123316,63151,60165
7 ,Fukushima,5_ 9,1990,Heisei,2,142911,72957,69954
7 ,Fukushima,10_ 14,1990,Heisei,2,155837,79721,76116
7 ,Fukushima,15_ 19,1990,Heisei,2,148597,75045,73552
7 ,Fukushima,20_ 24,1990,Heisei,2,109792,53888,55904
7 ,Fukushima,25_ 29,1990,Heisei,2,123112,61293,61819
7 ,Fukushima,30_ 34,1990,Heisei,2,138149,69600,68549
7 ,Fukushima,35_ 39,1990,Heisei,2,161317,82121,79196
7 ,Fukushima,40_ 44,1990,Heisei,2,162198,84535,77663
7 ,Fukushima,45_ 49,1990,Heisei,2,129163,65192,63971
7 ,Fukushima,50_ 54,1990,Heisei,2,128579,62094,66485
7 ,Fukushima,55_ 59,1990,Heisei,2,139893,66301,73592
7 ,Fukushima,60_ 64,1990,Heisei,2,137057,64693,72364
7 ,Fukushima,65_ 69,1990,Heisei,2,107106,46388,60718
7 ,Fukushima,70_ 74,1990,Heisei,2,77991,32415,45576
7 ,Fukushima,75_ 79,1990,Heisei,2,59467,23468,35999
7 ,Fukushima,80_ 84,1990,Heisei,2,36031,13270,22761
7 ,Fukushima,over_85,1990,Heisei,2,20957,6481,14476
7 ,Fukushima,total,1995,Heisei,7,2133592,1042030,1091562
7 ,Fukushima,0_ 4,1995,Heisei,7,110869,56861,54008
7 ,Fukushima,5_ 9,1995,Heisei,7,126484,64771,61713
7 ,Fukushima,10_ 14,1995,Heisei,7,144158,73585,70573
7 ,Fukushima,15_ 19,1995,Heisei,7,143803,73315,70488
7 ,Fukushima,20_ 24,1995,Heisei,7,127437,64489,62948
7 ,Fukushima,25_ 29,1995,Heisei,7,119994,60080,59914
7 ,Fukushima,30_ 34,1995,Heisei,7,128375,65068,63307
7 ,Fukushima,35_ 39,1995,Heisei,7,142095,72136,69959
7 ,Fukushima,40_ 44,1995,Heisei,7,163405,83881,79524
7 ,Fukushima,45_ 49,1995,Heisei,7,162526,85039,77487
7 ,Fukushima,50_ 54,1995,Heisei,7,128654,64867,63787
7 ,Fukushima,55_ 59,1995,Heisei,7,127251,61033,66218
7 ,Fukushima,60_ 64,1995,Heisei,7,136668,63878,72790
7 ,Fukushima,65_ 69,1995,Heisei,7,130783,60266,70517
7 ,Fukushima,70_ 74,1995,Heisei,7,98945,41176,57769
7 ,Fukushima,75_ 79,1995,Heisei,7,66855,26175,40680
7 ,Fukushima,80_ 84,1995,Heisei,7,45099,16079,29020
7 ,Fukushima,over_85,1995,Heisei,7,29890,9119,20771
7 ,Fukushima,total,2000,Heisei,12,2126935,1037787,1089148
7 ,Fukushima,0_ 4,2000,Heisei,12,102521,52428,50093
7 ,Fukushima,5_ 9,2000,Heisei,12,111776,57309,54467
7 ,Fukushima,10_ 14,2000,Heisei,12,126741,64866,61875
7 ,Fukushima,15_ 19,2000,Heisei,12,131843,67312,64531
7 ,Fukushima,20_ 24,2000,Heisei,12,119831,61453,58378
7 ,Fukushima,25_ 29,2000,Heisei,12,134304,68556,65748
7 ,Fukushima,30_ 34,2000,Heisei,12,122192,61396,60796
7 ,Fukushima,35_ 39,2000,Heisei,12,129388,65537,63851
7 ,Fukushima,40_ 44,2000,Heisei,12,142094,72191,69903
7 ,Fukushima,45_ 49,2000,Heisei,12,161909,82964,78945
7 ,Fukushima,50_ 54,2000,Heisei,12,160370,83310,77060
7 ,Fukushima,55_ 59,2000,Heisei,12,126647,63189,63458
7 ,Fukushima,60_ 64,2000,Heisei,12,124922,58993,65929
7 ,Fukushima,65_ 69,2000,Heisei,12,130519,59683,70836
7 ,Fukushima,70_ 74,2000,Heisei,12,120714,53529,67185
7 ,Fukushima,75_ 79,2000,Heisei,12,86774,33898,52876
7 ,Fukushima,80_ 84,2000,Heisei,12,52227,18568,33659
7 ,Fukushima,over_85,2000,Heisei,12,41563,12216,29347
7 ,Fukushima,total,2005,Heisei,17,2091319,1016724,1074595
7 ,Fukushima,0_ 4,2005,Heisei,17,93288,47689,45599
7 ,Fukushima,5_ 9,2005,Heisei,17,102670,52554,50116
7 ,Fukushima,10_ 14,2005,Heisei,17,111336,57098,54238
7 ,Fukushima,15_ 19,2005,Heisei,17,115623,59194,56429
7 ,Fukushima,20_ 24,2005,Heisei,17,105650,53992,51658
7 ,Fukushima,25_ 29,2005,Heisei,17,122111,62533,59578
7 ,Fukushima,30_ 34,2005,Heisei,17,133404,67989,65415
7 ,Fukushima,35_ 39,2005,Heisei,17,120922,60559,60363
7 ,Fukushima,40_ 44,2005,Heisei,17,128076,64633,63443
7 ,Fukushima,45_ 49,2005,Heisei,17,140319,70961,69358
7 ,Fukushima,50_ 54,2005,Heisei,17,159408,81111,78297
7 ,Fukushima,55_ 59,2005,Heisei,17,157706,81099,76607
7 ,Fukushima,60_ 64,2005,Heisei,17,124515,61245,63270
7 ,Fukushima,65_ 69,2005,Heisei,17,120336,55779,64557
7 ,Fukushima,70_ 74,2005,Heisei,17,121682,53820,67862
7 ,Fukushima,75_ 79,2005,Heisei,17,107250,44769,62481
7 ,Fukushima,80_ 84,2005,Heisei,17,70564,25160,45404
7 ,Fukushima,over_85,2005,Heisei,17,55028,15589,39439
7 ,Fukushima,total,2010,Heisei,22,2029064,984682,1044382
7 ,Fukushima,0_ 4,2010,Heisei,22,81909,41942,39967
7 ,Fukushima,5_ 9,2010,Heisei,22,92463,47284,45179
7 ,Fukushima,10_ 14,2010,Heisei,22,101697,52049,49648
7 ,Fukushima,15_ 19,2010,Heisei,22,101390,52234,49156
7 ,Fukushima,20_ 24,2010,Heisei,22,88659,45442,43217
7 ,Fukushima,25_ 29,2010,Heisei,22,104518,53386,51132
7 ,Fukushima,30_ 34,2010,Heisei,22,119543,61157,58386
7 ,Fukushima,35_ 39,2010,Heisei,22,130414,66304,64110
7 ,Fukushima,40_ 44,2010,Heisei,22,118460,59155,59305
7 ,Fukushima,45_ 49,2010,Heisei,22,125401,62976,62425
7 ,Fukushima,50_ 54,2010,Heisei,22,137612,69152,68460
7 ,Fukushima,55_ 59,2010,Heisei,22,156274,78928,77346
7 ,Fukushima,60_ 64,2010,Heisei,22,154187,78535,75652
7 ,Fukushima,65_ 69,2010,Heisei,22,119495,57821,61674
7 ,Fukushima,70_ 74,2010,Heisei,22,112303,50589,61714
7 ,Fukushima,75_ 79,2010,Heisei,22,108923,45497,63426
7 ,Fukushima,80_ 84,2010,Heisei,22,88349,33513,54836
7 ,Fukushima,over_85,2010,Heisei,22,75381,21212,54169
7 ,Fukushima,total,2015,Heisei,27,1914039,945660,968379
7 ,Fukushima,0_ 4,2015,Heisei,27,67458,34549,32909
7 ,Fukushima,5_ 9,2015,Heisei,27,74873,38450,36423
7 ,Fukushima,10_ 14,2015,Heisei,27,86556,44322,42234
7 ,Fukushima,15_ 19,2015,Heisei,27,89826,46754,43072
7 ,Fukushima,20_ 24,2015,Heisei,27,76683,40744,35939
7 ,Fukushima,25_ 29,2015,Heisei,27,87453,45885,41568
7 ,Fukushima,30_ 34,2015,Heisei,27,99679,51902,47777
7 ,Fukushima,35_ 39,2015,Heisei,27,113625,59308,54317
7 ,Fukushima,40_ 44,2015,Heisei,27,125972,65581,60391
7 ,Fukushima,45_ 49,2015,Heisei,27,115670,59280,56390
7 ,Fukushima,50_ 54,2015,Heisei,27,123194,63071,60123
7 ,Fukushima,55_ 59,2015,Heisei,27,135335,69230,66105
7 ,Fukushima,60_ 64,2015,Heisei,27,152752,77799,74953
7 ,Fukushima,65_ 69,2015,Heisei,27,147232,74781,72451
7 ,Fukushima,70_ 74,2015,Heisei,27,111153,52890,58263
7 ,Fukushima,75_ 79,2015,Heisei,27,100264,43777,56487
7 ,Fukushima,80_ 84,2015,Heisei,27,89460,34880,54580
7 ,Fukushima,over_85,2015,Heisei,27,94275,27660,66615
8 ,Ibaraki,total,1920,Taisho,9,1350400,662128,688272
8 ,Ibaraki,0_ 4,1920,Taisho,9,190119,94955,95164
8 ,Ibaraki,5_ 9,1920,Taisho,9,170022,84875,85147
8 ,Ibaraki,10_ 14,1920,Taisho,9,142706,71053,71653
8 ,Ibaraki,15_ 19,1920,Taisho,9,118793,58405,60388
8 ,Ibaraki,20_ 24,1920,Taisho,9,95599,44006,51593
8 ,Ibaraki,25_ 29,1920,Taisho,9,89867,44180,45687
8 ,Ibaraki,30_ 34,1920,Taisho,9,85028,42109,42919
8 ,Ibaraki,35_ 39,1920,Taisho,9,78561,38196,40365
8 ,Ibaraki,40_ 44,1920,Taisho,9,79498,39525,39973
8 ,Ibaraki,45_ 49,1920,Taisho,9,65398,32453,32945
8 ,Ibaraki,50_ 54,1920,Taisho,9,56658,28382,28276
8 ,Ibaraki,55_ 59,1920,Taisho,9,49461,24346,25115
8 ,Ibaraki,60_ 64,1920,Taisho,9,45159,21792,23367
8 ,Ibaraki,65_ 69,1920,Taisho,9,37815,17868,19947
8 ,Ibaraki,70_ 74,1920,Taisho,9,24936,11408,13528
8 ,Ibaraki,75_ 79,1920,Taisho,9,13426,5814,7612
8 ,Ibaraki,over_80,1920,Taisho,9,7354,2761,4593
8 ,Ibaraki,total,1925,Taisho,14,1409092,693837,715255
8 ,Ibaraki,0_ 4,1925,Taisho,14,204089,102153,101936
8 ,Ibaraki,5_ 9,1925,Taisho,14,175035,87545,87490
8 ,Ibaraki,10_ 14,1925,Taisho,14,160251,79693,80558
8 ,Ibaraki,15_ 19,1925,Taisho,14,121051,59562,61489
8 ,Ibaraki,20_ 24,1925,Taisho,14,100567,49256,51311
8 ,Ibaraki,25_ 29,1925,Taisho,14,91816,45156,46660
8 ,Ibaraki,30_ 34,1925,Taisho,14,84901,42394,42507
8 ,Ibaraki,35_ 39,1925,Taisho,14,80753,40430,40323
8 ,Ibaraki,40_ 44,1925,Taisho,14,74455,36563,37892
8 ,Ibaraki,45_ 49,1925,Taisho,14,75311,37406,37905
8 ,Ibaraki,50_ 54,1925,Taisho,14,61029,30139,30890
8 ,Ibaraki,55_ 59,1925,Taisho,14,51111,25270,25841
8 ,Ibaraki,60_ 64,1925,Taisho,14,43010,20554,22456
8 ,Ibaraki,65_ 69,1925,Taisho,14,35981,16672,19309
8 ,Ibaraki,70_ 74,1925,Taisho,14,26944,11850,15094
8 ,Ibaraki,75_ 79,1925,Taisho,14,14851,6252,8599
8 ,Ibaraki,80_ 84,1925,Taisho,14,5997,2293,3704
8 ,Ibaraki,over_85,1925,Taisho,14,1940,649,1291
8 ,Ibaraki,total,1930,Showa,5,1487097,734059,753038
8 ,Ibaraki,0_ 4,1930,Showa,5,216994,108933,108061
8 ,Ibaraki,5_ 9,1930,Showa,5,191721,95873,95848
8 ,Ibaraki,10_ 14,1930,Showa,5,164796,82207,82589
8 ,Ibaraki,15_ 19,1930,Showa,5,135994,67261,68733
8 ,Ibaraki,20_ 24,1930,Showa,5,104967,52369,52598
8 ,Ibaraki,25_ 29,1930,Showa,5,95716,48227,47489
8 ,Ibaraki,30_ 34,1930,Showa,5,88778,44029,44749
8 ,Ibaraki,35_ 39,1930,Showa,5,82175,41312,40863
8 ,Ibaraki,40_ 44,1930,Showa,5,77652,38864,38788
8 ,Ibaraki,45_ 49,1930,Showa,5,70593,34564,36029
8 ,Ibaraki,50_ 54,1930,Showa,5,70365,34536,35829
8 ,Ibaraki,55_ 59,1930,Showa,5,55719,27073,28646
8 ,Ibaraki,60_ 64,1930,Showa,5,44775,21547,23228
8 ,Ibaraki,65_ 69,1930,Showa,5,35053,15978,19075
8 ,Ibaraki,70_ 74,1930,Showa,5,26072,11279,14793
8 ,Ibaraki,75_ 79,1930,Showa,5,16400,6627,9773
8 ,Ibaraki,over_80,1930,Showa,5,9327,3380,5947
8 ,Ibaraki,total,1935,Showa,10,1548991,766423,782568
8 ,Ibaraki,0_ 4,1935,Showa,10,218200,109482,108718
8 ,Ibaraki,5_ 9,1935,Showa,10,204296,102675,101621
8 ,Ibaraki,10_ 14,1935,Showa,10,180719,90216,90503
8 ,Ibaraki,15_ 19,1935,Showa,10,133603,66588,67015
8 ,Ibaraki,20_ 24,1935,Showa,10,114371,57045,57326
8 ,Ibaraki,25_ 29,1935,Showa,10,98915,50015,48900
8 ,Ibaraki,30_ 34,1935,Showa,10,92053,46569,45484
8 ,Ibaraki,35_ 39,1935,Showa,10,85748,42780,42968
8 ,Ibaraki,40_ 44,1935,Showa,10,78647,39710,38937
8 ,Ibaraki,45_ 49,1935,Showa,10,73963,37077,36886
8 ,Ibaraki,50_ 54,1935,Showa,10,66263,32315,33948
8 ,Ibaraki,55_ 59,1935,Showa,10,64389,31160,33229
8 ,Ibaraki,60_ 64,1935,Showa,10,48873,23123,25750
8 ,Ibaraki,65_ 69,1935,Showa,10,36464,16691,19773
8 ,Ibaraki,70_ 74,1935,Showa,10,25700,10945,14755
8 ,Ibaraki,75_ 79,1935,Showa,10,16093,6269,9824
8 ,Ibaraki,over_80,1935,Showa,10,10694,3763,6931
8 ,Ibaraki,total,1940,Showa,15,1619926,801862,818064
8 ,Ibaraki,0_ 4,1940,Showa,15,212071,106686,105385
8 ,Ibaraki,5_ 9,1940,Showa,15,208313,104550,103763
8 ,Ibaraki,10_ 14,1940,Showa,15,196709,98719,97990
8 ,Ibaraki,15_ 19,1940,Showa,15,150613,73717,76896
8 ,Ibaraki,20_ 24,1940,Showa,15,121797,62670,59127
8 ,Ibaraki,25_ 29,1940,Showa,15,108071,54169,53902
8 ,Ibaraki,30_ 34,1940,Showa,15,95236,47872,47364
8 ,Ibaraki,35_ 39,1940,Showa,15,89795,45424,44371
8 ,Ibaraki,40_ 44,1940,Showa,15,82688,41285,41403
8 ,Ibaraki,45_ 49,1940,Showa,15,74766,37589,37177
8 ,Ibaraki,50_ 54,1940,Showa,15,69356,34349,35007
8 ,Ibaraki,55_ 59,1940,Showa,15,60574,29002,31572
8 ,Ibaraki,60_ 64,1940,Showa,15,56682,26582,30100
8 ,Ibaraki,65_ 69,1940,Showa,15,40331,18254,22077
8 ,Ibaraki,70_ 74,1940,Showa,15,26685,11368,15317
8 ,Ibaraki,75_ 79,1940,Showa,15,15821,6189,9632
8 ,Ibaraki,80_ 84,1940,Showa,15,7405,2515,4890
8 ,Ibaraki,over_85,1940,Showa,15,3012,921,2091
8 ,Ibaraki,total,1945,Showa,20,1944344,907525,1036819
8 ,Ibaraki,1_ 5,1945,Showa,20,258910,131586,127324
8 ,Ibaraki,6_ 10,1945,Showa,20,245864,123659,122205
8 ,Ibaraki,11_ 15,1945,Showa,20,237275,118619,118656
8 ,Ibaraki,16_ 20,1945,Showa,20,208751,102230,106521
8 ,Ibaraki,21_ 25,1945,Showa,20,145929,53990,91939
8 ,Ibaraki,26_ 30,1945,Showa,20,114843,39467,75376
8 ,Ibaraki,31_ 35,1945,Showa,20,115440,46145,69295
8 ,Ibaraki,36_ 40,1945,Showa,20,108655,50524,58131
8 ,Ibaraki,41_ 45,1945,Showa,20,101575,50253,51322
8 ,Ibaraki,46_ 50,1945,Showa,20,89938,44892,45046
8 ,Ibaraki,51_ 55,1945,Showa,20,78226,39219,39007
8 ,Ibaraki,56_ 60,1945,Showa,20,71354,34948,36406
8 ,Ibaraki,61_ 65,1945,Showa,20,57572,26471,31101
8 ,Ibaraki,66_ 70,1945,Showa,20,50339,22138,28201
8 ,Ibaraki,71_ 75,1945,Showa,20,32493,13513,18980
8 ,Ibaraki,76_ 80,1945,Showa,20,17019,6542,10477
8 ,Ibaraki,81_ 85,1945,Showa,20,7489,2521,4968
8 ,Ibaraki,86以上,1945,Showa,20,2672,808,1864
8 ,Ibaraki,total,1950,Showa,25,2039418,993694,1045724
8 ,Ibaraki,0_ 4,1950,Showa,25,274732,139850,134882
8 ,Ibaraki,5_ 9,1950,Showa,25,242464,123180,119284
8 ,Ibaraki,10_ 14,1950,Showa,25,230197,115918,114279
8 ,Ibaraki,15_ 19,1950,Showa,25,208813,104799,104014
8 ,Ibaraki,20_ 24,1950,Showa,25,178073,86756,91317
8 ,Ibaraki,25_ 29,1950,Showa,25,141546,63036,78510
8 ,Ibaraki,30_ 34,1950,Showa,25,119558,53109,66449
8 ,Ibaraki,35_ 39,1950,Showa,25,118594,55527,63067
8 ,Ibaraki,40_ 44,1950,Showa,25,103938,51325,52613
8 ,Ibaraki,45_ 49,1950,Showa,25,94219,47711,46508
8 ,Ibaraki,50_ 54,1950,Showa,25,82250,41204,41046
8 ,Ibaraki,55_ 59,1950,Showa,25,71058,35309,35749
8 ,Ibaraki,60_ 64,1950,Showa,25,61311,29432,31879
8 ,Ibaraki,65_ 69,1950,Showa,25,46175,20477,25698
8 ,Ibaraki,70_ 74,1950,Showa,25,35857,15060,20797
8 ,Ibaraki,75_ 79,1950,Showa,25,19530,7424,12106
8 ,Ibaraki,over_80,1950,Showa,25,10967,3505,7462
8 ,Ibaraki,total,1955,Showa,30,2064037,1006093,1057944
8 ,Ibaraki,0_ 4,1955,Showa,30,233567,118523,115044
8 ,Ibaraki,5_ 9,1955,Showa,30,262018,133560,128458
8 ,Ibaraki,10_ 14,1955,Showa,30,233115,118251,114864
8 ,Ibaraki,15_ 19,1955,Showa,30,192223,93432,98791
8 ,Ibaraki,20_ 24,1955,Showa,30,172940,84738,88202
8 ,Ibaraki,25_ 29,1955,Showa,30,161645,80567,81078
8 ,Ibaraki,30_ 34,1955,Showa,30,134587,60654,73933
8 ,Ibaraki,35_ 39,1955,Showa,30,113567,50821,62746
8 ,Ibaraki,40_ 44,1955,Showa,30,112008,52551,59457
8 ,Ibaraki,45_ 49,1955,Showa,30,98042,48362,49680
8 ,Ibaraki,50_ 54,1955,Showa,30,88092,44602,43490
8 ,Ibaraki,55_ 59,1955,Showa,30,76100,37840,38260
8 ,Ibaraki,60_ 64,1955,Showa,30,63196,30875,32321
8 ,Ibaraki,65_ 69,1955,Showa,30,50897,23554,27343
8 ,Ibaraki,70_ 74,1955,Showa,30,34839,14457,20382
8 ,Ibaraki,75_ 79,1955,Showa,30,23399,8885,14514
8 ,Ibaraki,80_ 84,1955,Showa,30,10103,3411,6692
8 ,Ibaraki,over_85,1955,Showa,30,3661,996,2665
8 ,Ibaraki,total,1960,Showa,35,2047024,1000184,1046840
8 ,Ibaraki,0_ 4,1960,Showa,35,183812,93574,90238
8 ,Ibaraki,5_ 9,1960,Showa,35,230796,117254,113542
8 ,Ibaraki,10_ 14,1960,Showa,35,257596,131107,126489
8 ,Ibaraki,15_ 19,1960,Showa,35,180594,89379,91215
8 ,Ibaraki,20_ 24,1960,Showa,35,155640,76064,79576
8 ,Ibaraki,25_ 29,1960,Showa,35,155087,77944,77143
8 ,Ibaraki,30_ 34,1960,Showa,35,156240,78382,77858
8 ,Ibaraki,35_ 39,1960,Showa,35,131167,59260,71907
8 ,Ibaraki,40_ 44,1960,Showa,35,109999,49268,60731
8 ,Ibaraki,45_ 49,1960,Showa,35,107430,50512,56918
8 ,Ibaraki,50_ 54,1960,Showa,35,93114,45828,47286
8 ,Ibaraki,55_ 59,1960,Showa,35,82359,41152,41207
8 ,Ibaraki,60_ 64,1960,Showa,35,68961,33653,35308
8 ,Ibaraki,65_ 69,1960,Showa,35,53999,25460,28539
8 ,Ibaraki,70_ 74,1960,Showa,35,39553,17233,22320
8 ,Ibaraki,75_ 79,1960,Showa,35,23276,8752,14524
8 ,Ibaraki,80_ 84,1960,Showa,35,12479,4031,8448
8 ,Ibaraki,over_85,1960,Showa,35,4922,1331,3591
8 ,Ibaraki,total,1965,Showa,40,2056154,1007852,1048302
8 ,Ibaraki,0_ 4,1965,Showa,40,165961,84463,81498
8 ,Ibaraki,5_ 9,1965,Showa,40,185061,93923,91138
8 ,Ibaraki,10_ 14,1965,Showa,40,229149,115870,113279
8 ,Ibaraki,15_ 19,1965,Showa,40,210577,105975,104602
8 ,Ibaraki,20_ 24,1965,Showa,40,153166,75362,77804
8 ,Ibaraki,25_ 29,1965,Showa,40,149264,75887,73377
8 ,Ibaraki,30_ 34,1965,Showa,40,155435,79121,76314
8 ,Ibaraki,35_ 39,1965,Showa,40,156216,78691,77525
8 ,Ibaraki,40_ 44,1965,Showa,40,129062,58358,70704
8 ,Ibaraki,45_ 49,1965,Showa,40,107405,48157,59248
8 ,Ibaraki,50_ 54,1965,Showa,40,103307,48392,54915
8 ,Ibaraki,55_ 59,1965,Showa,40,88097,43177,44920
8 ,Ibaraki,60_ 64,1965,Showa,40,75092,36892,38200
8 ,Ibaraki,65_ 69,1965,Showa,40,59757,28191,31566
8 ,Ibaraki,70_ 74,1965,Showa,40,42918,18983,23935
8 ,Ibaraki,75_ 79,1965,Showa,40,27112,10777,16335
8 ,Ibaraki,80_ 84,1965,Showa,40,12447,4023,8424
8 ,Ibaraki,over_85,1965,Showa,40,6128,1610,4518
8 ,Ibaraki,total,1970,Showa,45,2143551,1054003,1089548
8 ,Ibaraki,0_ 4,1970,Showa,45,176135,89879,86256
8 ,Ibaraki,5_ 9,1970,Showa,45,171768,87595,84173
8 ,Ibaraki,10_ 14,1970,Showa,45,186322,94546,91776
8 ,Ibaraki,15_ 19,1970,Showa,45,198851,99591,99260
8 ,Ibaraki,20_ 24,1970,Showa,45,190485,93468,97017
8 ,Ibaraki,25_ 29,1970,Showa,45,165004,83944,81060
8 ,Ibaraki,30_ 34,1970,Showa,45,159591,82835,76756
8 ,Ibaraki,35_ 39,1970,Showa,45,159096,81562,77534
8 ,Ibaraki,40_ 44,1970,Showa,45,153468,77566,75902
8 ,Ibaraki,45_ 49,1970,Showa,45,128262,57961,70301
8 ,Ibaraki,50_ 54,1970,Showa,45,105266,47030,58236
8 ,Ibaraki,55_ 59,1970,Showa,45,97660,45396,52264
8 ,Ibaraki,60_ 64,1970,Showa,45,82376,39461,42915
8 ,Ibaraki,65_ 69,1970,Showa,45,67045,31665,35380
8 ,Ibaraki,70_ 74,1970,Showa,45,49604,21932,27672
8 ,Ibaraki,75_ 79,1970,Showa,45,30424,12285,18139
8 ,Ibaraki,80_ 84,1970,Showa,45,15536,5471,10065
8 ,Ibaraki,over_85,1970,Showa,45,6658,1816,4842
8 ,Ibaraki,total,1975,Showa,50,2342198,1159707,1182491
8 ,Ibaraki,0_ 4,1975,Showa,50,213500,109261,104239
8 ,Ibaraki,5_ 9,1975,Showa,50,189351,96750,92601
8 ,Ibaraki,10_ 14,1975,Showa,50,177336,90470,86866
8 ,Ibaraki,15_ 19,1975,Showa,50,171346,86756,84590
8 ,Ibaraki,20_ 24,1975,Showa,50,182981,91237,91744
8 ,Ibaraki,25_ 29,1975,Showa,50,211730,107298,104432
8 ,Ibaraki,30_ 34,1975,Showa,50,184177,95204,88973
8 ,Ibaraki,35_ 39,1975,Showa,50,169368,88778,80590
8 ,Ibaraki,40_ 44,1975,Showa,50,163686,84206,79480
8 ,Ibaraki,45_ 49,1975,Showa,50,156745,78917,77828
8 ,Ibaraki,50_ 54,1975,Showa,50,126605,56936,69669
8 ,Ibaraki,55_ 59,1975,Showa,50,102901,45450,57451
8 ,Ibaraki,60_ 64,1975,Showa,50,95810,43672,52138
8 ,Ibaraki,65_ 69,1975,Showa,50,75746,35083,40663
8 ,Ibaraki,70_ 74,1975,Showa,50,56508,25293,31215
8 ,Ibaraki,75_ 79,1975,Showa,50,36763,15069,21694
8 ,Ibaraki,80_ 84,1975,Showa,50,18638,6688,11950
8 ,Ibaraki,over_85,1975,Showa,50,8725,2461,6264
8 ,Ibaraki,total,1980,Showa,55,2558007,1272533,1285474
8 ,Ibaraki,0_ 4,1980,Showa,55,197471,100988,96483
8 ,Ibaraki,5_ 9,1980,Showa,55,231513,118472,113041
8 ,Ibaraki,10_ 14,1980,Showa,55,199482,102164,97318
8 ,Ibaraki,15_ 19,1980,Showa,55,172715,88028,84687
8 ,Ibaraki,20_ 24,1980,Showa,55,160760,81290,79470
8 ,Ibaraki,25_ 29,1980,Showa,55,203555,103848,99707
8 ,Ibaraki,30_ 34,1980,Showa,55,231708,117728,113980
8 ,Ibaraki,35_ 39,1980,Showa,55,198753,103368,95385
8 ,Ibaraki,40_ 44,1980,Showa,55,176376,92702,83674
8 ,Ibaraki,45_ 49,1980,Showa,55,165454,85061,80393
8 ,Ibaraki,50_ 54,1980,Showa,55,156752,78522,78230
8 ,Ibaraki,55_ 59,1980,Showa,55,125931,56198,69733
8 ,Ibaraki,60_ 64,1980,Showa,55,100445,43603,56842
8 ,Ibaraki,65_ 69,1980,Showa,55,89858,39890,49968
8 ,Ibaraki,70_ 74,1980,Showa,55,66838,29634,37204
8 ,Ibaraki,75_ 79,1980,Showa,55,44172,18290,25882
8 ,Ibaraki,80_ 84,1980,Showa,55,23893,8793,15100
8 ,Ibaraki,over_85,1980,Showa,55,11724,3537,8187
8 ,Ibaraki,total,1985,Showa,60,2725005,1357963,1367042
8 ,Ibaraki,0_ 4,1985,Showa,60,178816,91351,87465
8 ,Ibaraki,5_ 9,1985,Showa,60,208782,106860,101922
8 ,Ibaraki,10_ 14,1985,Showa,60,239914,122797,117117
8 ,Ibaraki,15_ 19,1985,Showa,60,196703,100436,96267
8 ,Ibaraki,20_ 24,1985,Showa,60,164072,83676,80396
8 ,Ibaraki,25_ 29,1985,Showa,60,174654,89802,84852
8 ,Ibaraki,30_ 34,1985,Showa,60,215414,109581,105833
8 ,Ibaraki,35_ 39,1985,Showa,60,243610,124035,119575
8 ,Ibaraki,40_ 44,1985,Showa,60,204591,106775,97816
8 ,Ibaraki,45_ 49,1985,Showa,60,177424,93231,84193
8 ,Ibaraki,50_ 54,1985,Showa,60,164690,84113,80577
8 ,Ibaraki,55_ 59,1985,Showa,60,154663,76583,78080
8 ,Ibaraki,60_ 64,1985,Showa,60,122876,53859,69017
8 ,Ibaraki,65_ 69,1985,Showa,60,95501,40460,55041
8 ,Ibaraki,70_ 74,1985,Showa,60,81489,34786,46703
8 ,Ibaraki,75_ 79,1985,Showa,60,54736,22783,31953
8 ,Ibaraki,80_ 84,1985,Showa,60,30439,11459,18980
8 ,Ibaraki,over_85,1985,Showa,60,16338,5194,11144
8 ,Ibaraki,total,1990,Heisei,2,2845382,1419117,1426265
8 ,Ibaraki,0_ 4,1990,Heisei,2,157065,80650,76415
8 ,Ibaraki,5_ 9,1990,Heisei,2,187349,95526,91823
8 ,Ibaraki,10_ 14,1990,Heisei,2,214619,109801,104818
8 ,Ibaraki,15_ 19,1990,Heisei,2,234282,119630,114652
8 ,Ibaraki,20_ 24,1990,Heisei,2,183436,93209,90227
8 ,Ibaraki,25_ 29,1990,Heisei,2,173049,89656,83393
8 ,Ibaraki,30_ 34,1990,Heisei,2,182480,93505,88975
8 ,Ibaraki,35_ 39,1990,Heisei,2,224236,114076,110160
8 ,Ibaraki,40_ 44,1990,Heisei,2,249579,127871,121708
8 ,Ibaraki,45_ 49,1990,Heisei,2,205824,107518,98306
8 ,Ibaraki,50_ 54,1990,Heisei,2,176927,92495,84432
8 ,Ibaraki,55_ 59,1990,Heisei,2,162795,82057,80738
8 ,Ibaraki,60_ 64,1990,Heisei,2,151229,73616,77613
8 ,Ibaraki,65_ 69,1990,Heisei,2,117979,50496,67483
8 ,Ibaraki,70_ 74,1990,Heisei,2,88185,35960,52225
8 ,Ibaraki,75_ 79,1990,Heisei,2,69698,28043,41655
8 ,Ibaraki,80_ 84,1990,Heisei,2,40066,15230,24836
8 ,Ibaraki,over_85,1990,Heisei,2,22871,7293,15578
8 ,Ibaraki,total,1995,Heisei,7,2955530,1476437,1479093
8 ,Ibaraki,0_ 4,1995,Heisei,7,146309,75469,70840
8 ,Ibaraki,5_ 9,1995,Heisei,7,165828,85196,80632
8 ,Ibaraki,10_ 14,1995,Heisei,7,193226,98610,94616
8 ,Ibaraki,15_ 19,1995,Heisei,7,210634,107764,102870
8 ,Ibaraki,20_ 24,1995,Heisei,7,220771,112879,107892
8 ,Ibaraki,25_ 29,1995,Heisei,7,196224,102572,93652
8 ,Ibaraki,30_ 34,1995,Heisei,7,184251,95184,89067
8 ,Ibaraki,35_ 39,1995,Heisei,7,192032,98276,93756
8 ,Ibaraki,40_ 44,1995,Heisei,7,230939,118170,112769
8 ,Ibaraki,45_ 49,1995,Heisei,7,252508,129650,122858
8 ,Ibaraki,50_ 54,1995,Heisei,7,206426,107390,99036
8 ,Ibaraki,55_ 59,1995,Heisei,7,176412,91483,84929
8 ,Ibaraki,60_ 64,1995,Heisei,7,159848,79256,80592
8 ,Ibaraki,65_ 69,1995,Heisei,7,145188,68938,76250
8 ,Ibaraki,70_ 74,1995,Heisei,7,109946,45268,64678
8 ,Ibaraki,75_ 79,1995,Heisei,7,76848,29362,47486
8 ,Ibaraki,80_ 84,1995,Heisei,7,53324,19432,33892
8 ,Ibaraki,over_85,1995,Heisei,7,33304,10527,22777
8 ,Ibaraki,total,2000,Heisei,12,2985676,1488340,1497336
8 ,Ibaraki,0_ 4,2000,Heisei,12,142256,73084,69172
8 ,Ibaraki,5_ 9,2000,Heisei,12,149190,76960,72230
8 ,Ibaraki,10_ 14,2000,Heisei,12,167055,85914,81141
8 ,Ibaraki,15_ 19,2000,Heisei,12,185509,94443,91066
8 ,Ibaraki,20_ 24,2000,Heisei,12,190221,97137,93084
8 ,Ibaraki,25_ 29,2000,Heisei,12,223503,116465,107038
8 ,Ibaraki,30_ 34,2000,Heisei,12,197854,102794,95060
8 ,Ibaraki,35_ 39,2000,Heisei,12,185924,95418,90506
8 ,Ibaraki,40_ 44,2000,Heisei,12,192206,98271,93935
8 ,Ibaraki,45_ 49,2000,Heisei,12,229032,116796,112236
8 ,Ibaraki,50_ 54,2000,Heisei,12,249159,127140,122019
8 ,Ibaraki,55_ 59,2000,Heisei,12,203737,104936,98801
8 ,Ibaraki,60_ 64,2000,Heisei,12,173215,88446,84769
8 ,Ibaraki,65_ 69,2000,Heisei,12,153156,74170,78986
8 ,Ibaraki,70_ 74,2000,Heisei,12,134671,61660,73011
8 ,Ibaraki,75_ 79,2000,Heisei,12,97124,37699,59425
8 ,Ibaraki,80_ 84,2000,Heisei,12,60894,21096,39798
8 ,Ibaraki,over_85,2000,Heisei,12,49848,15114,34734
8 ,Ibaraki,total,2005,Heisei,17,2975167,1479941,1495226
8 ,Ibaraki,0_ 4,2005,Heisei,17,131766,67297,64469
8 ,Ibaraki,5_ 9,2005,Heisei,17,142817,73404,69413
8 ,Ibaraki,10_ 14,2005,Heisei,17,148330,76481,71849
8 ,Ibaraki,15_ 19,2005,Heisei,17,160297,82633,77664
8 ,Ibaraki,20_ 24,2005,Heisei,17,167323,85704,81619
8 ,Ibaraki,25_ 29,2005,Heisei,17,189034,98688,90346
8 ,Ibaraki,30_ 34,2005,Heisei,17,220890,115118,105772
8 ,Ibaraki,35_ 39,2005,Heisei,17,194943,100755,94188
8 ,Ibaraki,40_ 44,2005,Heisei,17,183353,93504,89849
8 ,Ibaraki,45_ 49,2005,Heisei,17,189494,96338,93156
8 ,Ibaraki,50_ 54,2005,Heisei,17,224886,114070,110816
8 ,Ibaraki,55_ 59,2005,Heisei,17,243946,123397,120549
8 ,Ibaraki,60_ 64,2005,Heisei,17,199993,101666,98327
8 ,Ibaraki,65_ 69,2005,Heisei,17,166607,83741,82866
8 ,Ibaraki,70_ 74,2005,Heisei,17,143065,67102,75963
8 ,Ibaraki,75_ 79,2005,Heisei,17,120191,51972,68219
8 ,Ibaraki,80_ 84,2005,Heisei,17,79931,28299,51632
8 ,Ibaraki,over_85,2005,Heisei,17,66478,18592,47886
8 ,Ibaraki,total,2010,Heisei,22,2969770,1479779,1489991
8 ,Ibaraki,0_ 4,2010,Heisei,22,122330,62808,59522
8 ,Ibaraki,5_ 9,2010,Heisei,22,134010,68526,65484
8 ,Ibaraki,10_ 14,2010,Heisei,22,143298,73702,69596
8 ,Ibaraki,15_ 19,2010,Heisei,22,144480,75094,69386
8 ,Ibaraki,20_ 24,2010,Heisei,22,145495,75951,69544
8 ,Ibaraki,25_ 29,2010,Heisei,22,167064,87531,79533
8 ,Ibaraki,30_ 34,2010,Heisei,22,189035,98811,90224
8 ,Ibaraki,35_ 39,2010,Heisei,22,221348,115168,106180
8 ,Ibaraki,40_ 44,2010,Heisei,22,195016,100859,94157
8 ,Ibaraki,45_ 49,2010,Heisei,22,181718,92534,89184
8 ,Ibaraki,50_ 54,2010,Heisei,22,186762,94563,92199
8 ,Ibaraki,55_ 59,2010,Heisei,22,221170,111299,109871
8 ,Ibaraki,60_ 64,2010,Heisei,22,239613,119973,119640
8 ,Ibaraki,65_ 69,2010,Heisei,22,193226,96798,96428
8 ,Ibaraki,70_ 74,2010,Heisei,22,156865,76786,80079
8 ,Ibaraki,75_ 79,2010,Heisei,22,128216,57020,71196
8 ,Ibaraki,80_ 84,2010,Heisei,22,99179,39183,59996
8 ,Ibaraki,over_85,2010,Heisei,22,87579,24160,63419
8 ,Ibaraki,total,2015,Heisei,27,2916976,1453594,1463382
8 ,Ibaraki,0_ 4,2015,Heisei,27,109073,55823,53250
8 ,Ibaraki,5_ 9,2015,Heisei,27,122167,62872,59295
8 ,Ibaraki,10_ 14,2015,Heisei,27,133111,68231,64880
8 ,Ibaraki,15_ 19,2015,Heisei,27,140357,72798,67559
8 ,Ibaraki,20_ 24,2015,Heisei,27,129447,68321,61126
8 ,Ibaraki,25_ 29,2015,Heisei,27,141878,75699,66179
8 ,Ibaraki,30_ 34,2015,Heisei,27,162661,84726,77935
8 ,Ibaraki,35_ 39,2015,Heisei,27,185899,96711,89188
8 ,Ibaraki,40_ 44,2015,Heisei,27,218542,113611,104931
8 ,Ibaraki,45_ 49,2015,Heisei,27,191782,99000,92782
8 ,Ibaraki,50_ 54,2015,Heisei,27,178223,90417,87806
8 ,Ibaraki,55_ 59,2015,Heisei,27,182692,91891,90801
8 ,Ibaraki,60_ 64,2015,Heisei,27,215831,107461,108370
8 ,Ibaraki,65_ 69,2015,Heisei,27,230584,113700,116884
8 ,Ibaraki,70_ 74,2015,Heisei,27,182065,89085,92980
8 ,Ibaraki,75_ 79,2015,Heisei,27,141470,66560,74910
8 ,Ibaraki,80_ 84,2015,Heisei,27,106708,43888,62820
8 ,Ibaraki,over_85,2015,Heisei,27,110851,33375,77476
9 ,Tochigi,total,1920,Taisho,9,1046479,514255,532224
9 ,Tochigi,0_ 4,1920,Taisho,9,157204,78561,78643
9 ,Tochigi,5_ 9,1920,Taisho,9,139772,69811,69961
9 ,Tochigi,10_ 14,1920,Taisho,9,117636,58991,58645
9 ,Tochigi,15_ 19,1920,Taisho,9,99626,48613,51013
9 ,Tochigi,20_ 24,1920,Taisho,9,78016,36473,41543
9 ,Tochigi,25_ 29,1920,Taisho,9,69519,34239,35280
9 ,Tochigi,30_ 34,1920,Taisho,9,66192,32521,33671
9 ,Tochigi,35_ 39,1920,Taisho,9,61878,30323,31555
9 ,Tochigi,40_ 44,1920,Taisho,9,60586,29924,30662
9 ,Tochigi,45_ 49,1920,Taisho,9,46582,23224,23358
9 ,Tochigi,50_ 54,1920,Taisho,9,39244,19833,19411
9 ,Tochigi,55_ 59,1920,Taisho,9,32739,16060,16679
9 ,Tochigi,60_ 64,1920,Taisho,9,28462,13752,14710
9 ,Tochigi,65_ 69,1920,Taisho,9,22527,10610,11917
9 ,Tochigi,70_ 74,1920,Taisho,9,14697,6537,8160
9 ,Tochigi,75_ 79,1920,Taisho,9,7813,3274,4539
9 ,Tochigi,over_80,1920,Taisho,9,3986,1509,2477
9 ,Tochigi,total,1925,Taisho,14,1090428,536259,554169
9 ,Tochigi,0_ 4,1925,Taisho,14,168053,83814,84239
9 ,Tochigi,5_ 9,1925,Taisho,14,143963,71813,72150
9 ,Tochigi,10_ 14,1925,Taisho,14,131387,65709,65678
9 ,Tochigi,15_ 19,1925,Taisho,14,97258,47905,49353
9 ,Tochigi,20_ 24,1925,Taisho,14,82038,39822,42216
9 ,Tochigi,25_ 29,1925,Taisho,14,72054,35421,36633
9 ,Tochigi,30_ 34,1925,Taisho,14,64027,31639,32388
9 ,Tochigi,35_ 39,1925,Taisho,14,61908,30538,31370
9 ,Tochigi,40_ 44,1925,Taisho,14,57817,28460,29357
9 ,Tochigi,45_ 49,1925,Taisho,14,56386,27684,28702
9 ,Tochigi,50_ 54,1925,Taisho,14,42611,20983,21628
9 ,Tochigi,55_ 59,1925,Taisho,14,34741,17279,17462
9 ,Tochigi,60_ 64,1925,Taisho,14,27692,13170,14522
9 ,Tochigi,65_ 69,1925,Taisho,14,22140,10227,11913
9 ,Tochigi,70_ 74,1925,Taisho,14,15710,6831,8879
9 ,Tochigi,75_ 79,1925,Taisho,14,8355,3410,4945
9 ,Tochigi,80_ 84,1925,Taisho,14,3307,1229,2078
9 ,Tochigi,over_85,1925,Taisho,14,981,325,656
9 ,Tochigi,total,1930,Showa,5,1141737,562839,578898
9 ,Tochigi,0_ 4,1930,Showa,5,175764,87906,87858
9 ,Tochigi,5_ 9,1930,Showa,5,155689,77756,77933
9 ,Tochigi,10_ 14,1930,Showa,5,134479,66973,67506
9 ,Tochigi,15_ 19,1930,Showa,5,104860,51203,53657
9 ,Tochigi,20_ 24,1930,Showa,5,81270,40671,40599
9 ,Tochigi,25_ 29,1930,Showa,5,75601,37506,38095
9 ,Tochigi,30_ 34,1930,Showa,5,68045,33872,34173
9 ,Tochigi,35_ 39,1930,Showa,5,61207,30629,30578
9 ,Tochigi,40_ 44,1930,Showa,5,58636,29159,29477
9 ,Tochigi,45_ 49,1930,Showa,5,54279,26697,27582
9 ,Tochigi,50_ 54,1930,Showa,5,51896,25401,26495
9 ,Tochigi,55_ 59,1930,Showa,5,38360,18685,19675
9 ,Tochigi,60_ 64,1930,Showa,5,29672,14323,15349
9 ,Tochigi,65_ 69,1930,Showa,5,21921,9837,12084
9 ,Tochigi,70_ 74,1930,Showa,5,15780,6754,9026
9 ,Tochigi,75_ 79,1930,Showa,5,9257,3733,5524
9 ,Tochigi,over_80,1930,Showa,5,5021,1734,3287
9 ,Tochigi,total,1935,Showa,10,1195057,588545,606512
9 ,Tochigi,0_ 4,1935,Showa,10,175102,88173,86929
9 ,Tochigi,5_ 9,1935,Showa,10,164842,82422,82420
9 ,Tochigi,10_ 14,1935,Showa,10,148920,74130,74790
9 ,Tochigi,15_ 19,1935,Showa,10,103798,49859,53939
9 ,Tochigi,20_ 24,1935,Showa,10,88507,43049,45458
9 ,Tochigi,25_ 29,1935,Showa,10,76151,38646,37505
9 ,Tochigi,30_ 34,1935,Showa,10,72913,36533,36380
9 ,Tochigi,35_ 39,1935,Showa,10,65782,32880,32902
9 ,Tochigi,40_ 44,1935,Showa,10,58505,29378,29127
9 ,Tochigi,45_ 49,1935,Showa,10,55494,27668,27826
9 ,Tochigi,50_ 54,1935,Showa,10,50366,24609,25757
9 ,Tochigi,55_ 59,1935,Showa,10,46948,22522,24426
9 ,Tochigi,60_ 64,1935,Showa,10,33075,15645,17430
9 ,Tochigi,65_ 69,1935,Showa,10,23723,10863,12860
9 ,Tochigi,70_ 74,1935,Showa,10,15870,6580,9290
9 ,Tochigi,75_ 79,1935,Showa,10,9409,3633,5776
9 ,Tochigi,over_80,1935,Showa,10,5652,1955,3697
9 ,Tochigi,total,1940,Showa,15,1206597,591562,615035
9 ,Tochigi,0_ 4,1940,Showa,15,163497,82695,80802
9 ,Tochigi,5_ 9,1940,Showa,15,162984,81911,81073
9 ,Tochigi,10_ 14,1940,Showa,15,154581,76734,77847
9 ,Tochigi,15_ 19,1940,Showa,15,108968,49869,59099
9 ,Tochigi,20_ 24,1940,Showa,15,89923,45984,43939
9 ,Tochigi,25_ 29,1940,Showa,15,77506,37969,39537
9 ,Tochigi,30_ 34,1940,Showa,15,69287,34538,34749
9 ,Tochigi,35_ 39,1940,Showa,15,68370,33797,34573
9 ,Tochigi,40_ 44,1940,Showa,15,61937,30720,31217
9 ,Tochigi,45_ 49,1940,Showa,15,54539,27277,27262
9 ,Tochigi,50_ 54,1940,Showa,15,51105,25193,25912
9 ,Tochigi,55_ 59,1940,Showa,15,45041,21679,23362
9 ,Tochigi,60_ 64,1940,Showa,15,40355,18728,21627
9 ,Tochigi,65_ 69,1940,Showa,15,26639,11973,14666
9 ,Tochigi,70_ 74,1940,Showa,15,16780,7089,9691
9 ,Tochigi,75_ 79,1940,Showa,15,9422,3531,5891
9 ,Tochigi,80_ 84,1940,Showa,15,4139,1428,2711
9 ,Tochigi,over_85,1940,Showa,15,1519,444,1075
9 ,Tochigi,total,1945,Showa,20,1546355,719529,826826
9 ,Tochigi,1_ 5,1945,Showa,20,211525,107066,104459
9 ,Tochigi,6_ 10,1945,Showa,20,200574,101175,99399
9 ,Tochigi,11_ 15,1945,Showa,20,195768,98011,97757
9 ,Tochigi,16_ 20,1945,Showa,20,166237,79707,86530
9 ,Tochigi,21_ 25,1945,Showa,20,118612,43958,74654
9 ,Tochigi,26_ 30,1945,Showa,20,92555,31915,60640
9 ,Tochigi,31_ 35,1945,Showa,20,93041,37493,55548
9 ,Tochigi,36_ 40,1945,Showa,20,86762,40541,46221
9 ,Tochigi,41_ 45,1945,Showa,20,81357,39914,41443
9 ,Tochigi,46_ 50,1945,Showa,20,70068,34660,35408
9 ,Tochigi,51_ 55,1945,Showa,20,59048,29298,29750
9 ,Tochigi,56_ 60,1945,Showa,20,53418,25850,27568
9 ,Tochigi,61_ 65,1945,Showa,20,43683,19946,23737
9 ,Tochigi,66_ 70,1945,Showa,20,36389,15667,20722
9 ,Tochigi,71_ 75,1945,Showa,20,21178,8671,12507
9 ,Tochigi,76_ 80,1945,Showa,20,10538,3898,6640
9 ,Tochigi,81_ 85,1945,Showa,20,4263,1365,2898
9 ,Tochigi,86以上,1945,Showa,20,1339,394,945
9 ,Tochigi,total,1950,Showa,25,1550462,752266,798196
9 ,Tochigi,0_ 4,1950,Showa,25,218139,111295,106844
9 ,Tochigi,5_ 9,1950,Showa,25,187041,94652,92389
9 ,Tochigi,10_ 14,1950,Showa,25,179635,90587,89048
9 ,Tochigi,15_ 19,1950,Showa,25,160109,78848,81261
9 ,Tochigi,20_ 24,1950,Showa,25,135835,64729,71106
9 ,Tochigi,25_ 29,1950,Showa,25,107955,48163,59792
9 ,Tochigi,30_ 34,1950,Showa,25,90979,40473,50506
9 ,Tochigi,35_ 39,1950,Showa,25,88349,41238,47111
9 ,Tochigi,40_ 44,1950,Showa,25,77369,38375,38994
9 ,Tochigi,45_ 49,1950,Showa,25,71625,35875,35750
9 ,Tochigi,50_ 54,1950,Showa,25,61228,30548,30680
9 ,Tochigi,55_ 59,1950,Showa,25,51142,25196,25946
9 ,Tochigi,60_ 64,1950,Showa,25,44350,20933,23417
9 ,Tochigi,65_ 69,1950,Showa,25,33475,14801,18674
9 ,Tochigi,70_ 74,1950,Showa,25,24558,9938,14620
9 ,Tochigi,75_ 79,1950,Showa,25,12257,4638,7619
9 ,Tochigi,over_80,1950,Showa,25,6369,1947,4422
9 ,Tochigi,total,1955,Showa,30,1547580,749636,797944
9 ,Tochigi,0_ 4,1955,Showa,30,176655,89985,86670
9 ,Tochigi,5_ 9,1955,Showa,30,204801,104469,100332
9 ,Tochigi,10_ 14,1955,Showa,30,178222,90180,88042
9 ,Tochigi,15_ 19,1955,Showa,30,140508,67053,73455
9 ,Tochigi,20_ 24,1955,Showa,30,129346,60901,68445
9 ,Tochigi,25_ 29,1955,Showa,30,122470,60015,62455
9 ,Tochigi,30_ 34,1955,Showa,30,101204,45484,55720
9 ,Tochigi,35_ 39,1955,Showa,30,85390,38238,47152
9 ,Tochigi,40_ 44,1955,Showa,30,82635,38628,44007
9 ,Tochigi,45_ 49,1955,Showa,30,72599,36177,36422
9 ,Tochigi,50_ 54,1955,Showa,30,66675,33337,33338
9 ,Tochigi,55_ 59,1955,Showa,30,56118,27788,28330
9 ,Tochigi,60_ 64,1955,Showa,30,45159,21790,23369
9 ,Tochigi,65_ 69,1955,Showa,30,36508,16655,19853
9 ,Tochigi,70_ 74,1955,Showa,30,24991,10426,14565
9 ,Tochigi,75_ 79,1955,Showa,30,15866,5826,10040
9 ,Tochigi,80_ 84,1955,Showa,30,6349,2139,4210
9 ,Tochigi,over_85,1955,Showa,30,2081,544,1537
9 ,Tochigi,total,1960,Showa,35,1513624,729692,783932
9 ,Tochigi,0_ 4,1960,Showa,35,136335,69630,66705
9 ,Tochigi,5_ 9,1960,Showa,35,173138,88099,85039
9 ,Tochigi,10_ 14,1960,Showa,35,200624,102290,98334
9 ,Tochigi,15_ 19,1960,Showa,35,129262,60686,68576
9 ,Tochigi,20_ 24,1960,Showa,35,108507,48557,59950
9 ,Tochigi,25_ 29,1960,Showa,35,115543,56545,58998
9 ,Tochigi,30_ 34,1960,Showa,35,116740,57550,59190
9 ,Tochigi,35_ 39,1960,Showa,35,97980,44102,53878
9 ,Tochigi,40_ 44,1960,Showa,35,82024,36777,45247
9 ,Tochigi,45_ 49,1960,Showa,35,78803,36904,41899
9 ,Tochigi,50_ 54,1960,Showa,35,68214,33972,34242
9 ,Tochigi,55_ 59,1960,Showa,35,61880,30632,31248
9 ,Tochigi,60_ 64,1960,Showa,35,50254,24362,25892
9 ,Tochigi,65_ 69,1960,Showa,35,38315,17763,20552
9 ,Tochigi,70_ 74,1960,Showa,35,28113,12089,16024
9 ,Tochigi,75_ 79,1960,Showa,35,16562,6223,10339
9 ,Tochigi,80_ 84,1960,Showa,35,8418,2716,5702
9 ,Tochigi,over_85,1960,Showa,35,2912,795,2117
9 ,Tochigi,total,1965,Showa,40,1521656,735781,785875
9 ,Tochigi,0_ 4,1965,Showa,40,120912,61662,59250
9 ,Tochigi,5_ 9,1965,Showa,40,136698,69745,66953
9 ,Tochigi,10_ 14,1965,Showa,40,171837,87150,84687
9 ,Tochigi,15_ 19,1965,Showa,40,164682,80523,84159
9 ,Tochigi,20_ 24,1965,Showa,40,110727,50651,60076
9 ,Tochigi,25_ 29,1965,Showa,40,106344,52109,54235
9 ,Tochigi,30_ 34,1965,Showa,40,115322,57487,57835
9 ,Tochigi,35_ 39,1965,Showa,40,116991,57949,59042
9 ,Tochigi,40_ 44,1965,Showa,40,96785,43645,53140
9 ,Tochigi,45_ 49,1965,Showa,40,80017,35893,44124
9 ,Tochigi,50_ 54,1965,Showa,40,75471,35319,40152
9 ,Tochigi,55_ 59,1965,Showa,40,64492,31843,32649
9 ,Tochigi,60_ 64,1965,Showa,40,55943,27130,28813
9 ,Tochigi,65_ 69,1965,Showa,40,43338,20197,23141
9 ,Tochigi,70_ 74,1965,Showa,40,30180,13194,16986
9 ,Tochigi,75_ 79,1965,Showa,40,18957,7404,11553
9 ,Tochigi,80_ 84,1965,Showa,40,8796,2813,5983
9 ,Tochigi,over_85,1965,Showa,40,4164,1067,3097
9 ,Tochigi,total,1970,Showa,45,1580021,769524,810497
9 ,Tochigi,0_ 4,1970,Showa,45,126222,64592,61630
9 ,Tochigi,5_ 9,1970,Showa,45,124754,63723,61031
9 ,Tochigi,10_ 14,1970,Showa,45,138040,70454,67586
9 ,Tochigi,15_ 19,1970,Showa,45,152387,75278,77109
9 ,Tochigi,20_ 24,1970,Showa,45,146868,70156,76712
9 ,Tochigi,25_ 29,1970,Showa,45,118468,59157,59311
9 ,Tochigi,30_ 34,1970,Showa,45,112185,56480,55705
9 ,Tochigi,35_ 39,1970,Showa,45,117792,59204,58588
9 ,Tochigi,40_ 44,1970,Showa,45,115981,57695,58286
9 ,Tochigi,45_ 49,1970,Showa,45,95964,43257,52707
9 ,Tochigi,50_ 54,1970,Showa,45,78225,35148,43077
9 ,Tochigi,55_ 59,1970,Showa,45,71993,33487,38506
9 ,Tochigi,60_ 64,1970,Showa,45,59721,28964,30757
9 ,Tochigi,65_ 69,1970,Showa,45,49179,23033,26146
9 ,Tochigi,70_ 74,1970,Showa,45,35353,15534,19819
9 ,Tochigi,75_ 79,1970,Showa,45,21326,8467,12859
9 ,Tochigi,80_ 84,1970,Showa,45,10976,3694,7282
9 ,Tochigi,over_85,1970,Showa,45,4587,1201,3386
9 ,Tochigi,total,1975,Showa,50,1698003,834794,863209
9 ,Tochigi,0_ 4,1975,Showa,50,153952,79004,74948
9 ,Tochigi,5_ 9,1975,Showa,50,132879,67900,64979
9 ,Tochigi,10_ 14,1975,Showa,50,127292,64972,62320
9 ,Tochigi,15_ 19,1975,Showa,50,127491,64147,63344
9 ,Tochigi,20_ 24,1975,Showa,50,136260,66432,69828
9 ,Tochigi,25_ 29,1975,Showa,50,159283,81089,78194
9 ,Tochigi,30_ 34,1975,Showa,50,128119,65748,62371
9 ,Tochigi,35_ 39,1975,Showa,50,117177,59638,57539
9 ,Tochigi,40_ 44,1975,Showa,50,119568,60337,59231
9 ,Tochigi,45_ 49,1975,Showa,50,116160,57707,58453
9 ,Tochigi,50_ 54,1975,Showa,50,94462,42341,52121
9 ,Tochigi,55_ 59,1975,Showa,50,75925,33687,42238
9 ,Tochigi,60_ 64,1975,Showa,50,68638,31371,37267
9 ,Tochigi,65_ 69,1975,Showa,50,54331,25479,28852
9 ,Tochigi,70_ 74,1975,Showa,50,41390,18221,23169
9 ,Tochigi,75_ 79,1975,Showa,50,26034,10473,15561
9 ,Tochigi,80_ 84,1975,Showa,50,12833,4459,8374
9 ,Tochigi,over_85,1975,Showa,50,6063,1683,4380
9 ,Tochigi,total,1980,Showa,55,1792201,885573,906628
9 ,Tochigi,0_ 4,1980,Showa,55,139275,71555,67720
9 ,Tochigi,5_ 9,1980,Showa,55,158550,81598,76952
9 ,Tochigi,10_ 14,1980,Showa,55,135407,69118,66289
9 ,Tochigi,15_ 19,1980,Showa,55,119231,60174,59057
9 ,Tochigi,20_ 24,1980,Showa,55,112274,55160,57114
9 ,Tochigi,25_ 29,1980,Showa,55,146398,73919,72479
9 ,Tochigi,30_ 34,1980,Showa,55,164731,85226,79505
9 ,Tochigi,35_ 39,1980,Showa,55,131715,67940,63775
9 ,Tochigi,40_ 44,1980,Showa,55,118449,60477,57972
9 ,Tochigi,45_ 49,1980,Showa,55,118838,59792,59046
9 ,Tochigi,50_ 54,1980,Showa,55,114422,56458,57964
9 ,Tochigi,55_ 59,1980,Showa,55,92243,40938,51305
9 ,Tochigi,60_ 64,1980,Showa,55,72808,31776,41032
9 ,Tochigi,65_ 69,1980,Showa,55,63577,28276,35301
9 ,Tochigi,70_ 74,1980,Showa,55,47135,21303,25832
9 ,Tochigi,75_ 79,1980,Showa,55,32106,13154,18952
9 ,Tochigi,80_ 84,1980,Showa,55,16698,6109,10589
9 ,Tochigi,over_85,1980,Showa,55,7922,2309,5613
9 ,Tochigi,total,1985,Showa,60,1866066,924221,941845
9 ,Tochigi,0_ 4,1985,Showa,60,123760,63604,60156
9 ,Tochigi,5_ 9,1985,Showa,60,141810,72825,68985
9 ,Tochigi,10_ 14,1985,Showa,60,160237,82395,77842
9 ,Tochigi,15_ 19,1985,Showa,60,128761,65395,63366
9 ,Tochigi,20_ 24,1985,Showa,60,107274,53368,53906
9 ,Tochigi,25_ 29,1985,Showa,60,122668,62379,60289
9 ,Tochigi,30_ 34,1985,Showa,60,150014,76501,73513
9 ,Tochigi,35_ 39,1985,Showa,60,167240,86483,80757
9 ,Tochigi,40_ 44,1985,Showa,60,132400,68406,63994
9 ,Tochigi,45_ 49,1985,Showa,60,117481,59862,57619
9 ,Tochigi,50_ 54,1985,Showa,60,116837,58353,58484
9 ,Tochigi,55_ 59,1985,Showa,60,111930,54605,57325
9 ,Tochigi,60_ 64,1985,Showa,60,89256,38913,50343
9 ,Tochigi,65_ 69,1985,Showa,60,68520,29126,39394
9 ,Tochigi,70_ 74,1985,Showa,60,56771,24286,32485
9 ,Tochigi,75_ 79,1985,Showa,60,38046,16152,21894
9 ,Tochigi,80_ 84,1985,Showa,60,21769,8080,13689
9 ,Tochigi,over_85,1985,Showa,60,11222,3449,7773
9 ,Tochigi,total,1990,Heisei,2,1935168,962571,972597
9 ,Tochigi,0_ 4,1990,Heisei,2,109045,55891,53154
9 ,Tochigi,5_ 9,1990,Heisei,2,127108,65255,61853
9 ,Tochigi,10_ 14,1990,Heisei,2,143934,73841,70093
9 ,Tochigi,15_ 19,1990,Heisei,2,152941,78479,74462
9 ,Tochigi,20_ 24,1990,Heisei,2,118095,59771,58324
9 ,Tochigi,25_ 29,1990,Heisei,2,119003,61423,57580
9 ,Tochigi,30_ 34,1990,Heisei,2,128020,65726,62294
9 ,Tochigi,35_ 39,1990,Heisei,2,154235,79117,75118
9 ,Tochigi,40_ 44,1990,Heisei,2,170010,88385,81625
9 ,Tochigi,45_ 49,1990,Heisei,2,132868,69003,63865
9 ,Tochigi,50_ 54,1990,Heisei,2,116695,59317,57378
9 ,Tochigi,55_ 59,1990,Heisei,2,114688,56628,58060
9 ,Tochigi,60_ 64,1990,Heisei,2,108673,52198,56475
9 ,Tochigi,65_ 69,1990,Heisei,2,84756,36158,48598
9 ,Tochigi,70_ 74,1990,Heisei,2,62425,25538,36887
9 ,Tochigi,75_ 79,1990,Heisei,2,47696,19205,28491
9 ,Tochigi,80_ 84,1990,Heisei,2,27351,10579,16772
9 ,Tochigi,over_85,1990,Heisei,2,16277,5074,11203
9 ,Tochigi,total,1995,Heisei,7,1984390,987426,996964
9 ,Tochigi,0_ 4,1995,Heisei,7,97417,49821,47596
9 ,Tochigi,5_ 9,1995,Heisei,7,112589,57657,54932
9 ,Tochigi,10_ 14,1995,Heisei,7,129247,66258,62989
9 ,Tochigi,15_ 19,1995,Heisei,7,137387,70499,66888
9 ,Tochigi,20_ 24,1995,Heisei,7,141703,73114,68589
9 ,Tochigi,25_ 29,1995,Heisei,7,128910,66525,62385
9 ,Tochigi,30_ 34,1995,Heisei,7,123904,63912,59992
9 ,Tochigi,35_ 39,1995,Heisei,7,132044,67786,64258
9 ,Tochigi,40_ 44,1995,Heisei,7,156849,80681,76168
9 ,Tochigi,45_ 49,1995,Heisei,7,170435,88655,81780
9 ,Tochigi,50_ 54,1995,Heisei,7,132431,68414,64017
9 ,Tochigi,55_ 59,1995,Heisei,7,115341,58027,57314
9 ,Tochigi,60_ 64,1995,Heisei,7,111631,54228,57403
9 ,Tochigi,65_ 69,1995,Heisei,7,103122,48224,54898
9 ,Tochigi,70_ 74,1995,Heisei,7,77899,31970,45929
9 ,Tochigi,75_ 79,1995,Heisei,7,53504,20550,32954
9 ,Tochigi,80_ 84,1995,Heisei,7,35746,12931,22815
9 ,Tochigi,over_85,1995,Heisei,7,22676,7146,15530
9 ,Tochigi,total,2000,Heisei,12,2004817,995859,1008958
9 ,Tochigi,0_ 4,2000,Heisei,12,94573,48516,46057
9 ,Tochigi,5_ 9,2000,Heisei,12,99135,50668,48467
9 ,Tochigi,10_ 14,2000,Heisei,12,113197,57949,55248
9 ,Tochigi,15_ 19,2000,Heisei,12,122021,62556,59465
9 ,Tochigi,20_ 24,2000,Heisei,12,123115,63057,60058
9 ,Tochigi,25_ 29,2000,Heisei,12,149181,77962,71219
9 ,Tochigi,30_ 34,2000,Heisei,12,132236,68193,64043
9 ,Tochigi,35_ 39,2000,Heisei,12,125902,64735,61167
9 ,Tochigi,40_ 44,2000,Heisei,12,132767,68184,64583
9 ,Tochigi,45_ 49,2000,Heisei,12,155971,80132,75839
9 ,Tochigi,50_ 54,2000,Heisei,12,168277,87017,81260
9 ,Tochigi,55_ 59,2000,Heisei,12,130261,66555,63706
9 ,Tochigi,60_ 64,2000,Heisei,12,112580,55689,56891
9 ,Tochigi,65_ 69,2000,Heisei,12,106272,50383,55889
9 ,Tochigi,70_ 74,2000,Heisei,12,95062,42746,52316
9 ,Tochigi,75_ 79,2000,Heisei,12,68376,26338,42038
9 ,Tochigi,80_ 84,2000,Heisei,12,41892,14544,27348
9 ,Tochigi,over_85,2000,Heisei,12,32904,9895,23009
9 ,Tochigi,total,2005,Heisei,17,2016631,1002114,1014517
9 ,Tochigi,0_ 4,2005,Heisei,17,91236,46627,44609
9 ,Tochigi,5_ 9,2005,Heisei,17,95178,48885,46293
9 ,Tochigi,10_ 14,2005,Heisei,17,98831,50626,48205
9 ,Tochigi,15_ 19,2005,Heisei,17,107096,54900,52196
9 ,Tochigi,20_ 24,2005,Heisei,17,109264,56469,52795
9 ,Tochigi,25_ 29,2005,Heisei,17,130702,68556,62146
9 ,Tochigi,30_ 34,2005,Heisei,17,152016,79591,72425
9 ,Tochigi,35_ 39,2005,Heisei,17,132471,68284,64187
9 ,Tochigi,40_ 44,2005,Heisei,17,125804,64714,61090
9 ,Tochigi,45_ 49,2005,Heisei,17,132135,67725,64410
9 ,Tochigi,50_ 54,2005,Heisei,17,153999,78836,75163
9 ,Tochigi,55_ 59,2005,Heisei,17,165715,85089,80626
9 ,Tochigi,60_ 64,2005,Heisei,17,127311,64058,63253
9 ,Tochigi,65_ 69,2005,Heisei,17,108253,52607,55646
9 ,Tochigi,70_ 74,2005,Heisei,17,98836,45281,53555
9 ,Tochigi,75_ 79,2005,Heisei,17,84266,35795,48471
9 ,Tochigi,80_ 84,2005,Heisei,17,55716,19457,36259
9 ,Tochigi,over_85,2005,Heisei,17,43825,12211,31614
9 ,Tochigi,total,2010,Heisei,22,2007683,996855,1010828
9 ,Tochigi,0_ 4,2010,Heisei,22,84400,43391,41009
9 ,Tochigi,5_ 9,2010,Heisei,22,91102,46602,44500
9 ,Tochigi,10_ 14,2010,Heisei,22,94321,48448,45873
9 ,Tochigi,15_ 19,2010,Heisei,22,93535,47850,45685
9 ,Tochigi,20_ 24,2010,Heisei,22,93793,48256,45537
9 ,Tochigi,25_ 29,2010,Heisei,22,113148,59646,53502
9 ,Tochigi,30_ 34,2010,Heisei,22,131663,68740,62923
9 ,Tochigi,35_ 39,2010,Heisei,22,151364,79111,72253
9 ,Tochigi,40_ 44,2010,Heisei,22,131539,67873,63666
9 ,Tochigi,45_ 49,2010,Heisei,22,124093,63749,60344
9 ,Tochigi,50_ 54,2010,Heisei,22,129620,66091,63529
9 ,Tochigi,55_ 59,2010,Heisei,22,151234,76792,74442
9 ,Tochigi,60_ 64,2010,Heisei,22,161285,81702,79583
9 ,Tochigi,65_ 69,2010,Heisei,22,122010,60316,61694
9 ,Tochigi,70_ 74,2010,Heisei,22,100623,47572,53051
9 ,Tochigi,75_ 79,2010,Heisei,22,87713,37959,49754
9 ,Tochigi,80_ 84,2010,Heisei,22,68649,26453,42196
9 ,Tochigi,over_85,2010,Heisei,22,59201,16345,42856
9 ,Tochigi,total,2015,Heisei,27,1974255,981626,992629
9 ,Tochigi,0_ 4,2015,Heisei,27,77033,39489,37544
9 ,Tochigi,5_ 9,2015,Heisei,27,84561,43432,41129
9 ,Tochigi,10_ 14,2015,Heisei,27,91242,46567,44675
9 ,Tochigi,15_ 19,2015,Heisei,27,90747,46527,44220
9 ,Tochigi,20_ 24,2015,Heisei,27,84564,43797,40767
9 ,Tochigi,25_ 29,2015,Heisei,27,100530,53363,47167
9 ,Tochigi,30_ 34,2015,Heisei,27,116500,61470,55030
9 ,Tochigi,35_ 39,2015,Heisei,27,132819,69406,63413
9 ,Tochigi,40_ 44,2015,Heisei,27,151156,79021,72135
9 ,Tochigi,45_ 49,2015,Heisei,27,130665,67377,63288
9 ,Tochigi,50_ 54,2015,Heisei,27,121835,62345,59490
9 ,Tochigi,55_ 59,2015,Heisei,27,127246,64463,62783
9 ,Tochigi,60_ 64,2015,Heisei,27,147554,74037,73517
9 ,Tochigi,65_ 69,2015,Heisei,27,155130,77392,77738
9 ,Tochigi,70_ 74,2015,Heisei,27,114300,55103,59197
9 ,Tochigi,75_ 79,2015,Heisei,27,90622,41010,49612
9 ,Tochigi,80_ 84,2015,Heisei,27,72614,28969,43645
9 ,Tochigi,over_85,2015,Heisei,27,75726,22433,53293
10 ,Gunma,total,1920,Taisho,9,1052610,514106,538504
10 ,Gunma,0_ 4,1920,Taisho,9,150451,75399,75052
10 ,Gunma,5_ 9,1920,Taisho,9,133004,66794,66210
10 ,Gunma,10_ 14,1920,Taisho,9,117168,57110,60058
10 ,Gunma,15_ 19,1920,Taisho,9,107349,50669,56680
10 ,Gunma,20_ 24,1920,Taisho,9,82273,37599,44674
10 ,Gunma,25_ 29,1920,Taisho,9,70795,34795,36000
10 ,Gunma,30_ 34,1920,Taisho,9,66888,32918,33970
10 ,Gunma,35_ 39,1920,Taisho,9,64339,31380,32959
10 ,Gunma,40_ 44,1920,Taisho,9,63896,31558,32338
10 ,Gunma,45_ 49,1920,Taisho,9,48964,24499,24465
10 ,Gunma,50_ 54,1920,Taisho,9,38834,19389,19445
10 ,Gunma,55_ 59,1920,Taisho,9,32699,16314,16385
10 ,Gunma,60_ 64,1920,Taisho,9,28026,13741,14285
10 ,Gunma,65_ 69,1920,Taisho,9,22772,10873,11899
10 ,Gunma,70_ 74,1920,Taisho,9,14514,6711,7803
10 ,Gunma,75_ 79,1920,Taisho,9,7069,2985,4084
10 ,Gunma,over_80,1920,Taisho,9,3569,1372,2197
10 ,Gunma,total,1925,Taisho,14,1118858,548633,570225
10 ,Gunma,0_ 4,1925,Taisho,14,161423,81252,80171
10 ,Gunma,5_ 9,1925,Taisho,14,136746,68527,68219
10 ,Gunma,10_ 14,1925,Taisho,14,131346,64187,67159
10 ,Gunma,15_ 19,1925,Taisho,14,108524,50506,58018
10 ,Gunma,20_ 24,1925,Taisho,14,92088,43279,48809
10 ,Gunma,25_ 29,1925,Taisho,14,79066,39536,39530
10 ,Gunma,30_ 34,1925,Taisho,14,67138,33787,33351
10 ,Gunma,35_ 39,1925,Taisho,14,64067,32270,31797
10 ,Gunma,40_ 44,1925,Taisho,14,61189,30255,30934
10 ,Gunma,45_ 49,1925,Taisho,14,60494,29897,30597
10 ,Gunma,50_ 54,1925,Taisho,14,45311,22586,22725
10 ,Gunma,55_ 59,1925,Taisho,14,34494,16910,17584
10 ,Gunma,60_ 64,1925,Taisho,14,27498,13322,14176
10 ,Gunma,65_ 69,1925,Taisho,14,21841,10344,11497
10 ,Gunma,70_ 74,1925,Taisho,14,15565,7040,8525
10 ,Gunma,75_ 79,1925,Taisho,14,8133,3494,4639
10 ,Gunma,80_ 84,1925,Taisho,14,3014,1113,1901
10 ,Gunma,over_85,1925,Taisho,14,921,328,593
10 ,Gunma,total,1930,Showa,5,1186080,581007,605073
10 ,Gunma,0_ 4,1930,Showa,5,174421,87700,86721
10 ,Gunma,5_ 9,1930,Showa,5,148226,74428,73798
10 ,Gunma,10_ 14,1930,Showa,5,132990,65095,67895
10 ,Gunma,15_ 19,1930,Showa,5,120055,55612,64443
10 ,Gunma,20_ 24,1930,Showa,5,93305,43589,49716
10 ,Gunma,25_ 29,1930,Showa,5,85760,42821,42939
10 ,Gunma,30_ 34,1930,Showa,5,74284,37565,36719
10 ,Gunma,35_ 39,1930,Showa,5,63761,32269,31492
10 ,Gunma,40_ 44,1930,Showa,5,60504,30461,30043
10 ,Gunma,45_ 49,1930,Showa,5,57250,28133,29117
10 ,Gunma,50_ 54,1930,Showa,5,55429,27140,28289
10 ,Gunma,55_ 59,1930,Showa,5,40172,19752,20420
10 ,Gunma,60_ 64,1930,Showa,5,29273,13889,15384
10 ,Gunma,65_ 69,1930,Showa,5,21667,10138,11529
10 ,Gunma,70_ 74,1930,Showa,5,15120,6796,8324
10 ,Gunma,75_ 79,1930,Showa,5,9079,3823,5256
10 ,Gunma,over_80,1930,Showa,5,4784,1796,2988
10 ,Gunma,total,1935,Showa,10,1242453,606779,635674
10 ,Gunma,0_ 4,1935,Showa,10,176216,88955,87261
10 ,Gunma,5_ 9,1935,Showa,10,162458,81472,80986
10 ,Gunma,10_ 14,1935,Showa,10,144355,70687,73668
10 ,Gunma,15_ 19,1935,Showa,10,116823,53348,63475
10 ,Gunma,20_ 24,1935,Showa,10,98816,45046,53770
10 ,Gunma,25_ 29,1935,Showa,10,85112,41941,43171
10 ,Gunma,30_ 34,1935,Showa,10,81148,40837,40311
10 ,Gunma,35_ 39,1935,Showa,10,70816,35988,34828
10 ,Gunma,40_ 44,1935,Showa,10,60172,30589,29583
10 ,Gunma,45_ 49,1935,Showa,10,56912,28695,28217
10 ,Gunma,50_ 54,1935,Showa,10,52788,25836,26952
10 ,Gunma,55_ 59,1935,Showa,10,49738,23969,25769
10 ,Gunma,60_ 64,1935,Showa,10,34228,16326,17902
10 ,Gunma,65_ 69,1935,Showa,10,23140,10504,12636
10 ,Gunma,70_ 74,1935,Showa,10,15495,6886,8609
10 ,Gunma,75_ 79,1935,Showa,10,8747,3624,5123
10 ,Gunma,over_80,1935,Showa,10,5489,2076,3413
10 ,Gunma,total,1940,Showa,15,1298853,637592,661261
10 ,Gunma,0_ 4,1940,Showa,15,171994,86934,85060
10 ,Gunma,5_ 9,1940,Showa,15,165617,83325,82292
10 ,Gunma,10_ 14,1940,Showa,15,158647,78460,80187
10 ,Gunma,15_ 19,1940,Showa,15,125614,57910,67704
10 ,Gunma,20_ 24,1940,Showa,15,103582,50243,53339
10 ,Gunma,25_ 29,1940,Showa,15,90510,44191,46319
10 ,Gunma,30_ 34,1940,Showa,15,80919,40398,40521
10 ,Gunma,35_ 39,1940,Showa,15,77915,39208,38707
10 ,Gunma,40_ 44,1940,Showa,15,67331,34337,32994
10 ,Gunma,45_ 49,1940,Showa,15,56620,28650,27970
10 ,Gunma,50_ 54,1940,Showa,15,52865,26443,26422
10 ,Gunma,55_ 59,1940,Showa,15,47480,22820,24660
10 ,Gunma,60_ 64,1940,Showa,15,42569,19932,22637
10 ,Gunma,65_ 69,1940,Showa,15,26988,12364,14624
10 ,Gunma,70_ 74,1940,Showa,15,16043,6860,9183
10 ,Gunma,75_ 79,1940,Showa,15,8955,3616,5339
10 ,Gunma,80_ 84,1940,Showa,15,3734,1391,2343
10 ,Gunma,over_85,1940,Showa,15,1467,508,959
10 ,Gunma,total,1945,Showa,20,1546081,723804,822277
10 ,Gunma,1_ 5,1945,Showa,20,210223,106347,103876
10 ,Gunma,6_ 10,1945,Showa,20,195787,98907,96880
10 ,Gunma,11_ 15,1945,Showa,20,188215,94401,93814
10 ,Gunma,16_ 20,1945,Showa,20,165863,80370,85493
10 ,Gunma,21_ 25,1945,Showa,20,117207,43815,73392
10 ,Gunma,26_ 30,1945,Showa,20,94152,33076,61076
10 ,Gunma,31_ 35,1945,Showa,20,95292,38581,56711
10 ,Gunma,36_ 40,1945,Showa,20,90032,42014,48018
10 ,Gunma,41_ 45,1945,Showa,20,86491,42739,43752
10 ,Gunma,46_ 50,1945,Showa,20,72952,36728,36224
10 ,Gunma,51_ 55,1945,Showa,20,59303,29707,29596
10 ,Gunma,56_ 60,1945,Showa,20,53597,26170,27427
10 ,Gunma,61_ 65,1945,Showa,20,44316,20473,23843
10 ,Gunma,66_ 70,1945,Showa,20,36653,16097,20556
10 ,Gunma,71_ 75,1945,Showa,20,21116,8883,12233
10 ,Gunma,76_ 80,1945,Showa,20,9678,3681,5997
10 ,Gunma,81_ 85,1945,Showa,20,3982,1430,2552
10 ,Gunma,86以上,1945,Showa,20,1222,385,837
10 ,Gunma,total,1950,Showa,25,1601380,778910,822470
10 ,Gunma,0_ 4,1950,Showa,25,217621,110937,106684
10 ,Gunma,5_ 9,1950,Showa,25,192138,97350,94788
10 ,Gunma,10_ 14,1950,Showa,25,179825,90844,88981
10 ,Gunma,15_ 19,1950,Showa,25,166552,82100,84452
10 ,Gunma,20_ 24,1950,Showa,25,143814,68680,75134
10 ,Gunma,25_ 29,1950,Showa,25,112162,50014,62148
10 ,Gunma,30_ 34,1950,Showa,25,95886,42859,53027
10 ,Gunma,35_ 39,1950,Showa,25,93125,43239,49886
10 ,Gunma,40_ 44,1950,Showa,25,83408,41084,42324
10 ,Gunma,45_ 49,1950,Showa,25,77753,38980,38773
10 ,Gunma,50_ 54,1950,Showa,25,64346,32552,31794
10 ,Gunma,55_ 59,1950,Showa,25,52094,25891,26203
10 ,Gunma,60_ 64,1950,Showa,25,44970,21598,23372
10 ,Gunma,65_ 69,1950,Showa,25,34578,15474,19104
10 ,Gunma,70_ 74,1950,Showa,25,25195,10557,14638
10 ,Gunma,75_ 79,1950,Showa,25,12166,4744,7422
10 ,Gunma,over_80,1950,Showa,25,5589,1923,3666
10 ,Gunma,total,1955,Showa,30,1613549,781607,831942
10 ,Gunma,0_ 4,1955,Showa,30,169183,86250,82933
10 ,Gunma,5_ 9,1955,Showa,30,206402,105089,101313
10 ,Gunma,10_ 14,1955,Showa,30,185303,93880,91423
10 ,Gunma,15_ 19,1955,Showa,30,155280,74296,80984
10 ,Gunma,20_ 24,1955,Showa,30,139732,64995,74737
10 ,Gunma,25_ 29,1955,Showa,30,129583,63564,66019
10 ,Gunma,30_ 34,1955,Showa,30,105223,47292,57931
10 ,Gunma,35_ 39,1955,Showa,30,90312,40456,49856
10 ,Gunma,40_ 44,1955,Showa,30,87988,40842,47146
10 ,Gunma,45_ 49,1955,Showa,30,78724,38812,39912
10 ,Gunma,50_ 54,1955,Showa,30,72772,36466,36306
10 ,Gunma,55_ 59,1955,Showa,30,59247,29695,29552
10 ,Gunma,60_ 64,1955,Showa,30,46200,22547,23653
10 ,Gunma,65_ 69,1955,Showa,30,37369,17549,19820
10 ,Gunma,70_ 74,1955,Showa,30,25984,10931,15053
10 ,Gunma,75_ 79,1955,Showa,30,16276,6269,10007
10 ,Gunma,80_ 84,1955,Showa,30,6215,2147,4068
10 ,Gunma,over_85,1955,Showa,30,1749,524,1225
10 ,Gunma,total,1960,Showa,35,1578476,759639,818837
10 ,Gunma,0_ 4,1960,Showa,35,131834,67517,64317
10 ,Gunma,5_ 9,1960,Showa,35,165569,84304,81265
10 ,Gunma,10_ 14,1960,Showa,35,202748,103247,99501
10 ,Gunma,15_ 19,1960,Showa,35,148915,70100,78815
10 ,Gunma,20_ 24,1960,Showa,35,121118,53877,67241
10 ,Gunma,25_ 29,1960,Showa,35,122569,59181,63388
10 ,Gunma,30_ 34,1960,Showa,35,122102,60529,61573
10 ,Gunma,35_ 39,1960,Showa,35,100872,45227,55645
10 ,Gunma,40_ 44,1960,Showa,35,86776,38862,47914
10 ,Gunma,45_ 49,1960,Showa,35,83896,38676,45220
10 ,Gunma,50_ 54,1960,Showa,35,74373,36427,37946
10 ,Gunma,55_ 59,1960,Showa,35,67460,33506,33954
10 ,Gunma,60_ 64,1960,Showa,35,53474,26266,27208
10 ,Gunma,65_ 69,1960,Showa,35,39328,18613,20715
10 ,Gunma,70_ 74,1960,Showa,35,28969,12908,16061
10 ,Gunma,75_ 79,1960,Showa,35,17040,6637,10403
10 ,Gunma,80_ 84,1960,Showa,35,8622,2874,5748
10 ,Gunma,over_85,1960,Showa,35,2811,888,1923
10 ,Gunma,total,1965,Showa,40,1605584,778916,826668
10 ,Gunma,0_ 4,1965,Showa,40,126533,64612,61921
10 ,Gunma,5_ 9,1965,Showa,40,132656,67836,64820
10 ,Gunma,10_ 14,1965,Showa,40,164685,83577,81108
10 ,Gunma,15_ 19,1965,Showa,40,178167,87294,90873
10 ,Gunma,20_ 24,1965,Showa,40,130999,60829,70170
10 ,Gunma,25_ 29,1965,Showa,40,118663,57982,60681
10 ,Gunma,30_ 34,1965,Showa,40,123027,61385,61642
10 ,Gunma,35_ 39,1965,Showa,40,122532,61307,61225
10 ,Gunma,40_ 44,1965,Showa,40,100068,45088,54980
10 ,Gunma,45_ 49,1965,Showa,40,85126,38284,46842
10 ,Gunma,50_ 54,1965,Showa,40,80986,37607,43379
10 ,Gunma,55_ 59,1965,Showa,40,70362,34454,35908
10 ,Gunma,60_ 64,1965,Showa,40,61503,30084,31419
10 ,Gunma,65_ 69,1965,Showa,40,46150,21990,24160
10 ,Gunma,70_ 74,1965,Showa,40,31162,14070,17092
10 ,Gunma,75_ 79,1965,Showa,40,19884,8218,11666
10 ,Gunma,80_ 84,1965,Showa,40,9155,3191,5964
10 ,Gunma,over_85,1965,Showa,40,3926,1108,2818
10 ,Gunma,total,1970,Showa,45,1658909,808270,850639
10 ,Gunma,0_ 4,1970,Showa,45,134994,69307,65687
10 ,Gunma,5_ 9,1970,Showa,45,128773,65904,62869
10 ,Gunma,10_ 14,1970,Showa,45,133265,68184,65081
10 ,Gunma,15_ 19,1970,Showa,45,150544,74541,76003
10 ,Gunma,20_ 24,1970,Showa,45,160002,76317,83685
10 ,Gunma,25_ 29,1970,Showa,45,132962,66266,66696
10 ,Gunma,30_ 34,1970,Showa,45,120742,60478,60264
10 ,Gunma,35_ 39,1970,Showa,45,123678,61782,61896
10 ,Gunma,40_ 44,1970,Showa,45,119745,59997,59748
10 ,Gunma,45_ 49,1970,Showa,45,98907,44273,54634
10 ,Gunma,50_ 54,1970,Showa,45,83083,37089,45994
10 ,Gunma,55_ 59,1970,Showa,45,76137,34995,41142
10 ,Gunma,60_ 64,1970,Showa,45,65278,31309,33969
10 ,Gunma,65_ 69,1970,Showa,45,54453,25703,28750
10 ,Gunma,70_ 74,1970,Showa,45,38106,17248,20858
10 ,Gunma,75_ 79,1970,Showa,45,22042,9175,12867
10 ,Gunma,80_ 84,1970,Showa,45,11354,4264,7090
10 ,Gunma,over_85,1970,Showa,45,4844,1438,3406
10 ,Gunma,total,1975,Showa,50,1756480,859364,897116
10 ,Gunma,0_ 4,1975,Showa,50,157325,80265,77060
10 ,Gunma,5_ 9,1975,Showa,50,139453,71500,67953
10 ,Gunma,10_ 14,1975,Showa,50,130843,66900,63943
10 ,Gunma,15_ 19,1975,Showa,50,121882,61295,60587
10 ,Gunma,20_ 24,1975,Showa,50,129463,61726,67737
10 ,Gunma,25_ 29,1975,Showa,50,164317,82205,82112
10 ,Gunma,30_ 34,1975,Showa,50,138109,70194,67915
10 ,Gunma,35_ 39,1975,Showa,50,123847,62532,61315
10 ,Gunma,40_ 44,1975,Showa,50,124814,62513,62301
10 ,Gunma,45_ 49,1975,Showa,50,120489,60166,60323
10 ,Gunma,50_ 54,1975,Showa,50,96927,43188,53739
10 ,Gunma,55_ 59,1975,Showa,50,80704,35727,44977
10 ,Gunma,60_ 64,1975,Showa,50,73840,33333,40507
10 ,Gunma,65_ 69,1975,Showa,50,59868,27977,31891
10 ,Gunma,70_ 74,1975,Showa,50,46219,20759,25460
10 ,Gunma,75_ 79,1975,Showa,50,28246,11877,16369
10 ,Gunma,80_ 84,1975,Showa,50,13729,5151,8578
10 ,Gunma,over_85,1975,Showa,50,6309,2000,4309
10 ,Gunma,total,1980,Showa,55,1848562,908871,939691
10 ,Gunma,0_ 4,1980,Showa,55,137741,70504,67237
10 ,Gunma,5_ 9,1980,Showa,55,161921,82668,79253
10 ,Gunma,10_ 14,1980,Showa,55,141886,72657,69229
10 ,Gunma,15_ 19,1980,Showa,55,123208,62445,60763
10 ,Gunma,20_ 24,1980,Showa,55,106948,52224,54724
10 ,Gunma,25_ 29,1980,Showa,55,140494,70043,70451
10 ,Gunma,30_ 34,1980,Showa,55,169363,86061,83302
10 ,Gunma,35_ 39,1980,Showa,55,141753,72444,69309
10 ,Gunma,40_ 44,1980,Showa,55,125088,63435,61653
10 ,Gunma,45_ 49,1980,Showa,55,124357,62165,62192
10 ,Gunma,50_ 54,1980,Showa,55,119042,59142,59900
10 ,Gunma,55_ 59,1980,Showa,55,94933,42036,52897
10 ,Gunma,60_ 64,1980,Showa,55,77640,33884,43756
10 ,Gunma,65_ 69,1980,Showa,55,68614,30372,38242
10 ,Gunma,70_ 74,1980,Showa,55,52222,23487,28735
10 ,Gunma,75_ 79,1980,Showa,55,36346,15324,21022
10 ,Gunma,80_ 84,1980,Showa,55,18428,7158,11270
10 ,Gunma,over_85,1980,Showa,55,8505,2776,5729
10 ,Gunma,total,1985,Showa,60,1921259,947013,974246
10 ,Gunma,0_ 4,1985,Showa,60,119908,61603,58305
10 ,Gunma,5_ 9,1985,Showa,60,140516,71944,68572
10 ,Gunma,10_ 14,1985,Showa,60,164405,83907,80498
10 ,Gunma,15_ 19,1985,Showa,60,137652,70292,67360
10 ,Gunma,20_ 24,1985,Showa,60,110645,54620,56025
10 ,Gunma,25_ 29,1985,Showa,60,117582,59637,57945
10 ,Gunma,30_ 34,1985,Showa,60,144675,73347,71328
10 ,Gunma,35_ 39,1985,Showa,60,172652,88122,84530
10 ,Gunma,40_ 44,1985,Showa,60,142814,73064,69750
10 ,Gunma,45_ 49,1985,Showa,60,124616,63031,61585
10 ,Gunma,50_ 54,1985,Showa,60,122509,60818,61691
10 ,Gunma,55_ 59,1985,Showa,60,116390,57167,59223
10 ,Gunma,60_ 64,1985,Showa,60,92000,40076,51924
10 ,Gunma,65_ 69,1985,Showa,60,73208,31198,42010
10 ,Gunma,70_ 74,1985,Showa,60,61718,26343,35375
10 ,Gunma,75_ 79,1985,Showa,60,42534,18033,24501
10 ,Gunma,80_ 84,1985,Showa,60,24930,9564,15366
10 ,Gunma,over_85,1985,Showa,60,12481,4235,8246
10 ,Gunma,total,1990,Heisei,2,1966265,971704,994561
10 ,Gunma,0_ 4,1990,Heisei,2,104490,53728,50762
10 ,Gunma,5_ 9,1990,Heisei,2,121822,62611,59211
10 ,Gunma,10_ 14,1990,Heisei,2,141768,72566,69202
10 ,Gunma,15_ 19,1990,Heisei,2,157266,80098,77168
10 ,Gunma,20_ 24,1990,Heisei,2,122491,61546,60945
10 ,Gunma,25_ 29,1990,Heisei,2,119602,60838,58764
10 ,Gunma,30_ 34,1990,Heisei,2,120607,61783,58824
10 ,Gunma,35_ 39,1990,Heisei,2,147150,74949,72201
10 ,Gunma,40_ 44,1990,Heisei,2,173777,89027,84750
10 ,Gunma,45_ 49,1990,Heisei,2,142272,72799,69473
10 ,Gunma,50_ 54,1990,Heisei,2,123511,62269,61242
10 ,Gunma,55_ 59,1990,Heisei,2,120634,59466,61168
10 ,Gunma,60_ 64,1990,Heisei,2,113247,54858,58389
10 ,Gunma,65_ 69,1990,Heisei,2,87600,37480,50120
10 ,Gunma,70_ 74,1990,Heisei,2,66985,27505,39480
10 ,Gunma,75_ 79,1990,Heisei,2,52120,21169,30951
10 ,Gunma,80_ 84,1990,Heisei,2,31183,12043,19140
10 ,Gunma,over_85,1990,Heisei,2,18479,6074,12405
10 ,Gunma,total,1995,Heisei,7,2003540,989610,1013930
10 ,Gunma,0_ 4,1995,Heisei,7,99128,50701,48427
10 ,Gunma,5_ 9,1995,Heisei,7,107350,55300,52050
10 ,Gunma,10_ 14,1995,Heisei,7,123482,63318,60164
10 ,Gunma,15_ 19,1995,Heisei,7,135412,69396,66016
10 ,Gunma,20_ 24,1995,Heisei,7,142968,72379,70589
10 ,Gunma,25_ 29,1995,Heisei,7,132791,68158,64633
10 ,Gunma,30_ 34,1995,Heisei,7,124003,63454,60549
10 ,Gunma,35_ 39,1995,Heisei,7,123380,63218,60162
10 ,Gunma,40_ 44,1995,Heisei,7,148420,75596,72824
10 ,Gunma,45_ 49,1995,Heisei,7,173356,88585,84771
10 ,Gunma,50_ 54,1995,Heisei,7,141140,71720,69420
10 ,Gunma,55_ 59,1995,Heisei,7,121446,60555,60891
10 ,Gunma,60_ 64,1995,Heisei,7,117123,56841,60282
10 ,Gunma,65_ 69,1995,Heisei,7,107923,51098,56825
10 ,Gunma,70_ 74,1995,Heisei,7,81204,33564,47640
10 ,Gunma,75_ 79,1995,Heisei,7,57885,22453,35432
10 ,Gunma,80_ 84,1995,Heisei,7,39837,14735,25102
10 ,Gunma,over_85,1995,Heisei,7,26576,8461,18115
10 ,Gunma,total,2000,Heisei,12,2024852,999349,1025503
10 ,Gunma,0_ 4,2000,Heisei,12,98168,50158,48010
10 ,Gunma,5_ 9,2000,Heisei,12,100664,51553,49111
10 ,Gunma,10_ 14,2000,Heisei,12,108063,55715,52348
10 ,Gunma,15_ 19,2000,Heisei,12,116903,59879,57024
10 ,Gunma,20_ 24,2000,Heisei,12,119418,60820,58598
10 ,Gunma,25_ 29,2000,Heisei,12,150270,77133,73137
10 ,Gunma,30_ 34,2000,Heisei,12,134998,69403,65595
10 ,Gunma,35_ 39,2000,Heisei,12,124572,63588,60984
10 ,Gunma,40_ 44,2000,Heisei,12,123922,63438,60484
10 ,Gunma,45_ 49,2000,Heisei,12,147380,74879,72501
10 ,Gunma,50_ 54,2000,Heisei,12,171109,87016,84093
10 ,Gunma,55_ 59,2000,Heisei,12,138933,69872,69061
10 ,Gunma,60_ 64,2000,Heisei,12,118936,58536,60400
10 ,Gunma,65_ 69,2000,Heisei,12,111969,53230,58739
10 ,Gunma,70_ 74,2000,Heisei,12,99804,45761,54043
10 ,Gunma,75_ 79,2000,Heisei,12,71677,28033,43644
10 ,Gunma,80_ 84,2000,Heisei,12,45831,16319,29512
10 ,Gunma,over_85,2000,Heisei,12,37836,11521,26315
10 ,Gunma,total,2005,Heisei,17,2024135,996346,1027789
10 ,Gunma,0_ 4,2005,Heisei,17,92128,47173,44955
10 ,Gunma,5_ 9,2005,Heisei,17,99293,50739,48554
10 ,Gunma,10_ 14,2005,Heisei,17,100574,51566,49008
10 ,Gunma,15_ 19,2005,Heisei,17,103009,52910,50099
10 ,Gunma,20_ 24,2005,Heisei,17,102975,52581,50394
10 ,Gunma,25_ 29,2005,Heisei,17,126116,64952,61164
10 ,Gunma,30_ 34,2005,Heisei,17,151024,77657,73367
10 ,Gunma,35_ 39,2005,Heisei,17,135115,69273,65842
10 ,Gunma,40_ 44,2005,Heisei,17,124224,63302,60922
10 ,Gunma,45_ 49,2005,Heisei,17,122795,62582,60213
10 ,Gunma,50_ 54,2005,Heisei,17,145379,73308,72071
10 ,Gunma,55_ 59,2005,Heisei,17,167753,84425,83328
10 ,Gunma,60_ 64,2005,Heisei,17,135869,67582,68287
10 ,Gunma,65_ 69,2005,Heisei,17,114158,55178,58980
10 ,Gunma,70_ 74,2005,Heisei,17,104331,48145,56186
10 ,Gunma,75_ 79,2005,Heisei,17,88997,38817,50180
10 ,Gunma,80_ 84,2005,Heisei,17,59099,21227,37872
10 ,Gunma,over_85,2005,Heisei,17,50324,14367,35957
10 ,Gunma,total,2010,Heisei,22,2008068,988019,1020049
10 ,Gunma,0_ 4,2010,Heisei,22,83429,42854,40575
10 ,Gunma,5_ 9,2010,Heisei,22,92728,47528,45200
10 ,Gunma,10_ 14,2010,Heisei,22,99068,50601,48467
10 ,Gunma,15_ 19,2010,Heisei,22,96344,49393,46951
10 ,Gunma,20_ 24,2010,Heisei,22,89790,46016,43774
10 ,Gunma,25_ 29,2010,Heisei,22,104860,54228,50632
10 ,Gunma,30_ 34,2010,Heisei,22,125697,64827,60870
10 ,Gunma,35_ 39,2010,Heisei,22,150672,77278,73394
10 ,Gunma,40_ 44,2010,Heisei,22,134130,68635,65495
10 ,Gunma,45_ 49,2010,Heisei,22,122696,62352,60344
10 ,Gunma,50_ 54,2010,Heisei,22,120755,61223,59532
10 ,Gunma,55_ 59,2010,Heisei,22,142590,71346,71244
10 ,Gunma,60_ 64,2010,Heisei,22,164074,81749,82325
10 ,Gunma,65_ 69,2010,Heisei,22,130494,63857,66637
10 ,Gunma,70_ 74,2010,Heisei,22,107174,50516,56658
10 ,Gunma,75_ 79,2010,Heisei,22,93365,41082,52283
10 ,Gunma,80_ 84,2010,Heisei,22,73745,29476,44269
10 ,Gunma,over_85,2010,Heisei,22,65742,18662,47080
10 ,Gunma,total,2015,Heisei,27,1973115,973283,999832
10 ,Gunma,0_ 4,2015,Heisei,27,74051,37710,36341
10 ,Gunma,5_ 9,2015,Heisei,27,84040,43195,40845
10 ,Gunma,10_ 14,2015,Heisei,27,92793,47545,45248
10 ,Gunma,15_ 19,2015,Heisei,27,95840,49143,46697
10 ,Gunma,20_ 24,2015,Heisei,27,86285,45079,41206
10 ,Gunma,25_ 29,2015,Heisei,27,91635,48445,43190
10 ,Gunma,30_ 34,2015,Heisei,27,104919,54306,50613
10 ,Gunma,35_ 39,2015,Heisei,27,125678,64798,60880
10 ,Gunma,40_ 44,2015,Heisei,27,149996,76909,73087
10 ,Gunma,45_ 49,2015,Heisei,27,132418,67624,64794
10 ,Gunma,50_ 54,2015,Heisei,27,120845,61264,59581
10 ,Gunma,55_ 59,2015,Heisei,27,118512,59736,58776
10 ,Gunma,60_ 64,2015,Heisei,27,139652,69365,70287
10 ,Gunma,65_ 69,2015,Heisei,27,157725,77602,80123
10 ,Gunma,70_ 74,2015,Heisei,27,123185,58916,64269
10 ,Gunma,75_ 79,2015,Heisei,27,97154,44063,53091
10 ,Gunma,80_ 84,2015,Heisei,27,78378,31866,46512
10 ,Gunma,over_85,2015,Heisei,27,83584,25803,57781
11 ,Saitama,total,1920,Taisho,9,1319533,641161,678372
11 ,Saitama,0_ 4,1920,Taisho,9,184336,92410,91926
11 ,Saitama,5_ 9,1920,Taisho,9,166187,83400,82787
11 ,Saitama,10_ 14,1920,Taisho,9,144253,69887,74366
11 ,Saitama,15_ 19,1920,Taisho,9,130179,60366,69813
11 ,Saitama,20_ 24,1920,Taisho,9,98890,44201,54689
11 ,Saitama,25_ 29,1920,Taisho,9,85485,41904,43581
11 ,Saitama,30_ 34,1920,Taisho,9,82986,40874,42112
11 ,Saitama,35_ 39,1920,Taisho,9,78569,38642,39927
11 ,Saitama,40_ 44,1920,Taisho,9,79158,39494,39664
11 ,Saitama,45_ 49,1920,Taisho,9,60204,30095,30109
11 ,Saitama,50_ 54,1920,Taisho,9,51250,25717,25533
11 ,Saitama,55_ 59,1920,Taisho,9,45632,22507,23125
11 ,Saitama,60_ 64,1920,Taisho,9,40539,19528,21011
11 ,Saitama,65_ 69,1920,Taisho,9,32798,15485,17313
11 ,Saitama,70_ 74,1920,Taisho,9,21692,9695,11997
11 ,Saitama,75_ 79,1920,Taisho,9,11237,4680,6557
11 ,Saitama,over_80,1920,Taisho,9,6138,2276,3862
11 ,Saitama,total,1925,Taisho,14,1394461,682052,712409
11 ,Saitama,0_ 4,1925,Taisho,14,197804,99406,98398
11 ,Saitama,5_ 9,1925,Taisho,14,168557,84653,83904
11 ,Saitama,10_ 14,1925,Taisho,14,165852,81215,84637
11 ,Saitama,15_ 19,1925,Taisho,14,133478,61795,71683
11 ,Saitama,20_ 24,1925,Taisho,14,107016,50355,56661
11 ,Saitama,25_ 29,1925,Taisho,14,93047,46204,46843
11 ,Saitama,30_ 34,1925,Taisho,14,81650,40890,40760
11 ,Saitama,35_ 39,1925,Taisho,14,80508,40427,40081
11 ,Saitama,40_ 44,1925,Taisho,14,75459,37400,38059
11 ,Saitama,45_ 49,1925,Taisho,14,75178,37587,37591
11 ,Saitama,50_ 54,1925,Taisho,14,56196,27858,28338
11 ,Saitama,55_ 59,1925,Taisho,14,46238,22874,23364
11 ,Saitama,60_ 64,1925,Taisho,14,39099,18754,20345
11 ,Saitama,65_ 69,1925,Taisho,14,32118,14799,17319
11 ,Saitama,70_ 74,1925,Taisho,14,23167,10268,12899
11 ,Saitama,75_ 79,1925,Taisho,14,12652,5199,7453
11 ,Saitama,80_ 84,1925,Taisho,14,4896,1869,3027
11 ,Saitama,over_85,1925,Taisho,14,1546,499,1047
11 ,Saitama,total,1930,Showa,5,1459172,718779,740393
11 ,Saitama,0_ 4,1930,Showa,5,210534,105434,105100
11 ,Saitama,5_ 9,1930,Showa,5,182179,91675,90504
11 ,Saitama,10_ 14,1930,Showa,5,163081,81146,81935
11 ,Saitama,15_ 19,1930,Showa,5,144815,69278,75537
11 ,Saitama,20_ 24,1930,Showa,5,106596,50650,55946
11 ,Saitama,25_ 29,1930,Showa,5,99419,49891,49528
11 ,Saitama,30_ 34,1930,Showa,5,88748,44790,43958
11 ,Saitama,35_ 39,1930,Showa,5,79087,40063,39024
11 ,Saitama,40_ 44,1930,Showa,5,77265,39019,38246
11 ,Saitama,45_ 49,1930,Showa,5,71731,35569,36162
11 ,Saitama,50_ 54,1930,Showa,5,70243,34902,35341
11 ,Saitama,55_ 59,1930,Showa,5,50739,24794,25945
11 ,Saitama,60_ 64,1930,Showa,5,39756,19127,20629
11 ,Saitama,65_ 69,1930,Showa,5,31040,14250,16790
11 ,Saitama,70_ 74,1930,Showa,5,22841,9943,12898
11 ,Saitama,75_ 79,1930,Showa,5,13545,5531,8014
11 ,Saitama,over_80,1930,Showa,5,7553,2717,4836
11 ,Saitama,total,1935,Showa,10,1528854,753802,775052
11 ,Saitama,0_ 4,1935,Showa,10,212489,106397,106092
11 ,Saitama,5_ 9,1935,Showa,10,196636,98516,98120
11 ,Saitama,10_ 14,1935,Showa,10,176964,88326,88638
11 ,Saitama,15_ 19,1935,Showa,10,140784,67692,73092
11 ,Saitama,20_ 24,1935,Showa,10,118184,55925,62259
11 ,Saitama,25_ 29,1935,Showa,10,101626,50784,50842
11 ,Saitama,30_ 34,1935,Showa,10,96003,48751,47252
11 ,Saitama,35_ 39,1935,Showa,10,86567,44145,42422
11 ,Saitama,40_ 44,1935,Showa,10,76020,38831,37189
11 ,Saitama,45_ 49,1935,Showa,10,73602,37143,36459
11 ,Saitama,50_ 54,1935,Showa,10,67072,33176,33896
11 ,Saitama,55_ 59,1935,Showa,10,63510,31076,32434
11 ,Saitama,60_ 64,1935,Showa,10,43810,20769,23041
11 ,Saitama,65_ 69,1935,Showa,10,31638,14475,17163
11 ,Saitama,70_ 74,1935,Showa,10,22261,9570,12691
11 ,Saitama,75_ 79,1935,Showa,10,13407,5352,8055
11 ,Saitama,over_80,1935,Showa,10,8281,2874,5407
11 ,Saitama,total,1940,Showa,15,1607927,798254,809673
11 ,Saitama,0_ 4,1940,Showa,15,207686,105059,102627
11 ,Saitama,5_ 9,1940,Showa,15,199792,100136,99656
11 ,Saitama,10_ 14,1940,Showa,15,192322,95474,96848
11 ,Saitama,15_ 19,1940,Showa,15,156964,76777,80187
11 ,Saitama,20_ 24,1940,Showa,15,127487,64606,62881
11 ,Saitama,25_ 29,1940,Showa,15,113520,56392,57128
11 ,Saitama,30_ 34,1940,Showa,15,98341,49272,49069
11 ,Saitama,35_ 39,1940,Showa,15,93418,47649,45769
11 ,Saitama,40_ 44,1940,Showa,15,83215,42667,40548
11 ,Saitama,45_ 49,1940,Showa,15,72295,36868,35427
11 ,Saitama,50_ 54,1940,Showa,15,68740,34534,34206
11 ,Saitama,55_ 59,1940,Showa,15,60894,29632,31262
11 ,Saitama,60_ 64,1940,Showa,15,55031,26031,29000
11 ,Saitama,65_ 69,1940,Showa,15,35028,15824,19204
11 ,Saitama,70_ 74,1940,Showa,15,22334,9530,12804
11 ,Saitama,75_ 79,1940,Showa,15,12887,5072,7815
11 ,Saitama,80_ 84,1940,Showa,15,5747,2081,3666
11 ,Saitama,over_85,1940,Showa,15,2224,650,1574
11 ,Saitama,total,1945,Showa,20,2047261,955753,1091508
11 ,Saitama,1_ 5,1945,Showa,20,277611,140220,137391
11 ,Saitama,6_ 10,1945,Showa,20,251791,126988,124803
11 ,Saitama,11_ 15,1945,Showa,20,244773,122248,122525
11 ,Saitama,16_ 20,1945,Showa,20,215026,105313,109713
11 ,Saitama,21_ 25,1945,Showa,20,149196,52187,97009
11 ,Saitama,26_ 30,1945,Showa,20,127738,45404,82334
11 ,Saitama,31_ 35,1945,Showa,20,128439,50655,77784
11 ,Saitama,36_ 40,1945,Showa,20,119226,55357,63869
11 ,Saitama,41_ 45,1945,Showa,20,114733,57804,56929
11 ,Saitama,46_ 50,1945,Showa,20,98207,50159,48048
11 ,Saitama,51_ 55,1945,Showa,20,81976,41416,40560
11 ,Saitama,56_ 60,1945,Showa,20,75054,36819,38235
11 ,Saitama,61_ 65,1945,Showa,20,61317,28460,32857
11 ,Saitama,66_ 70,1945,Showa,20,51093,22688,28405
11 ,Saitama,71_ 75,1945,Showa,20,29006,12065,16941
11 ,Saitama,76_ 80,1945,Showa,20,14062,5309,8753
11 ,Saitama,81_ 85,1945,Showa,20,6123,2089,4034
11 ,Saitama,86以上,1945,Showa,20,1890,572,1318
11 ,Saitama,total,1950,Showa,25,2146445,1049695,1096750
11 ,Saitama,0_ 4,1950,Showa,25,297348,152006,145342
11 ,Saitama,5_ 9,1950,Showa,25,253938,128328,125610
11 ,Saitama,10_ 14,1950,Showa,25,229841,116105,113736
11 ,Saitama,15_ 19,1950,Showa,25,216810,106300,110510
11 ,Saitama,20_ 24,1950,Showa,25,191849,94011,97838
11 ,Saitama,25_ 29,1950,Showa,25,153583,69316,84267
11 ,Saitama,30_ 34,1950,Showa,25,134161,60726,73435
11 ,Saitama,35_ 39,1950,Showa,25,129616,61037,68579
11 ,Saitama,40_ 44,1950,Showa,25,111695,55663,56032
11 ,Saitama,45_ 49,1950,Showa,25,101131,51861,49270
11 ,Saitama,50_ 54,1950,Showa,25,85815,43887,41928
11 ,Saitama,55_ 59,1950,Showa,25,70953,35516,35437
11 ,Saitama,60_ 64,1950,Showa,25,62328,29966,32362
11 ,Saitama,65_ 69,1950,Showa,25,47459,21248,26211
11 ,Saitama,70_ 74,1950,Showa,25,34792,14542,20250
11 ,Saitama,75_ 79,1950,Showa,25,16399,6299,10100
11 ,Saitama,over_80,1950,Showa,25,8555,2799,5756
11 ,Saitama,total,1955,Showa,30,2262623,1110083,1152540
11 ,Saitama,0_ 4,1955,Showa,30,242603,124223,118380
11 ,Saitama,5_ 9,1955,Showa,30,287837,147033,140804
11 ,Saitama,10_ 14,1955,Showa,30,249437,126039,123398
11 ,Saitama,15_ 19,1955,Showa,30,219765,107537,112228
11 ,Saitama,20_ 24,1955,Showa,30,205393,100431,104962
11 ,Saitama,25_ 29,1955,Showa,30,184614,92201,92413
11 ,Saitama,30_ 34,1955,Showa,30,150571,68597,81974
11 ,Saitama,35_ 39,1955,Showa,30,130378,59505,70873
11 ,Saitama,40_ 44,1955,Showa,30,125273,59064,66209
11 ,Saitama,45_ 49,1955,Showa,30,107290,53453,53837
11 ,Saitama,50_ 54,1955,Showa,30,96076,49181,46895
11 ,Saitama,55_ 59,1955,Showa,30,80157,40726,39431
11 ,Saitama,60_ 64,1955,Showa,30,63320,31114,32206
11 ,Saitama,65_ 69,1955,Showa,30,51622,24094,27528
11 ,Saitama,70_ 74,1955,Showa,30,35505,15002,20503
11 ,Saitama,75_ 79,1955,Showa,30,22045,8427,13618
11 ,Saitama,80_ 84,1955,Showa,30,8078,2738,5340
11 ,Saitama,over_85,1955,Showa,30,2650,713,1937
11 ,Saitama,total,1960,Showa,35,2430871,1200573,1230298
11 ,Saitama,0_ 4,1960,Showa,35,213473,109368,104105
11 ,Saitama,5_ 9,1960,Showa,35,246491,126207,120284
11 ,Saitama,10_ 14,1960,Showa,35,292060,149298,142762
11 ,Saitama,15_ 19,1960,Showa,35,248179,123132,125047
11 ,Saitama,20_ 24,1960,Showa,35,215510,107089,108421
11 ,Saitama,25_ 29,1960,Showa,35,208817,104683,104134
11 ,Saitama,30_ 34,1960,Showa,35,193051,98375,94676
11 ,Saitama,35_ 39,1960,Showa,35,154232,71254,82978
11 ,Saitama,40_ 44,1960,Showa,35,130841,60051,70790
11 ,Saitama,45_ 49,1960,Showa,35,124271,58709,65562
11 ,Saitama,50_ 54,1960,Showa,35,104647,51839,52808
11 ,Saitama,55_ 59,1960,Showa,35,92442,46792,45650
11 ,Saitama,60_ 64,1960,Showa,35,73851,36662,37189
11 ,Saitama,65_ 69,1960,Showa,35,54603,25828,28775
11 ,Saitama,70_ 74,1960,Showa,35,40241,17690,22551
11 ,Saitama,75_ 79,1960,Showa,35,23263,8865,14398
11 ,Saitama,80_ 84,1960,Showa,35,11276,3708,7568
11 ,Saitama,over_85,1960,Showa,35,3623,1023,2600
11 ,Saitama,total,1965,Showa,40,3014983,1511947,1503036
11 ,Saitama,0_ 4,1965,Showa,40,286643,146220,140423
11 ,Saitama,5_ 9,1965,Showa,40,240539,122479,118060
11 ,Saitama,10_ 14,1965,Showa,40,263779,134431,129348
11 ,Saitama,15_ 19,1965,Showa,40,339887,174937,164950
11 ,Saitama,20_ 24,1965,Showa,40,301207,154657,146550
11 ,Saitama,25_ 29,1965,Showa,40,290905,146401,144504
11 ,Saitama,30_ 34,1965,Showa,40,274830,144568,130262
11 ,Saitama,35_ 39,1965,Showa,40,224280,117546,106734
11 ,Saitama,40_ 44,1965,Showa,40,168216,79099,89117
11 ,Saitama,45_ 49,1965,Showa,40,139200,64018,75182
11 ,Saitama,50_ 54,1965,Showa,40,130205,61229,68976
11 ,Saitama,55_ 59,1965,Showa,40,108004,53249,54755
11 ,Saitama,60_ 64,1965,Showa,40,89603,44491,45112
11 ,Saitama,65_ 69,1965,Showa,40,66962,31995,34967
11 ,Saitama,70_ 74,1965,Showa,40,44833,19891,24942
11 ,Saitama,75_ 79,1965,Showa,40,27984,11202,16782
11 ,Saitama,80_ 84,1965,Showa,40,12527,4086,8441
11 ,Saitama,over_85,1965,Showa,40,5379,1448,3931
11 ,Saitama,total,1970,Showa,45,3866472,1951219,1915253
11 ,Saitama,0_ 4,1970,Showa,45,415367,212813,202554
11 ,Saitama,5_ 9,1970,Showa,45,327322,167518,159804
11 ,Saitama,10_ 14,1970,Showa,45,260174,132720,127454
11 ,Saitama,15_ 19,1970,Showa,45,321156,166369,154787
11 ,Saitama,20_ 24,1970,Showa,45,414863,215273,199590
11 ,Saitama,25_ 29,1970,Showa,45,406684,200634,206050
11 ,Saitama,30_ 34,1970,Showa,45,379893,198421,181472
11 ,Saitama,35_ 39,1970,Showa,45,319533,171509,148024
11 ,Saitama,40_ 44,1970,Showa,45,243954,128244,115710
11 ,Saitama,45_ 49,1970,Showa,45,182828,85508,97320
11 ,Saitama,50_ 54,1970,Showa,45,150332,68527,81805
11 ,Saitama,55_ 59,1970,Showa,45,137029,64172,72857
11 ,Saitama,60_ 64,1970,Showa,45,108748,52413,56335
11 ,Saitama,65_ 69,1970,Showa,45,84565,40214,44351
11 ,Saitama,70_ 74,1970,Showa,45,57931,25958,31973
11 ,Saitama,75_ 79,1970,Showa,45,32921,13298,19623
11 ,Saitama,80_ 84,1970,Showa,45,16469,5826,10643
11 ,Saitama,over_85,1970,Showa,45,6703,1802,4901
11 ,Saitama,total,1975,Showa,50,4821340,2437128,2384212
11 ,Saitama,0_ 4,1975,Showa,50,532546,273763,258783
11 ,Saitama,5_ 9,1975,Showa,50,457576,235203,222373
11 ,Saitama,10_ 14,1975,Showa,50,350014,179443,170571
11 ,Saitama,15_ 19,1975,Showa,50,306437,158145,148292
11 ,Saitama,20_ 24,1975,Showa,50,384660,199335,185325
11 ,Saitama,25_ 29,1975,Showa,50,515429,255363,260066
11 ,Saitama,30_ 34,1975,Showa,50,498018,252881,245137
11 ,Saitama,35_ 39,1975,Showa,50,423094,224278,198816
11 ,Saitama,40_ 44,1975,Showa,50,342770,183962,158808
11 ,Saitama,45_ 49,1975,Showa,50,261842,136373,125469
11 ,Saitama,50_ 54,1975,Showa,50,193496,89930,103566
11 ,Saitama,55_ 59,1975,Showa,50,156741,70614,86127
11 ,Saitama,60_ 64,1975,Showa,50,140651,64206,76445
11 ,Saitama,65_ 69,1975,Showa,50,105257,48950,56307
11 ,Saitama,70_ 74,1975,Showa,50,75051,33853,41198
11 ,Saitama,75_ 79,1975,Showa,50,45188,18791,26397
11 ,Saitama,80_ 84,1975,Showa,50,21091,7678,13413
11 ,Saitama,over_85,1975,Showa,50,9427,2873,6554
11 ,Saitama,total,1980,Showa,55,5420480,2739175,2681305
11 ,Saitama,0_ 4,1980,Showa,55,434011,223321,210690
11 ,Saitama,5_ 9,1980,Showa,55,553901,284427,269474
11 ,Saitama,10_ 14,1980,Showa,55,470509,242179,228330
11 ,Saitama,15_ 19,1980,Showa,55,380181,196243,183938
11 ,Saitama,20_ 24,1980,Showa,55,341335,178299,163036
11 ,Saitama,25_ 29,1980,Showa,55,418112,210189,207923
11 ,Saitama,30_ 34,1980,Showa,55,562078,279818,282260
11 ,Saitama,35_ 39,1980,Showa,55,521698,266772,254926
11 ,Saitama,40_ 44,1980,Showa,55,434280,229968,204312
11 ,Saitama,45_ 49,1980,Showa,55,348471,185763,162708
11 ,Saitama,50_ 54,1980,Showa,55,266077,137314,128763
11 ,Saitama,55_ 59,1980,Showa,55,196264,90221,106043
11 ,Saitama,60_ 64,1980,Showa,55,156054,68957,87097
11 ,Saitama,65_ 69,1980,Showa,55,134928,59805,75123
11 ,Saitama,70_ 74,1980,Showa,55,94910,42210,52700
11 ,Saitama,75_ 79,1980,Showa,55,60315,25463,34852
11 ,Saitama,80_ 84,1980,Showa,55,30266,11418,18848
11 ,Saitama,over_85,1980,Showa,55,13455,4118,9337
11 ,Saitama,total,1985,Showa,60,5863678,2961591,2902087
11 ,Saitama,0_ 4,1985,Showa,60,365844,187173,178671
11 ,Saitama,5_ 9,1985,Showa,60,448822,230728,218094
11 ,Saitama,10_ 14,1985,Showa,60,565514,290378,275136
11 ,Saitama,15_ 19,1985,Showa,60,492913,254721,238192
11 ,Saitama,20_ 24,1985,Showa,60,403236,211778,191458
11 ,Saitama,25_ 29,1985,Showa,60,354233,183048,171185
11 ,Saitama,30_ 34,1985,Showa,60,449471,225677,223794
11 ,Saitama,35_ 39,1985,Showa,60,584626,292747,291879
11 ,Saitama,40_ 44,1985,Showa,60,530782,271606,259176
11 ,Saitama,45_ 49,1985,Showa,60,437445,230545,206900
11 ,Saitama,50_ 54,1985,Showa,60,348713,184450,164263
11 ,Saitama,55_ 59,1985,Showa,60,264970,135076,129894
11 ,Saitama,60_ 64,1985,Showa,60,194184,87630,106554
11 ,Saitama,65_ 69,1985,Showa,60,150317,64421,85896
11 ,Saitama,70_ 74,1985,Showa,60,124488,52802,71686
11 ,Saitama,75_ 79,1985,Showa,60,80245,33335,46910
11 ,Saitama,80_ 84,1985,Showa,60,43561,16662,26899
11 ,Saitama,over_85,1985,Showa,60,21488,6746,14742
11 ,Saitama,total,1990,Heisei,2,6405319,3245868,3159451
11 ,Saitama,0_ 4,1990,Heisei,2,337960,173279,164681
11 ,Saitama,5_ 9,1990,Heisei,2,392988,201305,191683
11 ,Saitama,10_ 14,1990,Heisei,2,465998,239690,226308
11 ,Saitama,15_ 19,1990,Heisei,2,597462,307879,289583
11 ,Saitama,20_ 24,1990,Heisei,2,538195,282660,255535
11 ,Saitama,25_ 29,1990,Heisei,2,433950,227111,206839
11 ,Saitama,30_ 34,1990,Heisei,2,402315,207795,194520
11 ,Saitama,35_ 39,1990,Heisei,2,486158,247100,239058
11 ,Saitama,40_ 44,1990,Heisei,2,607635,306104,301531
11 ,Saitama,45_ 49,1990,Heisei,2,539958,276060,263898
11 ,Saitama,50_ 54,1990,Heisei,2,442078,232065,210013
11 ,Saitama,55_ 59,1990,Heisei,2,349721,183301,166420
11 ,Saitama,60_ 64,1990,Heisei,2,262730,131884,130846
11 ,Saitama,65_ 69,1990,Heisei,2,188046,82430,105616
11 ,Saitama,70_ 74,1990,Heisei,2,140596,57918,82678
11 ,Saitama,75_ 79,1990,Heisei,2,108130,42994,65136
11 ,Saitama,80_ 84,1990,Heisei,2,60284,22647,37637
11 ,Saitama,over_85,1990,Heisei,2,33483,10809,22674
11 ,Saitama,total,1995,Heisei,7,6759311,3419218,3340093
11 ,Saitama,0_ 4,1995,Heisei,7,339209,173697,165512
11 ,Saitama,5_ 9,1995,Heisei,7,350642,179834,170808
11 ,Saitama,10_ 14,1995,Heisei,7,400544,205296,195248
11 ,Saitama,15_ 19,1995,Heisei,7,489274,251827,237447
11 ,Saitama,20_ 24,1995,Heisei,7,622113,322294,299819
11 ,Saitama,25_ 29,1995,Heisei,7,539473,281277,258196
11 ,Saitama,30_ 34,1995,Heisei,7,465868,243391,222477
11 ,Saitama,35_ 39,1995,Heisei,7,424421,220067,204354
11 ,Saitama,40_ 44,1995,Heisei,7,498730,253682,245048
11 ,Saitama,45_ 49,1995,Heisei,7,614673,309213,305460
11 ,Saitama,50_ 54,1995,Heisei,7,540388,275549,264839
11 ,Saitama,55_ 59,1995,Heisei,7,439828,229686,210142
11 ,Saitama,60_ 64,1995,Heisei,7,342177,177012,165165
11 ,Saitama,65_ 69,1995,Heisei,7,250979,122973,128006
11 ,Saitama,70_ 74,1995,Heisei,7,174179,73201,100978
11 ,Saitama,75_ 79,1995,Heisei,7,122184,46979,75205
11 ,Saitama,80_ 84,1995,Heisei,7,83165,29819,53346
11 ,Saitama,over_85,1995,Heisei,7,50665,15549,35116
11 ,Saitama,total,2000,Heisei,12,6938006,3500224,3437782
11 ,Saitama,0_ 4,2000,Heisei,12,334106,170854,163252
11 ,Saitama,5_ 9,2000,Heisei,12,338965,173754,165211
11 ,Saitama,10_ 14,2000,Heisei,12,351716,180566,171150
11 ,Saitama,15_ 19,2000,Heisei,12,418663,215132,203531
11 ,Saitama,20_ 24,2000,Heisei,12,503591,262358,241233
11 ,Saitama,25_ 29,2000,Heisei,12,600660,311036,289624
11 ,Saitama,30_ 34,2000,Heisei,12,538361,280577,257784
11 ,Saitama,35_ 39,2000,Heisei,12,466683,243200,223483
11 ,Saitama,40_ 44,2000,Heisei,12,424292,219008,205284
11 ,Saitama,45_ 49,2000,Heisei,12,495805,250813,244992
11 ,Saitama,50_ 54,2000,Heisei,12,606501,302965,303536
11 ,Saitama,55_ 59,2000,Heisei,12,529596,267853,261743
11 ,Saitama,60_ 64,2000,Heisei,12,427050,219590,207460
11 ,Saitama,65_ 69,2000,Heisei,12,324319,163747,160572
11 ,Saitama,70_ 74,2000,Heisei,12,231875,109650,122225
11 ,Saitama,75_ 79,2000,Heisei,12,155677,62058,93619
11 ,Saitama,80_ 84,2000,Heisei,12,98227,34513,63714
11 ,Saitama,over_85,2000,Heisei,12,79145,23623,55522
11 ,Saitama,total,2005,Heisei,17,7054243,3554843,3499400
11 ,Saitama,0_ 4,2005,Heisei,17,314918,161198,153720
11 ,Saitama,5_ 9,2005,Heisei,17,333788,170744,163044
11 ,Saitama,10_ 14,2005,Heisei,17,337655,173144,164511
11 ,Saitama,15_ 19,2005,Heisei,17,366383,189256,177127
11 ,Saitama,20_ 24,2005,Heisei,17,430772,224751,206021
11 ,Saitama,25_ 29,2005,Heisei,17,480344,249188,231156
11 ,Saitama,30_ 34,2005,Heisei,17,596644,310383,286261
11 ,Saitama,35_ 39,2005,Heisei,17,534636,278312,256324
11 ,Saitama,40_ 44,2005,Heisei,17,462504,240368,222136
11 ,Saitama,45_ 49,2005,Heisei,17,420091,215581,204510
11 ,Saitama,50_ 54,2005,Heisei,17,489172,246610,242562
11 ,Saitama,55_ 59,2005,Heisei,17,595169,296126,299043
11 ,Saitama,60_ 64,2005,Heisei,17,516538,259315,257223
11 ,Saitama,65_ 69,2005,Heisei,17,409437,207343,202094
11 ,Saitama,70_ 74,2005,Heisei,17,303707,149082,154625
11 ,Saitama,75_ 79,2005,Heisei,17,207222,93022,114200
11 ,Saitama,80_ 84,2005,Heisei,17,128342,46645,81697
11 ,Saitama,over_85,2005,Heisei,17,108298,30401,77897
11 ,Saitama,total,2010,Heisei,22,7194556,3608711,3585845
11 ,Saitama,0_ 4,2010,Heisei,22,301586,154326,147260
11 ,Saitama,5_ 9,2010,Heisei,22,317477,162691,154786
11 ,Saitama,10_ 14,2010,Heisei,22,334605,171315,163290
11 ,Saitama,15_ 19,2010,Heisei,22,356249,183477,172772
11 ,Saitama,20_ 24,2010,Heisei,22,389023,201811,187212
11 ,Saitama,25_ 29,2010,Heisei,22,423019,217904,205115
11 ,Saitama,30_ 34,2010,Heisei,22,491671,254811,236860
11 ,Saitama,35_ 39,2010,Heisei,22,606464,315895,290569
11 ,Saitama,40_ 44,2010,Heisei,22,538984,280673,258311
11 ,Saitama,45_ 49,2010,Heisei,22,462165,239189,222976
11 ,Saitama,50_ 54,2010,Heisei,22,418643,214515,204128
11 ,Saitama,55_ 59,2010,Heisei,22,482672,241444,241228
11 ,Saitama,60_ 64,2010,Heisei,22,580218,285175,295043
11 ,Saitama,65_ 69,2010,Heisei,22,494324,243408,250916
11 ,Saitama,70_ 74,2010,Heisei,22,383654,188816,194838
11 ,Saitama,75_ 79,2010,Heisei,22,272446,127055,145391
11 ,Saitama,80_ 84,2010,Heisei,22,171461,69828,101633
11 ,Saitama,over_85,2010,Heisei,22,142975,39528,103447
11 ,Saitama,total,2015,Heisei,27,7266534,3628418,3638116
11 ,Saitama,0_ 4,2015,Heisei,27,283932,145339,138593
11 ,Saitama,5_ 9,2015,Heisei,27,306037,156880,149157
11 ,Saitama,10_ 14,2015,Heisei,27,320836,164499,156337
11 ,Saitama,15_ 19,2015,Heisei,27,352775,181378,171397
11 ,Saitama,20_ 24,2015,Heisei,27,373218,192837,180381
11 ,Saitama,25_ 29,2015,Heisei,27,373411,191808,181603
11 ,Saitama,30_ 34,2015,Heisei,27,426232,218250,207982
11 ,Saitama,35_ 39,2015,Heisei,27,496414,256666,239748
11 ,Saitama,40_ 44,2015,Heisei,27,608039,315834,292205
11 ,Saitama,45_ 49,2015,Heisei,27,536165,277448,258717
11 ,Saitama,50_ 54,2015,Heisei,27,459647,236770,222877
11 ,Saitama,55_ 59,2015,Heisei,27,411320,208766,202554
11 ,Saitama,60_ 64,2015,Heisei,27,469953,232703,237250
11 ,Saitama,65_ 69,2015,Heisei,27,557503,269367,288136
11 ,Saitama,70_ 74,2015,Heisei,27,465107,222621,242486
11 ,Saitama,75_ 79,2015,Heisei,27,346530,163151,183379
11 ,Saitama,80_ 84,2015,Heisei,27,228474,98456,130018
11 ,Saitama,over_85,2015,Heisei,27,191121,59221,131900
12 ,Chiba,total,1920,Taisho,9,1336155,656968,679187
12 ,Chiba,0_ 4,1920,Taisho,9,174193,87208,86985
12 ,Chiba,5_ 9,1920,Taisho,9,163185,82177,81008
12 ,Chiba,10_ 14,1920,Taisho,9,136927,67785,69142
12 ,Chiba,15_ 19,1920,Taisho,9,112451,55248,57203
12 ,Chiba,20_ 24,1920,Taisho,9,103653,53954,49699
12 ,Chiba,25_ 29,1920,Taisho,9,82732,40913,41819
12 ,Chiba,30_ 34,1920,Taisho,9,84332,41063,43269
12 ,Chiba,35_ 39,1920,Taisho,9,77224,37096,40128
12 ,Chiba,40_ 44,1920,Taisho,9,81827,40109,41718
12 ,Chiba,45_ 49,1920,Taisho,9,68216,33577,34639
12 ,Chiba,50_ 54,1920,Taisho,9,56782,27972,28810
12 ,Chiba,55_ 59,1920,Taisho,9,51945,25375,26570
12 ,Chiba,60_ 64,1920,Taisho,9,48796,23370,25426
12 ,Chiba,65_ 69,1920,Taisho,9,41779,19391,22388
12 ,Chiba,70_ 74,1920,Taisho,9,27646,12248,15398
12 ,Chiba,75_ 79,1920,Taisho,9,15765,6401,9364
12 ,Chiba,over_80,1920,Taisho,9,8702,3081,5621
12 ,Chiba,total,1925,Taisho,14,1399257,691242,708015
12 ,Chiba,0_ 4,1925,Taisho,14,185511,93103,92408
12 ,Chiba,5_ 9,1925,Taisho,14,163993,82284,81709
12 ,Chiba,10_ 14,1925,Taisho,14,155444,77692,77752
12 ,Chiba,15_ 19,1925,Taisho,14,115736,57171,58565
12 ,Chiba,20_ 24,1925,Taisho,14,110683,58825,51858
12 ,Chiba,25_ 29,1925,Taisho,14,95164,47866,47298
12 ,Chiba,30_ 34,1925,Taisho,14,81085,40704,40381
12 ,Chiba,35_ 39,1925,Taisho,14,82045,40710,41335
12 ,Chiba,40_ 44,1925,Taisho,14,74932,36271,38661
12 ,Chiba,45_ 49,1925,Taisho,14,78680,38490,40190
12 ,Chiba,50_ 54,1925,Taisho,14,64440,31433,33007
12 ,Chiba,55_ 59,1925,Taisho,14,52142,25321,26821
12 ,Chiba,60_ 64,1925,Taisho,14,45229,21364,23865
12 ,Chiba,65_ 69,1925,Taisho,14,39031,17707,21324
12 ,Chiba,70_ 74,1925,Taisho,14,29878,12826,17052
12 ,Chiba,75_ 79,1925,Taisho,14,16167,6427,9740
12 ,Chiba,80_ 84,1925,Taisho,14,6789,2369,4420
12 ,Chiba,over_85,1925,Taisho,14,2308,679,1629
12 ,Chiba,total,1930,Showa,5,1470121,729439,740682
12 ,Chiba,0_ 4,1930,Showa,5,199489,100117,99372
12 ,Chiba,5_ 9,1930,Showa,5,175537,88094,87443
12 ,Chiba,10_ 14,1930,Showa,5,156404,77976,78428
12 ,Chiba,15_ 19,1930,Showa,5,130769,65415,65354
12 ,Chiba,20_ 24,1930,Showa,5,114033,62070,51963
12 ,Chiba,25_ 29,1930,Showa,5,100499,50894,49605
12 ,Chiba,30_ 34,1930,Showa,5,92742,47059,45683
12 ,Chiba,35_ 39,1930,Showa,5,78580,39572,39008
12 ,Chiba,40_ 44,1930,Showa,5,79289,39502,39787
12 ,Chiba,45_ 49,1930,Showa,5,71629,34635,36994
12 ,Chiba,50_ 54,1930,Showa,5,73832,35872,37960
12 ,Chiba,55_ 59,1930,Showa,5,59016,28345,30671
12 ,Chiba,60_ 64,1930,Showa,5,45549,21385,24164
12 ,Chiba,65_ 69,1930,Showa,5,36598,16414,20184
12 ,Chiba,70_ 74,1930,Showa,5,28133,11862,16271
12 ,Chiba,75_ 79,1930,Showa,5,17992,6929,11063
12 ,Chiba,over_80,1930,Showa,5,10030,3298,6732
12 ,Chiba,total,1935,Showa,10,1546394,764751,781643
12 ,Chiba,0_ 4,1935,Showa,10,205697,103197,102500
12 ,Chiba,5_ 9,1935,Showa,10,191272,96012,95260
12 ,Chiba,10_ 14,1935,Showa,10,169765,84363,85402
12 ,Chiba,15_ 19,1935,Showa,10,130656,64279,66377
12 ,Chiba,20_ 24,1935,Showa,10,122662,64342,58320
12 ,Chiba,25_ 29,1935,Showa,10,103801,52514,51287
12 ,Chiba,30_ 34,1935,Showa,10,98704,50014,48690
12 ,Chiba,35_ 39,1935,Showa,10,90186,45832,44354
12 ,Chiba,40_ 44,1935,Showa,10,76306,38780,37526
12 ,Chiba,45_ 49,1935,Showa,10,76520,38106,38414
12 ,Chiba,50_ 54,1935,Showa,10,67550,32517,35033
12 ,Chiba,55_ 59,1935,Showa,10,68097,32440,35657
12 ,Chiba,60_ 64,1935,Showa,10,52112,24159,27953
12 ,Chiba,65_ 69,1935,Showa,10,37227,16705,20522
12 ,Chiba,70_ 74,1935,Showa,10,26899,11198,15701
12 ,Chiba,75_ 79,1935,Showa,10,17539,6629,10910
12 ,Chiba,over_80,1935,Showa,10,11401,3664,7737
12 ,Chiba,total,1940,Showa,15,1588218,776401,811817
12 ,Chiba,0_ 4,1940,Showa,15,196335,98656,97679
12 ,Chiba,5_ 9,1940,Showa,15,197381,99084,98297
12 ,Chiba,10_ 14,1940,Showa,15,184265,91565,92700
12 ,Chiba,15_ 19,1940,Showa,15,138693,66188,72505
12 ,Chiba,20_ 24,1940,Showa,15,116986,59027,57959
12 ,Chiba,25_ 29,1940,Showa,15,110332,53803,56529
12 ,Chiba,30_ 34,1940,Showa,15,98626,48678,49948
12 ,Chiba,35_ 39,1940,Showa,15,94948,47520,47428
12 ,Chiba,40_ 44,1940,Showa,15,86423,43510,42913
12 ,Chiba,45_ 49,1940,Showa,15,72658,36502,36156
12 ,Chiba,50_ 54,1940,Showa,15,71828,35229,36599
12 ,Chiba,55_ 59,1940,Showa,15,62045,29051,32994
12 ,Chiba,60_ 64,1940,Showa,15,59957,27659,32298
12 ,Chiba,65_ 69,1940,Showa,15,42943,18909,24034
12 ,Chiba,70_ 74,1940,Showa,15,27175,11293,15882
12 ,Chiba,75_ 79,1940,Showa,15,16470,6195,10275
12 ,Chiba,80_ 84,1940,Showa,15,7950,2647,5303
12 ,Chiba,over_85,1940,Showa,15,3188,877,2311
12 ,Chiba,total,1945,Showa,20,1966862,908228,1058634
12 ,Chiba,1_ 5,1945,Showa,20,256041,129004,127037
12 ,Chiba,6_ 10,1945,Showa,20,234558,117788,116770
12 ,Chiba,11_ 15,1945,Showa,20,233089,116492,116597
12 ,Chiba,16_ 20,1945,Showa,20,202258,98628,103630
12 ,Chiba,21_ 25,1945,Showa,20,141299,49768,91531
12 ,Chiba,26_ 30,1945,Showa,20,119651,41979,77672
12 ,Chiba,31_ 35,1945,Showa,20,119011,45147,73864
12 ,Chiba,36_ 40,1945,Showa,20,112186,49681,62505
12 ,Chiba,41_ 45,1945,Showa,20,112381,55831,56550
12 ,Chiba,46_ 50,1945,Showa,20,99853,50526,49327
12 ,Chiba,51_ 55,1945,Showa,20,80598,40508,40090
12 ,Chiba,56_ 60,1945,Showa,20,76572,37153,39419
12 ,Chiba,61_ 65,1945,Showa,20,61557,27894,33663
12 ,Chiba,66_ 70,1945,Showa,20,54339,23618,30721
12 ,Chiba,71_ 75,1945,Showa,20,35215,14270,20945
12 ,Chiba,76_ 80,1945,Showa,20,17348,6506,10842
12 ,Chiba,81_ 85,1945,Showa,20,8070,2631,5439
12 ,Chiba,86以上,1945,Showa,20,2836,804,2032
12 ,Chiba,total,1950,Showa,25,2139037,1036932,1102105
12 ,Chiba,0_ 4,1950,Showa,25,283277,143910,139367
12 ,Chiba,5_ 9,1950,Showa,25,248427,125351,123076
12 ,Chiba,10_ 14,1950,Showa,25,224737,112713,112024
12 ,Chiba,15_ 19,1950,Showa,25,212479,105658,106821
12 ,Chiba,20_ 24,1950,Showa,25,185849,91250,94599
12 ,Chiba,25_ 29,1950,Showa,25,149443,66913,82530
12 ,Chiba,30_ 34,1950,Showa,25,132266,59265,73001
12 ,Chiba,35_ 39,1950,Showa,25,129749,60105,69644
12 ,Chiba,40_ 44,1950,Showa,25,113416,55501,57915
12 ,Chiba,45_ 49,1950,Showa,25,105236,52937,52299
12 ,Chiba,50_ 54,1950,Showa,25,90943,45905,45038
12 ,Chiba,55_ 59,1950,Showa,25,73533,36484,37049
12 ,Chiba,60_ 64,1950,Showa,25,66989,31574,35415
12 ,Chiba,65_ 69,1950,Showa,25,49666,21588,28078
12 ,Chiba,70_ 74,1950,Showa,25,39701,16196,23505
12 ,Chiba,75_ 79,1950,Showa,25,21622,8048,13574
12 ,Chiba,over_80,1950,Showa,25,11649,3512,8137
12 ,Chiba,total,1955,Showa,30,2205060,1074181,1130879
12 ,Chiba,0_ 4,1955,Showa,30,225227,114594,110633
12 ,Chiba,5_ 9,1955,Showa,30,274329,139622,134707
12 ,Chiba,10_ 14,1955,Showa,30,241303,121693,119610
12 ,Chiba,15_ 19,1955,Showa,30,203247,99745,103502
12 ,Chiba,20_ 24,1955,Showa,30,194022,97391,96631
12 ,Chiba,25_ 29,1955,Showa,30,176753,87883,88870
12 ,Chiba,30_ 34,1955,Showa,30,144891,65404,79487
12 ,Chiba,35_ 39,1955,Showa,30,127173,57336,69837
12 ,Chiba,40_ 44,1955,Showa,30,123999,57481,66518
12 ,Chiba,45_ 49,1955,Showa,30,108209,52846,55363
12 ,Chiba,50_ 54,1955,Showa,30,99585,50028,49557
12 ,Chiba,55_ 59,1955,Showa,30,84812,42468,42344
12 ,Chiba,60_ 64,1955,Showa,30,65612,31948,33664
12 ,Chiba,65_ 69,1955,Showa,30,56254,25628,30626
12 ,Chiba,70_ 74,1955,Showa,30,38134,15543,22591
12 ,Chiba,75_ 79,1955,Showa,30,26153,9748,16405
12 ,Chiba,80_ 84,1955,Showa,30,11437,3783,7654
12 ,Chiba,over_85,1955,Showa,30,3908,1035,2873
12 ,Chiba,total,1960,Showa,35,2306010,1128734,1177276
12 ,Chiba,0_ 4,1960,Showa,35,192910,98096,94814
12 ,Chiba,5_ 9,1960,Showa,35,230249,117238,113011
12 ,Chiba,10_ 14,1960,Showa,35,277036,141013,136023
12 ,Chiba,15_ 19,1960,Showa,35,216572,106869,109703
12 ,Chiba,20_ 24,1960,Showa,35,190491,95630,94861
12 ,Chiba,25_ 29,1960,Showa,35,193918,97876,96042
12 ,Chiba,30_ 34,1960,Showa,35,182412,91790,90622
12 ,Chiba,35_ 39,1960,Showa,35,146971,67007,79964
12 ,Chiba,40_ 44,1960,Showa,35,126810,57548,69262
12 ,Chiba,45_ 49,1960,Showa,35,122259,56820,65439
12 ,Chiba,50_ 54,1960,Showa,35,105418,51257,54161
12 ,Chiba,55_ 59,1960,Showa,35,95298,47504,47794
12 ,Chiba,60_ 64,1960,Showa,35,78568,38437,40131
12 ,Chiba,65_ 69,1960,Showa,35,57273,26928,30345
12 ,Chiba,70_ 74,1960,Showa,35,44741,19213,25528
12 ,Chiba,75_ 79,1960,Showa,35,25717,9486,16231
12 ,Chiba,80_ 84,1960,Showa,35,13983,4521,9462
12 ,Chiba,over_85,1960,Showa,35,5384,1501,3883
12 ,Chiba,total,1965,Showa,40,2701770,1343167,1358603
12 ,Chiba,0_ 4,1965,Showa,40,241160,122993,118167
12 ,Chiba,5_ 9,1965,Showa,40,216115,109511,106604
12 ,Chiba,10_ 14,1965,Showa,40,244065,123736,120329
12 ,Chiba,15_ 19,1965,Showa,40,279493,143536,135957
12 ,Chiba,20_ 24,1965,Showa,40,246511,128470,118041
12 ,Chiba,25_ 29,1965,Showa,40,241887,120878,121009
12 ,Chiba,30_ 34,1965,Showa,40,240649,125541,115108
12 ,Chiba,35_ 39,1965,Showa,40,207526,106800,100726
12 ,Chiba,40_ 44,1965,Showa,40,157603,73346,84257
12 ,Chiba,45_ 49,1965,Showa,40,132039,60326,71713
12 ,Chiba,50_ 54,1965,Showa,40,125000,57983,67017
12 ,Chiba,55_ 59,1965,Showa,40,106412,51746,54666
12 ,Chiba,60_ 64,1965,Showa,40,91588,44699,46889
12 ,Chiba,65_ 69,1965,Showa,40,71261,33744,37517
12 ,Chiba,70_ 74,1965,Showa,40,47465,20969,26496
12 ,Chiba,75_ 79,1965,Showa,40,31626,12394,19232
12 ,Chiba,80_ 84,1965,Showa,40,14351,4680,9671
12 ,Chiba,over_85,1965,Showa,40,7019,1815,5204
12 ,Chiba,total,1970,Showa,45,3366624,1694854,1671770
12 ,Chiba,0_ 4,1970,Showa,45,329808,168831,160977
12 ,Chiba,5_ 9,1970,Showa,45,279083,142870,136213
12 ,Chiba,10_ 14,1970,Showa,45,236725,120396,116329
12 ,Chiba,15_ 19,1970,Showa,45,269600,140590,129010
12 ,Chiba,20_ 24,1970,Showa,45,342439,181139,161300
12 ,Chiba,25_ 29,1970,Showa,45,330914,164059,166855
12 ,Chiba,30_ 34,1970,Showa,45,314118,162974,151144
12 ,Chiba,35_ 39,1970,Showa,45,282027,150220,131807
12 ,Chiba,40_ 44,1970,Showa,45,225472,118264,107208
12 ,Chiba,45_ 49,1970,Showa,45,171629,80530,91099
12 ,Chiba,50_ 54,1970,Showa,45,140284,64102,76182
12 ,Chiba,55_ 59,1970,Showa,45,127867,59540,68327
12 ,Chiba,60_ 64,1970,Showa,45,105718,50259,55459
12 ,Chiba,65_ 69,1970,Showa,45,86043,40400,45643
12 ,Chiba,70_ 74,1970,Showa,45,62379,27582,34797
12 ,Chiba,75_ 79,1970,Showa,45,35442,14382,21060
12 ,Chiba,80_ 84,1970,Showa,45,19080,6608,12472
12 ,Chiba,over_85,1970,Showa,45,7996,2108,5888
12 ,Chiba,total,1975,Showa,50,4149147,2095295,2053852
12 ,Chiba,0_ 4,1975,Showa,50,425792,219036,206756
12 ,Chiba,5_ 9,1975,Showa,50,370580,190237,180343
12 ,Chiba,10_ 14,1975,Showa,50,303218,155719,147499
12 ,Chiba,15_ 19,1975,Showa,50,265645,139025,126620
12 ,Chiba,20_ 24,1975,Showa,50,327267,175368,151899
12 ,Chiba,25_ 29,1975,Showa,50,429873,215263,214610
12 ,Chiba,30_ 34,1975,Showa,50,404783,204370,200413
12 ,Chiba,35_ 39,1975,Showa,50,353132,185225,167907
12 ,Chiba,40_ 44,1975,Showa,50,305367,162185,143182
12 ,Chiba,45_ 49,1975,Showa,50,243049,125797,117252
12 ,Chiba,50_ 54,1975,Showa,50,179746,83773,95973
12 ,Chiba,55_ 59,1975,Showa,50,144965,65607,79358
12 ,Chiba,60_ 64,1975,Showa,50,131574,59483,72091
12 ,Chiba,65_ 69,1975,Showa,50,101612,46533,55079
12 ,Chiba,70_ 74,1975,Showa,50,76509,33990,42519
12 ,Chiba,75_ 79,1975,Showa,50,48810,20065,28745
12 ,Chiba,80_ 84,1975,Showa,50,22973,8384,14589
12 ,Chiba,over_85,1975,Showa,50,11301,3294,8007
12 ,Chiba,total,1980,Showa,55,4735424,2383157,2352267
12 ,Chiba,0_ 4,1980,Showa,55,374804,191960,182844
12 ,Chiba,5_ 9,1980,Showa,55,459737,236223,223514
12 ,Chiba,10_ 14,1980,Showa,55,390373,200240,190133
12 ,Chiba,15_ 19,1980,Showa,55,321435,167020,154415
12 ,Chiba,20_ 24,1980,Showa,55,296937,157528,139409
12 ,Chiba,25_ 29,1980,Showa,55,373636,187665,185971
12 ,Chiba,30_ 34,1980,Showa,55,487054,243308,243746
12 ,Chiba,35_ 39,1980,Showa,55,438822,223149,215673
12 ,Chiba,40_ 44,1980,Showa,55,368912,193772,175140
12 ,Chiba,45_ 49,1980,Showa,55,313314,165058,148256
12 ,Chiba,50_ 54,1980,Showa,55,248566,127318,121248
12 ,Chiba,55_ 59,1980,Showa,55,182613,83886,98727
12 ,Chiba,60_ 64,1980,Showa,55,144811,64063,80748
12 ,Chiba,65_ 69,1980,Showa,55,126682,55414,71268
12 ,Chiba,70_ 74,1980,Showa,55,92458,40429,52029
12 ,Chiba,75_ 79,1980,Showa,55,62443,25964,36479
12 ,Chiba,80_ 84,1980,Showa,55,33372,12488,20884
12 ,Chiba,over_85,1980,Showa,55,15233,4722,10511
12 ,Chiba,total,1985,Showa,60,5148163,2588365,2559798
12 ,Chiba,0_ 4,1985,Showa,60,327127,167868,159259
12 ,Chiba,5_ 9,1985,Showa,60,390469,200135,190334
12 ,Chiba,10_ 14,1985,Showa,60,474218,243768,230450
12 ,Chiba,15_ 19,1985,Showa,60,404390,209072,195318
12 ,Chiba,20_ 24,1985,Showa,60,340879,180059,160820
12 ,Chiba,25_ 29,1985,Showa,60,324185,167198,156987
12 ,Chiba,30_ 34,1985,Showa,60,401393,201114,200279
12 ,Chiba,35_ 39,1985,Showa,60,508537,254894,253643
12 ,Chiba,40_ 44,1985,Showa,60,449356,228412,220944
12 ,Chiba,45_ 49,1985,Showa,60,373318,195149,178169
12 ,Chiba,50_ 54,1985,Showa,60,314979,164812,150167
12 ,Chiba,55_ 59,1985,Showa,60,248354,125575,122779
12 ,Chiba,60_ 64,1985,Showa,60,182068,81861,100207
12 ,Chiba,65_ 69,1985,Showa,60,141050,60661,80389
12 ,Chiba,70_ 74,1985,Showa,60,118219,49564,68655
12 ,Chiba,75_ 79,1985,Showa,60,78846,32200,46646
12 ,Chiba,80_ 84,1985,Showa,60,45125,17110,28015
12 ,Chiba,over_85,1985,Showa,60,23855,7629,16226
12 ,Chiba,total,1990,Heisei,2,5555429,2802774,2752655
12 ,Chiba,0_ 4,1990,Heisei,2,288065,147604,140461
12 ,Chiba,5_ 9,1990,Heisei,2,343921,176386,167535
12 ,Chiba,10_ 14,1990,Heisei,2,402322,206468,195854
12 ,Chiba,15_ 19,1990,Heisei,2,491690,255367,236323
12 ,Chiba,20_ 24,1990,Heisei,2,435223,229888,205335
12 ,Chiba,25_ 29,1990,Heisei,2,375898,197525,178373
12 ,Chiba,30_ 34,1990,Heisei,2,352642,181211,171431
12 ,Chiba,35_ 39,1990,Heisei,2,421772,212543,209229
12 ,Chiba,40_ 44,1990,Heisei,2,522819,262867,259952
12 ,Chiba,45_ 49,1990,Heisei,2,455399,231402,223997
12 ,Chiba,50_ 54,1990,Heisei,2,376336,196105,180231
12 ,Chiba,55_ 59,1990,Heisei,2,315268,163375,151893
12 ,Chiba,60_ 64,1990,Heisei,2,247198,122985,124213
12 ,Chiba,65_ 69,1990,Heisei,2,177078,77629,99449
12 ,Chiba,70_ 74,1990,Heisei,2,132596,54639,77957
12 ,Chiba,75_ 79,1990,Heisei,2,103889,40845,63044
12 ,Chiba,80_ 84,1990,Heisei,2,60085,22235,37850
12 ,Chiba,over_85,1990,Heisei,2,36189,11497,24692
12 ,Chiba,total,1995,Heisei,7,5797782,2923839,2873943
12 ,Chiba,0_ 4,1995,Heisei,7,272587,139619,132968
12 ,Chiba,5_ 9,1995,Heisei,7,294468,150687,143781
12 ,Chiba,10_ 14,1995,Heisei,7,348664,178933,169731
12 ,Chiba,15_ 19,1995,Heisei,7,414124,215290,198834
12 ,Chiba,20_ 24,1995,Heisei,7,511784,269300,242484
12 ,Chiba,25_ 29,1995,Heisei,7,453212,238606,214606
12 ,Chiba,30_ 34,1995,Heisei,7,394499,206537,187962
12 ,Chiba,35_ 39,1995,Heisei,7,363074,187036,176038
12 ,Chiba,40_ 44,1995,Heisei,7,427556,215657,211899
12 ,Chiba,45_ 49,1995,Heisei,7,525661,263945,261716
12 ,Chiba,50_ 54,1995,Heisei,7,454171,230279,223892
12 ,Chiba,55_ 59,1995,Heisei,7,373408,193484,179924
12 ,Chiba,60_ 64,1995,Heisei,7,307249,156669,150580
12 ,Chiba,65_ 69,1995,Heisei,7,236575,114526,122049
12 ,Chiba,70_ 74,1995,Heisei,7,165337,69626,95711
12 ,Chiba,75_ 79,1995,Heisei,7,116482,44818,71664
12 ,Chiba,80_ 84,1995,Heisei,7,81139,28831,52308
12 ,Chiba,over_85,1995,Heisei,7,52256,15972,36284
12 ,Chiba,total,2000,Heisei,12,5926285,2976984,2949301
12 ,Chiba,0_ 4,2000,Heisei,12,273064,139521,133543
12 ,Chiba,5_ 9,2000,Heisei,12,273918,140246,133672
12 ,Chiba,10_ 14,2000,Heisei,12,295552,151057,144495
12 ,Chiba,15_ 19,2000,Heisei,12,354973,184110,170863
12 ,Chiba,20_ 24,2000,Heisei,12,420352,221407,198945
12 ,Chiba,25_ 29,2000,Heisei,12,501533,261121,240412
12 ,Chiba,30_ 34,2000,Heisei,12,450073,234453,215620
12 ,Chiba,35_ 39,2000,Heisei,12,393596,204309,189287
12 ,Chiba,40_ 44,2000,Heisei,12,363312,185945,177367
12 ,Chiba,45_ 49,2000,Heisei,12,424466,212908,211558
12 ,Chiba,50_ 54,2000,Heisei,12,516574,257476,259098
12 ,Chiba,55_ 59,2000,Heisei,12,445801,223970,221831
12 ,Chiba,60_ 64,2000,Heisei,12,365245,186656,178589
12 ,Chiba,65_ 69,2000,Heisei,12,294695,146996,147699
12 ,Chiba,70_ 74,2000,Heisei,12,221409,104044,117365
12 ,Chiba,75_ 79,2000,Heisei,12,148075,59242,88833
12 ,Chiba,80_ 84,2000,Heisei,12,94123,33177,60946
12 ,Chiba,over_85,2000,Heisei,12,78715,23303,55412
12 ,Chiba,total,2005,Heisei,17,6056462,3029486,3026976
12 ,Chiba,0_ 4,2005,Heisei,17,265409,135747,129662
12 ,Chiba,5_ 9,2005,Heisei,17,277895,142166,135729
12 ,Chiba,10_ 14,2005,Heisei,17,276044,141187,134857
12 ,Chiba,15_ 19,2005,Heisei,17,304011,157063,146948
12 ,Chiba,20_ 24,2005,Heisei,17,365057,191520,173537
12 ,Chiba,25_ 29,2005,Heisei,17,410555,212191,198364
12 ,Chiba,30_ 34,2005,Heisei,17,500461,258057,242404
12 ,Chiba,35_ 39,2005,Heisei,17,450531,233101,217430
12 ,Chiba,40_ 44,2005,Heisei,17,393365,203224,190141
12 ,Chiba,45_ 49,2005,Heisei,17,360682,183559,177123
12 ,Chiba,50_ 54,2005,Heisei,17,420321,209960,210361
12 ,Chiba,55_ 59,2005,Heisei,17,510283,252990,257293
12 ,Chiba,60_ 64,2005,Heisei,17,439334,218759,220575
12 ,Chiba,65_ 69,2005,Heisei,17,354066,178093,175973
12 ,Chiba,70_ 74,2005,Heisei,17,277620,134416,143204
12 ,Chiba,75_ 79,2005,Heisei,17,198987,88228,110759
12 ,Chiba,80_ 84,2005,Heisei,17,123457,45194,78263
12 ,Chiba,over_85,2005,Heisei,17,106213,30023,76190
12 ,Chiba,total,2010,Heisei,22,6216289,3098139,3118150
12 ,Chiba,0_ 4,2010,Heisei,22,255768,130950,124818
12 ,Chiba,5_ 9,2010,Heisei,22,267835,137258,130577
12 ,Chiba,10_ 14,2010,Heisei,22,276043,141375,134668
12 ,Chiba,15_ 19,2010,Heisei,22,283408,147033,136375
12 ,Chiba,20_ 24,2010,Heisei,22,316050,164122,151928
12 ,Chiba,25_ 29,2010,Heisei,22,361007,184691,176316
12 ,Chiba,30_ 34,2010,Heisei,22,416659,213244,203415
12 ,Chiba,35_ 39,2010,Heisei,22,507333,260835,246498
12 ,Chiba,40_ 44,2010,Heisei,22,452196,233304,218892
12 ,Chiba,45_ 49,2010,Heisei,22,391528,201561,189967
12 ,Chiba,50_ 54,2010,Heisei,22,358323,181251,177072
12 ,Chiba,55_ 59,2010,Heisei,22,417238,206997,210241
12 ,Chiba,60_ 64,2010,Heisei,22,505318,247847,257471
12 ,Chiba,65_ 69,2010,Heisei,22,429359,210472,218887
12 ,Chiba,70_ 74,2010,Heisei,22,336501,164985,171516
12 ,Chiba,75_ 79,2010,Heisei,22,251434,116127,135307
12 ,Chiba,80_ 84,2010,Heisei,22,165603,67020,98583
12 ,Chiba,over_85,2010,Heisei,22,137223,38456,98767
12 ,Chiba,total,2015,Heisei,27,6222666,3095860,3126806
12 ,Chiba,0_ 4,2015,Heisei,27,234739,120478,114261
12 ,Chiba,5_ 9,2015,Heisei,27,256207,131373,124834
12 ,Chiba,10_ 14,2015,Heisei,27,271166,138915,132251
12 ,Chiba,15_ 19,2015,Heisei,27,289116,149516,139600
12 ,Chiba,20_ 24,2015,Heisei,27,298538,155350,143188
12 ,Chiba,25_ 29,2015,Heisei,27,312386,160084,152302
12 ,Chiba,30_ 34,2015,Heisei,27,360240,184179,176061
12 ,Chiba,35_ 39,2015,Heisei,27,415886,212736,203150
12 ,Chiba,40_ 44,2015,Heisei,27,506031,260051,245980
12 ,Chiba,45_ 49,2015,Heisei,27,449920,231937,217983
12 ,Chiba,50_ 54,2015,Heisei,27,388229,199047,189182
12 ,Chiba,55_ 59,2015,Heisei,27,352575,177419,175156
12 ,Chiba,60_ 64,2015,Heisei,27,406891,200444,206447
12 ,Chiba,65_ 69,2015,Heisei,27,486671,235993,250678
12 ,Chiba,70_ 74,2015,Heisei,27,401929,192768,209161
12 ,Chiba,75_ 79,2015,Heisei,27,302271,142522,159749
12 ,Chiba,80_ 84,2015,Heisei,27,209585,89944,119641
12 ,Chiba,over_85,2015,Heisei,27,183963,57085,126878
13 ,Tokyo,total,1920,Taisho,9,3699428,1952989,1746439
13 ,Tokyo,0_ 4,1920,Taisho,9,430438,216739,213699
13 ,Tokyo,5_ 9,1920,Taisho,9,376151,190545,185606
13 ,Tokyo,10_ 14,1920,Taisho,9,360901,190834,170067
13 ,Tokyo,15_ 19,1920,Taisho,9,445500,250628,194872
13 ,Tokyo,20_ 24,1920,Taisho,9,419231,232574,186657
13 ,Tokyo,25_ 29,1920,Taisho,9,339254,184598,154656
13 ,Tokyo,30_ 34,1920,Taisho,9,292292,157664,134628
13 ,Tokyo,35_ 39,1920,Taisho,9,245953,130536,115417
13 ,Tokyo,40_ 44,1920,Taisho,9,212729,113803,98926
13 ,Tokyo,45_ 49,1920,Taisho,9,154983,82707,72276
13 ,Tokyo,50_ 54,1920,Taisho,9,125606,65251,60355
13 ,Tokyo,55_ 59,1920,Taisho,9,98477,49784,48693
13 ,Tokyo,60_ 64,1920,Taisho,9,80349,38819,41530
13 ,Tokyo,65_ 69,1920,Taisho,9,58274,25986,32288
13 ,Tokyo,70_ 74,1920,Taisho,9,34313,13967,20346
13 ,Tokyo,75_ 79,1920,Taisho,9,16929,6015,10914
13 ,Tokyo,over_80,1920,Taisho,9,8048,2539,5509
13 ,Tokyo,total,1925,Taisho,14,4485144,2387609,2097535
13 ,Tokyo,0_ 4,1925,Taisho,14,567026,285002,282024
13 ,Tokyo,5_ 9,1925,Taisho,14,411849,207769,204080
13 ,Tokyo,10_ 14,1925,Taisho,14,437135,228112,209023
13 ,Tokyo,15_ 19,1925,Taisho,14,555177,311334,243843
13 ,Tokyo,20_ 24,1925,Taisho,14,546822,306818,240004
13 ,Tokyo,25_ 29,1925,Taisho,14,437937,241959,195978
13 ,Tokyo,30_ 34,1925,Taisho,14,341137,188862,152275
13 ,Tokyo,35_ 39,1925,Taisho,14,291572,160661,130911
13 ,Tokyo,40_ 44,1925,Taisho,14,238205,128601,109604
13 ,Tokyo,45_ 49,1925,Taisho,14,202830,108785,94045
13 ,Tokyo,50_ 54,1925,Taisho,14,142943,75318,67625
13 ,Tokyo,55_ 59,1925,Taisho,14,110234,55389,54845
13 ,Tokyo,60_ 64,1925,Taisho,14,80029,38294,41735
13 ,Tokyo,65_ 69,1925,Taisho,14,57935,26076,31859
13 ,Tokyo,70_ 74,1925,Taisho,14,37334,15374,21960
13 ,Tokyo,75_ 79,1925,Taisho,14,18146,6633,11513
13 ,Tokyo,80_ 84,1925,Taisho,14,6858,2083,4775
13 ,Tokyo,over_85,1925,Taisho,14,1975,539,1436
13 ,Tokyo,total,1930,Showa,5,5408678,2855323,2553355
13 ,Tokyo,0_ 4,1930,Showa,5,705182,356655,348527
13 ,Tokyo,5_ 9,1930,Showa,5,539880,271773,268107
13 ,Tokyo,10_ 14,1930,Showa,5,473432,245775,227657
13 ,Tokyo,15_ 19,1930,Showa,5,682415,374802,307613
13 ,Tokyo,20_ 24,1930,Showa,5,649194,357947,291247
13 ,Tokyo,25_ 29,1930,Showa,5,539291,293269,246022
13 ,Tokyo,30_ 34,1930,Showa,5,424366,232720,191646
13 ,Tokyo,35_ 39,1930,Showa,5,330628,182064,148564
13 ,Tokyo,40_ 44,1930,Showa,5,279856,153057,126799
13 ,Tokyo,45_ 49,1930,Showa,5,227066,120218,106848
13 ,Tokyo,50_ 54,1930,Showa,5,190982,99021,91961
13 ,Tokyo,55_ 59,1930,Showa,5,131262,66013,65249
13 ,Tokyo,60_ 64,1930,Showa,5,96218,45113,51105
13 ,Tokyo,65_ 69,1930,Showa,5,64286,28605,35681
13 ,Tokyo,70_ 74,1930,Showa,5,41251,16791,24460
13 ,Tokyo,75_ 79,1930,Showa,5,22148,8109,14039
13 ,Tokyo,over_80,1930,Showa,5,11221,3391,7830
13 ,Tokyo,total,1935,Showa,10,6369919,3325696,3044223
13 ,Tokyo,0_ 4,1935,Showa,10,781352,396651,384701
13 ,Tokyo,5_ 9,1935,Showa,10,661833,334874,326959
13 ,Tokyo,10_ 14,1935,Showa,10,608648,314515,294133
13 ,Tokyo,15_ 19,1935,Showa,10,777682,424876,352806
13 ,Tokyo,20_ 24,1935,Showa,10,776644,412556,364088
13 ,Tokyo,25_ 29,1935,Showa,10,613712,324052,289660
13 ,Tokyo,30_ 34,1935,Showa,10,506016,270869,235147
13 ,Tokyo,35_ 39,1935,Showa,10,401735,218458,183277
13 ,Tokyo,40_ 44,1935,Showa,10,311790,170073,141717
13 ,Tokyo,45_ 49,1935,Showa,10,265056,142150,122906
13 ,Tokyo,50_ 54,1935,Showa,10,212556,109320,103236
13 ,Tokyo,55_ 59,1935,Showa,10,174581,86639,87942
13 ,Tokyo,60_ 64,1935,Showa,10,114716,54375,60341
13 ,Tokyo,65_ 69,1935,Showa,10,78050,33925,44125
13 ,Tokyo,70_ 74,1935,Showa,10,46792,19061,27731
13 ,Tokyo,75_ 79,1935,Showa,10,24674,8972,15702
13 ,Tokyo,over_80,1935,Showa,10,14082,4330,9752
13 ,Tokyo,total,1940,Showa,15,7346983,3790831,3556152
13 ,Tokyo,0_ 4,1940,Showa,15,843200,427395,415805
13 ,Tokyo,5_ 9,1940,Showa,15,746468,378596,367872
13 ,Tokyo,10_ 14,1940,Showa,15,725203,374117,351086
13 ,Tokyo,15_ 19,1940,Showa,15,963479,531904,431575
13 ,Tokyo,20_ 24,1940,Showa,15,789458,391370,398088
13 ,Tokyo,25_ 29,1940,Showa,15,726366,372221,354145
13 ,Tokyo,30_ 34,1940,Showa,15,588173,307048,281125
13 ,Tokyo,35_ 39,1940,Showa,15,489243,260947,228296
13 ,Tokyo,40_ 44,1940,Showa,15,386066,208570,177496
13 ,Tokyo,45_ 49,1940,Showa,15,299514,161354,138160
13 ,Tokyo,50_ 54,1940,Showa,15,250083,131452,118631
13 ,Tokyo,55_ 59,1940,Showa,15,194737,96700,98037
13 ,Tokyo,60_ 64,1940,Showa,15,152213,71216,80997
13 ,Tokyo,65_ 69,1940,Showa,15,93437,40935,52502
13 ,Tokyo,70_ 74,1940,Showa,15,56000,22152,33848
13 ,Tokyo,75_ 79,1940,Showa,15,27854,10111,17743
13 ,Tokyo,80_ 84,1940,Showa,15,11036,3523,7513
13 ,Tokyo,over_85,1940,Showa,15,4277,1129,3148
13 ,Tokyo,total,1945,Showa,20,3488284,1788145,1700139
13 ,Tokyo,1_ 5,1945,Showa,20,365375,184786,180589
13 ,Tokyo,6_ 10,1945,Showa,20,296109,149974,146135
13 ,Tokyo,11_ 15,1945,Showa,20,336277,174207,162070
13 ,Tokyo,16_ 20,1945,Showa,20,430242,235292,194950
13 ,Tokyo,21_ 25,1945,Showa,20,333660,151015,182645
13 ,Tokyo,26_ 30,1945,Showa,20,257136,114844,142292
13 ,Tokyo,31_ 35,1945,Showa,20,254982,127299,127683
13 ,Tokyo,36_ 40,1945,Showa,20,249083,131902,117181
13 ,Tokyo,41_ 45,1945,Showa,20,251817,138756,113061
13 ,Tokyo,46_ 50,1945,Showa,20,215610,119956,95654
13 ,Tokyo,51_ 55,1945,Showa,20,166226,93251,72975
13 ,Tokyo,56_ 60,1945,Showa,20,130741,72341,58400
13 ,Tokyo,61_ 65,1945,Showa,20,88104,45490,42614
13 ,Tokyo,66_ 70,1945,Showa,20,59593,27963,31630
13 ,Tokyo,71_ 75,1945,Showa,20,31308,13260,18048
13 ,Tokyo,76_ 80,1945,Showa,20,14605,5423,9182
13 ,Tokyo,81_ 85,1945,Showa,20,5712,1873,3839
13 ,Tokyo,86以上,1945,Showa,20,1704,513,1191
13 ,Tokyo,total,1950,Showa,25,6277500,3169389,3108111
13 ,Tokyo,0_ 4,1950,Showa,25,780018,398853,381165
13 ,Tokyo,5_ 9,1950,Showa,25,671135,340399,330736
13 ,Tokyo,10_ 14,1950,Showa,25,536825,271264,265561
13 ,Tokyo,15_ 19,1950,Showa,25,650609,342311,308298
13 ,Tokyo,20_ 24,1950,Showa,25,693511,370569,322942
13 ,Tokyo,25_ 29,1950,Showa,25,567040,268886,298154
13 ,Tokyo,30_ 34,1950,Showa,25,465302,218219,247083
13 ,Tokyo,35_ 39,1950,Showa,25,432430,214682,217748
13 ,Tokyo,40_ 44,1950,Showa,25,365801,186507,179294
13 ,Tokyo,45_ 49,1950,Showa,25,320907,167314,153593
13 ,Tokyo,50_ 54,1950,Showa,25,255876,135155,120721
13 ,Tokyo,55_ 59,1950,Showa,25,193039,100807,92232
13 ,Tokyo,60_ 64,1950,Showa,25,146358,72815,73543
13 ,Tokyo,65_ 69,1950,Showa,25,96322,43140,53182
13 ,Tokyo,70_ 74,1950,Showa,25,60724,24276,36448
13 ,Tokyo,75_ 79,1950,Showa,25,27850,9952,17898
13 ,Tokyo,over_80,1950,Showa,25,13165,3876,9289
13 ,Tokyo,total,1955,Showa,30,8037084,4115823,3921261
13 ,Tokyo,0_ 4,1955,Showa,30,661660,339133,322527
13 ,Tokyo,5_ 9,1955,Showa,30,849145,434328,414817
13 ,Tokyo,10_ 14,1955,Showa,30,751006,381037,369969
13 ,Tokyo,15_ 19,1955,Showa,30,895911,498762,397149
13 ,Tokyo,20_ 24,1955,Showa,30,1018839,577955,440884
13 ,Tokyo,25_ 29,1955,Showa,30,820366,419028,401338
13 ,Tokyo,30_ 34,1955,Showa,30,624996,291824,333172
13 ,Tokyo,35_ 39,1955,Showa,30,502660,233036,269624
13 ,Tokyo,40_ 44,1955,Showa,30,464658,227678,236980
13 ,Tokyo,45_ 49,1955,Showa,30,389130,196077,193053
13 ,Tokyo,50_ 54,1955,Showa,30,332599,170687,161912
13 ,Tokyo,55_ 59,1955,Showa,30,258498,133100,125398
13 ,Tokyo,60_ 64,1955,Showa,30,186106,93468,92638
13 ,Tokyo,65_ 69,1955,Showa,30,133902,63124,70778
13 ,Tokyo,70_ 74,1955,Showa,30,81333,33715,47618
13 ,Tokyo,75_ 79,1955,Showa,30,44562,16264,28298
13 ,Tokyo,80_ 84,1955,Showa,30,16350,5185,11165
13 ,Tokyo,over_85,1955,Showa,30,5215,1323,3892
13 ,Tokyo,total,1960,Showa,35,9683802,4997023,4686779
13 ,Tokyo,0_ 4,1960,Showa,35,693719,356324,337395
13 ,Tokyo,5_ 9,1960,Showa,35,674170,345611,328559
13 ,Tokyo,10_ 14,1960,Showa,35,881163,450954,430209
13 ,Tokyo,15_ 19,1960,Showa,35,1250356,698545,551811
13 ,Tokyo,20_ 24,1960,Showa,35,1308146,744750,563396
13 ,Tokyo,25_ 29,1960,Showa,35,1098234,582625,515609
13 ,Tokyo,30_ 34,1960,Showa,35,840120,422476,417644
13 ,Tokyo,35_ 39,1960,Showa,35,634272,294526,339746
13 ,Tokyo,40_ 44,1960,Showa,35,508584,234036,274548
13 ,Tokyo,45_ 49,1960,Showa,35,470924,228571,242353
13 ,Tokyo,50_ 54,1960,Showa,35,388826,193444,195382
13 ,Tokyo,55_ 59,1960,Showa,35,325046,163892,161154
13 ,Tokyo,60_ 64,1960,Showa,35,242579,120807,121772
13 ,Tokyo,65_ 69,1960,Showa,35,165295,79418,85877
13 ,Tokyo,70_ 74,1960,Showa,35,109725,48415,61310
13 ,Tokyo,75_ 79,1960,Showa,35,58606,22130,36476
13 ,Tokyo,80_ 84,1960,Showa,35,25465,8104,17361
13 ,Tokyo,over_85,1960,Showa,35,8572,2395,6177
13 ,Tokyo,total,1965,Showa,40,10869244,5564583,5304661
13 ,Tokyo,0_ 4,1965,Showa,40,876263,447828,428435
13 ,Tokyo,5_ 9,1965,Showa,40,664708,339634,325074
13 ,Tokyo,10_ 14,1965,Showa,40,675974,345328,330646
13 ,Tokyo,15_ 19,1965,Showa,40,1298174,693715,604459
13 ,Tokyo,20_ 24,1965,Showa,40,1579890,878344,701546
13 ,Tokyo,25_ 29,1965,Showa,40,1243711,660867,582844
13 ,Tokyo,30_ 34,1965,Showa,40,1017041,524421,492620
13 ,Tokyo,35_ 39,1965,Showa,40,805517,400831,404686
13 ,Tokyo,40_ 44,1965,Showa,40,618431,286164,332267
13 ,Tokyo,45_ 49,1965,Showa,40,497946,228558,269388
13 ,Tokyo,50_ 54,1965,Showa,40,455787,220800,234987
13 ,Tokyo,55_ 59,1965,Showa,40,370464,182302,188162
13 ,Tokyo,60_ 64,1965,Showa,40,296375,146211,150164
13 ,Tokyo,65_ 69,1965,Showa,40,210755,101891,108864
13 ,Tokyo,70_ 74,1965,Showa,40,132716,60393,72323
13 ,Tokyo,75_ 79,1965,Showa,40,78077,31921,46156
13 ,Tokyo,80_ 84,1965,Showa,40,33441,11544,21897
13 ,Tokyo,over_85,1965,Showa,40,13974,3831,10143
13 ,Tokyo,total,1970,Showa,45,11408071,5801009,5607062
13 ,Tokyo,0_ 4,1970,Showa,45,971687,498250,473437
13 ,Tokyo,5_ 9,1970,Showa,45,791874,405701,386173
13 ,Tokyo,10_ 14,1970,Showa,45,637069,326382,310687
13 ,Tokyo,15_ 19,1970,Showa,45,963755,506894,456861
13 ,Tokyo,20_ 24,1970,Showa,45,1675115,922542,752573
13 ,Tokyo,25_ 29,1970,Showa,45,1290878,683751,607127
13 ,Tokyo,30_ 34,1970,Showa,45,1031700,526138,505562
13 ,Tokyo,35_ 39,1970,Showa,45,910696,459134,451562
13 ,Tokyo,40_ 44,1970,Showa,45,744424,367273,377151
13 ,Tokyo,45_ 49,1970,Showa,45,584319,268848,315471
13 ,Tokyo,50_ 54,1970,Showa,45,467280,213504,253776
13 ,Tokyo,55_ 59,1970,Showa,45,415597,197872,217725
13 ,Tokyo,60_ 64,1970,Showa,45,332866,159341,173525
13 ,Tokyo,65_ 69,1970,Showa,45,257119,122564,134555
13 ,Tokyo,70_ 74,1970,Showa,45,172110,78890,93220
13 ,Tokyo,75_ 79,1970,Showa,45,96219,40731,55488
13 ,Tokyo,80_ 84,1970,Showa,45,46374,17316,29058
13 ,Tokyo,over_85,1970,Showa,45,18989,5878,13111
13 ,Tokyo,total,1975,Showa,50,11673554,5913373,5760181
13 ,Tokyo,0_ 4,1975,Showa,50,964456,494161,470295
13 ,Tokyo,5_ 9,1975,Showa,50,856943,439780,417163
13 ,Tokyo,10_ 14,1975,Showa,50,743050,381516,361534
13 ,Tokyo,15_ 19,1975,Showa,50,824026,431843,392183
13 ,Tokyo,20_ 24,1975,Showa,50,1311354,727833,583521
13 ,Tokyo,25_ 29,1975,Showa,50,1338307,715564,622743
13 ,Tokyo,30_ 34,1975,Showa,50,1067346,546627,520719
13 ,Tokyo,35_ 39,1975,Showa,50,910793,454288,456505
13 ,Tokyo,40_ 44,1975,Showa,50,844180,420324,423856
13 ,Tokyo,45_ 49,1975,Showa,50,705845,345119,360726
13 ,Tokyo,50_ 54,1975,Showa,50,545313,249464,295849
13 ,Tokyo,55_ 59,1975,Showa,50,430028,192895,237133
13 ,Tokyo,60_ 64,1975,Showa,50,383027,178252,204775
13 ,Tokyo,65_ 69,1975,Showa,50,296987,137114,159873
13 ,Tokyo,70_ 74,1975,Showa,50,215274,97826,117448
13 ,Tokyo,75_ 79,1975,Showa,50,130692,55890,74802
13 ,Tokyo,80_ 84,1975,Showa,50,61035,23914,37121
13 ,Tokyo,over_85,1975,Showa,50,27820,9276,18544
13 ,Tokyo,total,1980,Showa,55,11618281,5856280,5762001
13 ,Tokyo,0_ 4,1980,Showa,55,715230,366318,348912
13 ,Tokyo,5_ 9,1980,Showa,55,865035,443461,421574
13 ,Tokyo,10_ 14,1980,Showa,55,813422,417319,396103
13 ,Tokyo,15_ 19,1980,Showa,55,876161,456826,419335
13 ,Tokyo,20_ 24,1980,Showa,55,1113290,616805,496485
13 ,Tokyo,25_ 29,1980,Showa,55,1010762,543382,467380
13 ,Tokyo,30_ 34,1980,Showa,55,1128129,587169,540960
13 ,Tokyo,35_ 39,1980,Showa,55,954985,478907,476078
13 ,Tokyo,40_ 44,1980,Showa,55,851939,418503,433436
13 ,Tokyo,45_ 49,1980,Showa,55,803528,396865,406663
13 ,Tokyo,50_ 54,1980,Showa,55,665798,323651,342147
13 ,Tokyo,55_ 59,1980,Showa,55,508454,229620,278834
13 ,Tokyo,60_ 64,1980,Showa,55,395517,174113,221404
13 ,Tokyo,65_ 69,1980,Showa,55,343812,155775,188037
13 ,Tokyo,70_ 74,1980,Showa,55,253787,112375,141412
13 ,Tokyo,75_ 79,1980,Showa,55,168857,72010,96847
13 ,Tokyo,80_ 84,1980,Showa,55,87975,34564,53411
13 ,Tokyo,over_85,1980,Showa,55,40530,13875,26655
13 ,Tokyo,total,1985,Showa,60,11829363,5955029,5874334
13 ,Tokyo,0_ 4,1985,Showa,60,620843,317664,303179
13 ,Tokyo,5_ 9,1985,Showa,60,666781,340759,326022
13 ,Tokyo,10_ 14,1985,Showa,60,837713,429744,407969
13 ,Tokyo,15_ 19,1985,Showa,60,934068,486528,447540
13 ,Tokyo,20_ 24,1985,Showa,60,1181783,651784,529999
13 ,Tokyo,25_ 29,1985,Showa,60,919931,493686,426245
13 ,Tokyo,30_ 34,1985,Showa,60,909087,480999,428088
13 ,Tokyo,35_ 39,1985,Showa,60,1052373,541672,510701
13 ,Tokyo,40_ 44,1985,Showa,60,920175,456616,463559
13 ,Tokyo,45_ 49,1985,Showa,60,833307,407708,425599
13 ,Tokyo,50_ 54,1985,Showa,60,778265,383221,395044
13 ,Tokyo,55_ 59,1985,Showa,60,632913,304900,328013
13 ,Tokyo,60_ 64,1985,Showa,60,476397,211901,264496
13 ,Tokyo,65_ 69,1985,Showa,60,362572,155608,206964
13 ,Tokyo,70_ 74,1985,Showa,60,302128,131305,170823
13 ,Tokyo,75_ 79,1985,Showa,60,207551,86161,121390
13 ,Tokyo,80_ 84,1985,Showa,60,119756,46661,73095
13 ,Tokyo,over_85,1985,Showa,60,63843,21619,42224
13 ,Tokyo,total,1990,Heisei,2,11855563,5969773,5885790
13 ,Tokyo,0_ 4,1990,Heisei,2,521605,267282,254323
13 ,Tokyo,5_ 9,1990,Heisei,2,565862,289336,276526
13 ,Tokyo,10_ 14,1990,Heisei,2,640012,326926,313086
13 ,Tokyo,15_ 19,1990,Heisei,2,948359,489587,458772
13 ,Tokyo,20_ 24,1990,Heisei,2,1195664,645946,549718
13 ,Tokyo,25_ 29,1990,Heisei,2,995391,534900,460491
13 ,Tokyo,30_ 34,1990,Heisei,2,804673,424361,380312
13 ,Tokyo,35_ 39,1990,Heisei,2,822279,428012,394267
13 ,Tokyo,40_ 44,1990,Heisei,2,1000011,509047,490964
13 ,Tokyo,45_ 49,1990,Heisei,2,893591,442741,450850
13 ,Tokyo,50_ 54,1990,Heisei,2,804082,393817,410265
13 ,Tokyo,55_ 59,1990,Heisei,2,737990,362109,375881
13 ,Tokyo,60_ 64,1990,Heisei,2,588485,280517,307968
13 ,Tokyo,65_ 69,1990,Heisei,2,433985,188610,245375
13 ,Tokyo,70_ 74,1990,Heisei,2,318591,131729,186862
13 ,Tokyo,75_ 79,1990,Heisei,2,249195,102415,146780
13 ,Tokyo,80_ 84,1990,Heisei,2,149186,56539,92647
13 ,Tokyo,over_85,1990,Heisei,2,93069,30704,62365
13 ,Tokyo,total,1995,Heisei,7,11773605,5892704,5880901
13 ,Tokyo,0_ 4,1995,Heisei,7,467748,239666,228082
13 ,Tokyo,5_ 9,1995,Heisei,7,485921,248105,237816
13 ,Tokyo,10_ 14,1995,Heisei,7,545457,278974,266483
13 ,Tokyo,15_ 19,1995,Heisei,7,731600,375083,356517
13 ,Tokyo,20_ 24,1995,Heisei,7,1169793,615266,554527
13 ,Tokyo,25_ 29,1995,Heisei,7,1056719,557726,498993
13 ,Tokyo,30_ 34,1995,Heisei,7,895053,473711,421342
13 ,Tokyo,35_ 39,1995,Heisei,7,740683,385701,354982
13 ,Tokyo,40_ 44,1995,Heisei,7,784977,404490,380487
13 ,Tokyo,45_ 49,1995,Heisei,7,979147,496770,482377
13 ,Tokyo,50_ 54,1995,Heisei,7,870796,432225,438571
13 ,Tokyo,55_ 59,1995,Heisei,7,777126,380874,396252
13 ,Tokyo,60_ 64,1995,Heisei,7,699205,339610,359595
13 ,Tokyo,65_ 69,1995,Heisei,7,550743,257717,293026
13 ,Tokyo,70_ 74,1995,Heisei,7,391228,163639,227589
13 ,Tokyo,75_ 79,1995,Heisei,7,270421,105270,165151
13 ,Tokyo,80_ 84,1995,Heisei,7,187813,70207,117606
13 ,Tokyo,over_85,1995,Heisei,7,130490,41332,89158
13 ,Tokyo,total,2000,Heisei,12,12064101,6028562,6035539
13 ,Tokyo,0_ 4,2000,Heisei,12,477014,244520,232494
13 ,Tokyo,5_ 9,2000,Heisei,12,462053,236370,225683
13 ,Tokyo,10_ 14,2000,Heisei,12,481852,246019,235833
13 ,Tokyo,15_ 19,2000,Heisei,12,640095,328620,311475
13 ,Tokyo,20_ 24,2000,Heisei,12,991457,523171,468286
13 ,Tokyo,25_ 29,2000,Heisei,12,1118725,580884,537841
13 ,Tokyo,30_ 34,2000,Heisei,12,1020691,532026,488665
13 ,Tokyo,35_ 39,2000,Heisei,12,877029,459840,417189
13 ,Tokyo,40_ 44,2000,Heisei,12,731320,377857,353463
13 ,Tokyo,45_ 49,2000,Heisei,12,773398,396696,376702
13 ,Tokyo,50_ 54,2000,Heisei,12,955871,483897,471974
13 ,Tokyo,55_ 59,2000,Heisei,12,839781,414340,425441
13 ,Tokyo,60_ 64,2000,Heisei,12,737511,355502,382009
13 ,Tokyo,65_ 69,2000,Heisei,12,654925,310740,344185
13 ,Tokyo,70_ 74,2000,Heisei,12,504291,228375,275916
13 ,Tokyo,75_ 79,2000,Heisei,12,349344,140984,208360
13 ,Tokyo,80_ 84,2000,Heisei,12,216801,79555,137246
13 ,Tokyo,over_85,2000,Heisei,12,185095,58645,126450
13 ,Tokyo,total,2005,Heisei,17,12576601,6264895,6311706
13 ,Tokyo,0_ 4,2005,Heisei,17,476692,243648,233044
13 ,Tokyo,5_ 9,2005,Heisei,17,481382,246639,234743
13 ,Tokyo,10_ 14,2005,Heisei,17,466593,238695,227898
13 ,Tokyo,15_ 19,2005,Heisei,17,562968,288446,274522
13 ,Tokyo,20_ 24,2005,Heisei,17,859742,449576,410166
13 ,Tokyo,25_ 29,2005,Heisei,17,981230,508302,472928
13 ,Tokyo,30_ 34,2005,Heisei,17,1121689,573146,548543
13 ,Tokyo,35_ 39,2005,Heisei,17,1026016,529690,496326
13 ,Tokyo,40_ 44,2005,Heisei,17,885146,460461,424685
13 ,Tokyo,45_ 49,2005,Heisei,17,736656,378960,357696
13 ,Tokyo,50_ 54,2005,Heisei,17,770054,393422,376632
13 ,Tokyo,55_ 59,2005,Heisei,17,938669,472951,465718
13 ,Tokyo,60_ 64,2005,Heisei,17,813422,396362,417060
13 ,Tokyo,65_ 69,2005,Heisei,17,705944,334449,371495
13 ,Tokyo,70_ 74,2005,Heisei,17,612400,281675,330725
13 ,Tokyo,75_ 79,2005,Heisei,17,451357,195032,256325
13 ,Tokyo,80_ 84,2005,Heisei,17,285738,107073,178665
13 ,Tokyo,over_85,2005,Heisei,17,240088,72786,167302
13 ,Tokyo,total,2010,Heisei,22,13159388,6512110,6647278
13 ,Tokyo,0_ 4,2010,Heisei,22,500269,256087,244182
13 ,Tokyo,5_ 9,2010,Heisei,22,484303,247825,236478
13 ,Tokyo,10_ 14,2010,Heisei,22,492799,251866,240933
13 ,Tokyo,15_ 19,2010,Heisei,22,546573,277669,268904
13 ,Tokyo,20_ 24,2010,Heisei,22,785911,402472,383439
13 ,Tokyo,25_ 29,2010,Heisei,22,949354,487772,461582
13 ,Tokyo,30_ 34,2010,Heisei,22,1038768,532686,506082
13 ,Tokyo,35_ 39,2010,Heisei,22,1164057,594971,569086
13 ,Tokyo,40_ 44,2010,Heisei,22,1053232,541168,512064
13 ,Tokyo,45_ 49,2010,Heisei,22,905561,467659,437902
13 ,Tokyo,50_ 54,2010,Heisei,22,740091,379997,360094
13 ,Tokyo,55_ 59,2010,Heisei,22,760764,387172,373592
13 ,Tokyo,60_ 64,2010,Heisei,22,905914,449665,456249
13 ,Tokyo,65_ 69,2010,Heisei,22,771396,364786,406610
13 ,Tokyo,70_ 74,2010,Heisei,22,654931,298675,356256
13 ,Tokyo,75_ 79,2010,Heisei,22,544554,236497,308057
13 ,Tokyo,80_ 84,2010,Heisei,22,366372,143057,223315
13 ,Tokyo,over_85,2010,Heisei,22,304978,88488,216490
13 ,Tokyo,total,2015,Heisei,27,13515271,6666690,6848581
13 ,Tokyo,0_ 4,2015,Heisei,27,524939,267601,257338
13 ,Tokyo,5_ 9,2015,Heisei,27,499632,255978,243654
13 ,Tokyo,10_ 14,2015,Heisei,27,493559,252438,241121
13 ,Tokyo,15_ 19,2015,Heisei,27,566729,289130,277599
13 ,Tokyo,20_ 24,2015,Heisei,27,753698,383164,370534
13 ,Tokyo,25_ 29,2015,Heisei,27,863678,436135,427543
13 ,Tokyo,30_ 34,2015,Heisei,27,969877,495240,474637
13 ,Tokyo,35_ 39,2015,Heisei,27,1038390,530043,508347
13 ,Tokyo,40_ 44,2015,Heisei,27,1154214,584654,569560
13 ,Tokyo,45_ 49,2015,Heisei,27,1048170,536680,511490
13 ,Tokyo,50_ 54,2015,Heisei,27,891332,459994,431338
13 ,Tokyo,55_ 59,2015,Heisei,27,722755,369325,353430
13 ,Tokyo,60_ 64,2015,Heisei,27,725312,364160,361152
13 ,Tokyo,65_ 69,2015,Heisei,27,854575,414853,439722
13 ,Tokyo,70_ 74,2015,Heisei,27,713342,327345,385997
13 ,Tokyo,75_ 79,2015,Heisei,27,583971,254158,329813
13 ,Tokyo,80_ 84,2015,Heisei,27,449314,180294,269020
13 ,Tokyo,over_85,2015,Heisei,27,404314,124599,279715
14 ,Kanagawa,total,1920,Taisho,9,1323390,689751,633639
14 ,Kanagawa,0_ 4,1920,Taisho,9,174546,87772,86774
14 ,Kanagawa,5_ 9,1920,Taisho,9,155280,78644,76636
14 ,Kanagawa,10_ 14,1920,Taisho,9,134173,67090,67083
14 ,Kanagawa,15_ 19,1920,Taisho,9,133087,71597,61490
14 ,Kanagawa,20_ 24,1920,Taisho,9,129679,72418,57261
14 ,Kanagawa,25_ 29,1920,Taisho,9,109329,60210,49119
14 ,Kanagawa,30_ 34,1920,Taisho,9,96585,52018,44567
14 ,Kanagawa,35_ 39,1920,Taisho,9,82367,43342,39025
14 ,Kanagawa,40_ 44,1920,Taisho,9,76068,40173,35895
14 ,Kanagawa,45_ 49,1920,Taisho,9,57311,30379,26932
14 ,Kanagawa,50_ 54,1920,Taisho,9,45996,23968,22028
14 ,Kanagawa,55_ 59,1920,Taisho,9,38678,19975,18703
14 ,Kanagawa,60_ 64,1920,Taisho,9,33405,16423,16982
14 ,Kanagawa,65_ 69,1920,Taisho,9,26020,12383,13637
14 ,Kanagawa,70_ 74,1920,Taisho,9,16751,7590,9161
14 ,Kanagawa,75_ 79,1920,Taisho,9,9311,3950,5361
14 ,Kanagawa,over_80,1920,Taisho,9,4804,1819,2985
14 ,Kanagawa,total,1925,Taisho,14,1416792,739699,677093
14 ,Kanagawa,0_ 4,1925,Taisho,14,197264,99143,98121
14 ,Kanagawa,5_ 9,1925,Taisho,14,157512,79135,78377
14 ,Kanagawa,10_ 14,1925,Taisho,14,151760,76626,75134
14 ,Kanagawa,15_ 19,1925,Taisho,14,134720,70389,64331
14 ,Kanagawa,20_ 24,1925,Taisho,14,140116,78522,61594
14 ,Kanagawa,25_ 29,1925,Taisho,14,123224,68223,55001
14 ,Kanagawa,30_ 34,1925,Taisho,14,99908,54687,45221
14 ,Kanagawa,35_ 39,1925,Taisho,14,89507,48917,40590
14 ,Kanagawa,40_ 44,1925,Taisho,14,75343,40018,35325
14 ,Kanagawa,45_ 49,1925,Taisho,14,69417,36554,32863
14 ,Kanagawa,50_ 54,1925,Taisho,14,50813,26592,24221
14 ,Kanagawa,55_ 59,1925,Taisho,14,39230,20049,19181
14 ,Kanagawa,60_ 64,1925,Taisho,14,31391,15676,15715
14 ,Kanagawa,65_ 69,1925,Taisho,14,24694,11498,13196
14 ,Kanagawa,70_ 74,1925,Taisho,14,17301,7824,9477
14 ,Kanagawa,75_ 79,1925,Taisho,14,9436,3927,5509
14 ,Kanagawa,80_ 84,1925,Taisho,14,3942,1519,2423
14 ,Kanagawa,over_85,1925,Taisho,14,1214,400,814
14 ,Kanagawa,total,1930,Showa,5,1619606,839309,780297
14 ,Kanagawa,0_ 4,1930,Showa,5,230450,116225,114225
14 ,Kanagawa,5_ 9,1930,Showa,5,189904,95347,94557
14 ,Kanagawa,10_ 14,1930,Showa,5,161074,81439,79635
14 ,Kanagawa,15_ 19,1930,Showa,5,161946,84937,77009
14 ,Kanagawa,20_ 24,1930,Showa,5,154522,85346,69176
14 ,Kanagawa,25_ 29,1930,Showa,5,139692,74458,65234
14 ,Kanagawa,30_ 34,1930,Showa,5,119167,64052,55115
14 ,Kanagawa,35_ 39,1930,Showa,5,97544,52957,44587
14 ,Kanagawa,40_ 44,1930,Showa,5,86389,46849,39540
14 ,Kanagawa,45_ 49,1930,Showa,5,71694,37314,34380
14 ,Kanagawa,50_ 54,1930,Showa,5,64750,33194,31556
14 ,Kanagawa,55_ 59,1930,Showa,5,46933,23632,23301
14 ,Kanagawa,60_ 64,1930,Showa,5,34823,16916,17907
14 ,Kanagawa,65_ 69,1930,Showa,5,25771,12165,13606
14 ,Kanagawa,70_ 74,1930,Showa,5,17982,7797,10185
14 ,Kanagawa,75_ 79,1930,Showa,5,10837,4482,6355
14 ,Kanagawa,over_80,1930,Showa,5,6128,2199,3929
14 ,Kanagawa,total,1935,Showa,10,1840005,951348,888657
14 ,Kanagawa,0_ 4,1935,Showa,10,245022,123900,121122
14 ,Kanagawa,5_ 9,1935,Showa,10,220409,111005,109404
14 ,Kanagawa,10_ 14,1935,Showa,10,192977,96647,96330
14 ,Kanagawa,15_ 19,1935,Showa,10,179697,93651,86046
14 ,Kanagawa,20_ 24,1935,Showa,10,188204,105075,83129
14 ,Kanagawa,25_ 29,1935,Showa,10,154682,81376,73306
14 ,Kanagawa,30_ 34,1935,Showa,10,136013,71699,64314
14 ,Kanagawa,35_ 39,1935,Showa,10,114513,61516,52997
14 ,Kanagawa,40_ 44,1935,Showa,10,93241,50562,42679
14 ,Kanagawa,45_ 49,1935,Showa,10,81833,43745,38088
14 ,Kanagawa,50_ 54,1935,Showa,10,66935,34100,32835
14 ,Kanagawa,55_ 59,1935,Showa,10,59476,29519,29957
14 ,Kanagawa,60_ 64,1935,Showa,10,41231,19983,21248
14 ,Kanagawa,65_ 69,1935,Showa,10,28445,13101,15344
14 ,Kanagawa,70_ 74,1935,Showa,10,18987,8410,10577
14 ,Kanagawa,75_ 79,1935,Showa,10,11178,4458,6720
14 ,Kanagawa,over_80,1935,Showa,10,7162,2601,4561
14 ,Kanagawa,total,1940,Showa,15,2183019,1134166,1048853
14 ,Kanagawa,0_ 4,1940,Showa,15,271694,137765,133929
14 ,Kanagawa,5_ 9,1940,Showa,15,245476,124105,121371
14 ,Kanagawa,10_ 14,1940,Showa,15,232789,119214,113575
14 ,Kanagawa,15_ 19,1940,Showa,15,242089,134052,108037
14 ,Kanagawa,20_ 24,1940,Showa,15,204753,105653,99100
14 ,Kanagawa,25_ 29,1940,Showa,15,207768,110572,97196
14 ,Kanagawa,30_ 34,1940,Showa,15,164604,88054,76550
14 ,Kanagawa,35_ 39,1940,Showa,15,139930,75191,64739
14 ,Kanagawa,40_ 44,1940,Showa,15,114038,61682,52356
14 ,Kanagawa,45_ 49,1940,Showa,15,90817,49011,41806
14 ,Kanagawa,50_ 54,1940,Showa,15,78244,40966,37278
14 ,Kanagawa,55_ 59,1940,Showa,15,62862,30876,31986
14 ,Kanagawa,60_ 64,1940,Showa,15,53302,25237,28065
14 ,Kanagawa,65_ 69,1940,Showa,15,34498,15628,18870
14 ,Kanagawa,70_ 74,1940,Showa,15,21001,8935,12066
14 ,Kanagawa,75_ 79,1940,Showa,15,11834,4761,7073
14 ,Kanagawa,80_ 84,1940,Showa,15,5128,1776,3352
14 ,Kanagawa,over_85,1940,Showa,15,2169,681,1488
14 ,Kanagawa,total,1945,Showa,20,1865667,922522,943145
14 ,Kanagawa,1_ 5,1945,Showa,20,227175,114942,112233
14 ,Kanagawa,6_ 10,1945,Showa,20,201187,102470,98717
14 ,Kanagawa,11_ 15,1945,Showa,20,205181,104919,100262
14 ,Kanagawa,16_ 20,1945,Showa,20,212052,113153,98899
14 ,Kanagawa,21_ 25,1945,Showa,20,153984,63895,90089
14 ,Kanagawa,26_ 30,1945,Showa,20,130286,55418,74868
14 ,Kanagawa,31_ 35,1945,Showa,20,130844,60624,70220
14 ,Kanagawa,36_ 40,1945,Showa,20,119593,59357,60236
14 ,Kanagawa,41_ 45,1945,Showa,20,116794,62282,54512
14 ,Kanagawa,46_ 50,1945,Showa,20,98849,53177,45672
14 ,Kanagawa,51_ 55,1945,Showa,20,78145,41915,36230
14 ,Kanagawa,56_ 60,1945,Showa,20,66234,34273,31961
14 ,Kanagawa,61_ 65,1945,Showa,20,48683,23328,25355
14 ,Kanagawa,66_ 70,1945,Showa,20,37898,17084,20814
14 ,Kanagawa,71_ 75,1945,Showa,20,22048,9417,12631
14 ,Kanagawa,76_ 80,1945,Showa,20,10641,4179,6462
14 ,Kanagawa,81_ 85,1945,Showa,20,4547,1624,2923
14 ,Kanagawa,86以上,1945,Showa,20,1526,465,1061
14 ,Kanagawa,total,1950,Showa,25,2487665,1247934,1239731
14 ,Kanagawa,0_ 4,1950,Showa,25,332869,170246,162623
14 ,Kanagawa,5_ 9,1950,Showa,25,283222,143619,139603
14 ,Kanagawa,10_ 14,1950,Showa,25,235692,119602,116090
14 ,Kanagawa,15_ 19,1950,Showa,25,242483,124373,118110
14 ,Kanagawa,20_ 24,1950,Showa,25,251855,133725,118130
14 ,Kanagawa,25_ 29,1950,Showa,25,207833,98379,109454
14 ,Kanagawa,30_ 34,1950,Showa,25,177415,83454,93961
14 ,Kanagawa,35_ 39,1950,Showa,25,167219,83237,83982
14 ,Kanagawa,40_ 44,1950,Showa,25,136538,69276,67262
14 ,Kanagawa,45_ 49,1950,Showa,25,120194,62368,57826
14 ,Kanagawa,50_ 54,1950,Showa,25,97331,50353,46978
14 ,Kanagawa,55_ 59,1950,Showa,25,76320,39174,37146
14 ,Kanagawa,60_ 64,1950,Showa,25,62290,30243,32047
14 ,Kanagawa,65_ 69,1950,Showa,25,43226,19021,24205
14 ,Kanagawa,70_ 74,1950,Showa,25,30550,12560,17990
14 ,Kanagawa,75_ 79,1950,Showa,25,14938,5788,9150
14 ,Kanagawa,over_80,1950,Showa,25,7577,2456,5121
14 ,Kanagawa,total,1955,Showa,30,2919497,1470415,1449082
14 ,Kanagawa,0_ 4,1955,Showa,30,280616,143565,137051
14 ,Kanagawa,5_ 9,1955,Showa,30,348927,178684,170243
14 ,Kanagawa,10_ 14,1955,Showa,30,297977,151080,146897
14 ,Kanagawa,15_ 19,1955,Showa,30,276237,143580,132657
14 ,Kanagawa,20_ 24,1955,Showa,30,303506,161644,141862
14 ,Kanagawa,25_ 29,1955,Showa,30,284573,146703,137870
14 ,Kanagawa,30_ 34,1955,Showa,30,224113,106104,118009
14 ,Kanagawa,35_ 39,1955,Showa,30,185547,87247,98300
14 ,Kanagawa,40_ 44,1955,Showa,30,171488,85173,86315
14 ,Kanagawa,45_ 49,1955,Showa,30,138531,69982,68549
14 ,Kanagawa,50_ 54,1955,Showa,30,119725,61318,58407
14 ,Kanagawa,55_ 59,1955,Showa,30,95037,48205,46832
14 ,Kanagawa,60_ 64,1955,Showa,30,71416,35601,35815
14 ,Kanagawa,65_ 69,1955,Showa,30,54433,25336,29097
14 ,Kanagawa,70_ 74,1955,Showa,30,34904,14529,20375
14 ,Kanagawa,75_ 79,1955,Showa,30,21218,7987,13231
14 ,Kanagawa,80_ 84,1955,Showa,30,8403,2864,5539
14 ,Kanagawa,over_85,1955,Showa,30,2809,796,2013
14 ,Kanagawa,total,1960,Showa,35,3443176,1746926,1696250
14 ,Kanagawa,0_ 4,1960,Showa,35,281460,144531,136929
14 ,Kanagawa,5_ 9,1960,Showa,35,295229,150979,144250
14 ,Kanagawa,10_ 14,1960,Showa,35,364030,185956,178074
14 ,Kanagawa,15_ 19,1960,Showa,35,373803,197285,176518
14 ,Kanagawa,20_ 24,1960,Showa,35,359926,196256,163670
14 ,Kanagawa,25_ 29,1960,Showa,35,352494,180238,172256
14 ,Kanagawa,30_ 34,1960,Showa,35,312945,162053,150892
14 ,Kanagawa,35_ 39,1960,Showa,35,237066,113495,123571
14 ,Kanagawa,40_ 44,1960,Showa,35,191209,90219,100990
14 ,Kanagawa,45_ 49,1960,Showa,35,174729,86436,88293
14 ,Kanagawa,50_ 54,1960,Showa,35,139929,69883,70046
14 ,Kanagawa,55_ 59,1960,Showa,35,118626,59600,59026
14 ,Kanagawa,60_ 64,1960,Showa,35,90854,44565,46289
14 ,Kanagawa,65_ 69,1960,Showa,35,64430,30757,33673
14 ,Kanagawa,70_ 74,1960,Showa,35,45131,19777,25354
14 ,Kanagawa,75_ 79,1960,Showa,35,24949,9581,15368
14 ,Kanagawa,80_ 84,1960,Showa,35,12032,4085,7947
14 ,Kanagawa,over_85,1960,Showa,35,4334,1230,3104
14 ,Kanagawa,total,1965,Showa,40,4430743,2280926,2149817
14 ,Kanagawa,0_ 4,1965,Showa,40,402712,206102,196610
14 ,Kanagawa,5_ 9,1965,Showa,40,312869,159746,153123
14 ,Kanagawa,10_ 14,1965,Showa,40,319722,162546,157176
14 ,Kanagawa,15_ 19,1965,Showa,40,500922,268360,232562
14 ,Kanagawa,20_ 24,1965,Showa,40,527272,292089,235183
14 ,Kanagawa,25_ 29,1965,Showa,40,480014,251907,228107
14 ,Kanagawa,30_ 34,1965,Showa,40,432689,226382,206307
14 ,Kanagawa,35_ 39,1965,Showa,40,353769,186895,166874
14 ,Kanagawa,40_ 44,1965,Showa,40,257349,125032,132317
14 ,Kanagawa,45_ 49,1965,Showa,40,204051,96838,107213
14 ,Kanagawa,50_ 54,1965,Showa,40,183887,90579,93308
14 ,Kanagawa,55_ 59,1965,Showa,40,145365,72234,73131
14 ,Kanagawa,60_ 64,1965,Showa,40,116368,57271,59097
14 ,Kanagawa,65_ 69,1965,Showa,40,83981,39604,44377
14 ,Kanagawa,70_ 74,1965,Showa,40,54889,24793,30096
14 ,Kanagawa,75_ 79,1965,Showa,40,33464,13576,19888
14 ,Kanagawa,80_ 84,1965,Showa,40,14763,5120,9643
14 ,Kanagawa,over_85,1965,Showa,40,6657,1852,4805
14 ,Kanagawa,total,1970,Showa,45,5472247,2822212,2650035
14 ,Kanagawa,0_ 4,1970,Showa,45,543479,278727,264752
14 ,Kanagawa,5_ 9,1970,Showa,45,427357,219113,208244
14 ,Kanagawa,10_ 14,1970,Showa,45,330936,169363,161573
14 ,Kanagawa,15_ 19,1970,Showa,45,457462,249776,207686
14 ,Kanagawa,20_ 24,1970,Showa,45,666307,370816,295491
14 ,Kanagawa,25_ 29,1970,Showa,45,606868,313342,293526
14 ,Kanagawa,30_ 34,1970,Showa,45,532418,278580,253838
14 ,Kanagawa,35_ 39,1970,Showa,45,461948,242136,219812
14 ,Kanagawa,40_ 44,1970,Showa,45,369472,193953,175519
14 ,Kanagawa,45_ 49,1970,Showa,45,271434,130673,140761
14 ,Kanagawa,50_ 54,1970,Showa,45,215080,101058,114022
14 ,Kanagawa,55_ 59,1970,Showa,45,189103,92099,97004
14 ,Kanagawa,60_ 64,1970,Showa,45,144464,69795,74669
14 ,Kanagawa,65_ 69,1970,Showa,45,109694,51884,57810
14 ,Kanagawa,70_ 74,1970,Showa,45,73591,32773,40818
14 ,Kanagawa,75_ 79,1970,Showa,45,42436,17648,24788
14 ,Kanagawa,80_ 84,1970,Showa,45,21197,7781,13416
14 ,Kanagawa,over_85,1970,Showa,45,9001,2695,6306
14 ,Kanagawa,total,1975,Showa,50,6397748,3287118,3110630
14 ,Kanagawa,0_ 4,1975,Showa,50,639180,327940,311240
14 ,Kanagawa,5_ 9,1975,Showa,50,552629,283699,268930
14 ,Kanagawa,10_ 14,1975,Showa,50,440212,226064,214148
14 ,Kanagawa,15_ 19,1975,Showa,50,413796,222761,191035
14 ,Kanagawa,20_ 24,1975,Showa,50,576966,324767,252199
14 ,Kanagawa,25_ 29,1975,Showa,50,708671,368901,339770
14 ,Kanagawa,30_ 34,1975,Showa,50,637876,326241,311635
14 ,Kanagawa,35_ 39,1975,Showa,50,545917,285169,260748
14 ,Kanagawa,40_ 44,1975,Showa,50,474081,247543,226538
14 ,Kanagawa,45_ 49,1975,Showa,50,382403,199138,183265
14 ,Kanagawa,50_ 54,1975,Showa,50,278727,133130,145597
14 ,Kanagawa,55_ 59,1975,Showa,50,217322,101373,115949
14 ,Kanagawa,60_ 64,1975,Showa,50,189013,89957,99056
14 ,Kanagawa,65_ 69,1975,Showa,50,138062,64330,73732
14 ,Kanagawa,70_ 74,1975,Showa,50,98097,43987,54110
14 ,Kanagawa,75_ 79,1975,Showa,50,59410,24573,34837
14 ,Kanagawa,80_ 84,1975,Showa,50,28375,10710,17665
14 ,Kanagawa,over_85,1975,Showa,50,13361,4214,9147
14 ,Kanagawa,total,1980,Showa,55,6924348,3536021,3388327
14 ,Kanagawa,0_ 4,1980,Showa,55,517278,266256,251022
14 ,Kanagawa,5_ 9,1980,Showa,55,633171,325023,308148
14 ,Kanagawa,10_ 14,1980,Showa,55,552614,283848,268766
14 ,Kanagawa,15_ 19,1980,Showa,55,491991,259313,232678
14 ,Kanagawa,20_ 24,1980,Showa,55,501081,280106,220975
14 ,Kanagawa,25_ 29,1980,Showa,55,564655,298142,266513
14 ,Kanagawa,30_ 34,1980,Showa,55,707464,361047,346417
14 ,Kanagawa,35_ 39,1980,Showa,55,632999,321815,311184
14 ,Kanagawa,40_ 44,1980,Showa,55,540829,280457,260372
14 ,Kanagawa,45_ 49,1980,Showa,55,470739,243429,227310
14 ,Kanagawa,50_ 54,1980,Showa,55,378451,194919,183532
14 ,Kanagawa,55_ 59,1980,Showa,55,274043,129201,144842
14 ,Kanagawa,60_ 64,1980,Showa,55,210290,95668,114622
14 ,Kanagawa,65_ 69,1980,Showa,55,177567,81720,95847
14 ,Kanagawa,70_ 74,1980,Showa,55,124184,55155,69029
14 ,Kanagawa,75_ 79,1980,Showa,55,80521,33801,46720
14 ,Kanagawa,80_ 84,1980,Showa,55,41459,15686,25773
14 ,Kanagawa,over_85,1980,Showa,55,19317,6214,13103
14 ,Kanagawa,total,1985,Showa,60,7431974,3804081,3627893
14 ,Kanagawa,0_ 4,1985,Showa,60,446129,228254,217875
14 ,Kanagawa,5_ 9,1985,Showa,60,514952,264549,250403
14 ,Kanagawa,10_ 14,1985,Showa,60,634046,325258,308788
14 ,Kanagawa,15_ 19,1985,Showa,60,601973,316946,285027
14 ,Kanagawa,20_ 24,1985,Showa,60,601015,339124,261891
14 ,Kanagawa,25_ 29,1985,Showa,60,511665,278027,233638
14 ,Kanagawa,30_ 34,1985,Showa,60,574500,298911,275589
14 ,Kanagawa,35_ 39,1985,Showa,60,710619,362441,348178
14 ,Kanagawa,40_ 44,1985,Showa,60,633268,321083,312185
14 ,Kanagawa,45_ 49,1985,Showa,60,540383,278705,261678
14 ,Kanagawa,50_ 54,1985,Showa,60,467258,240321,226937
14 ,Kanagawa,55_ 59,1985,Showa,60,371155,189221,181934
14 ,Kanagawa,60_ 64,1985,Showa,60,265732,122924,142808
14 ,Kanagawa,65_ 69,1985,Showa,60,199167,88092,111075
14 ,Kanagawa,70_ 74,1985,Showa,60,161884,71518,90366
14 ,Kanagawa,75_ 79,1985,Showa,60,104932,43674,61258
14 ,Kanagawa,80_ 84,1985,Showa,60,58484,22419,36065
14 ,Kanagawa,over_85,1985,Showa,60,31418,10178,21240
14 ,Kanagawa,total,1990,Heisei,2,7980391,4098147,3882244
14 ,Kanagawa,0_ 4,1990,Heisei,2,406908,208896,198012
14 ,Kanagawa,5_ 9,1990,Heisei,2,450166,230203,219963
14 ,Kanagawa,10_ 14,1990,Heisei,2,518695,266735,251960
14 ,Kanagawa,15_ 19,1990,Heisei,2,688446,360351,328095
14 ,Kanagawa,20_ 24,1990,Heisei,2,729311,406554,322757
14 ,Kanagawa,25_ 29,1990,Heisei,2,625733,344903,280830
14 ,Kanagawa,30_ 34,1990,Heisei,2,532893,283168,249725
14 ,Kanagawa,35_ 39,1990,Heisei,2,584380,303193,281187
14 ,Kanagawa,40_ 44,1990,Heisei,2,717342,364964,352378
14 ,Kanagawa,45_ 49,1990,Heisei,2,636239,321062,315177
14 ,Kanagawa,50_ 54,1990,Heisei,2,539723,277413,262310
14 ,Kanagawa,55_ 59,1990,Heisei,2,460926,235142,225784
14 ,Kanagawa,60_ 64,1990,Heisei,2,359452,180044,179408
14 ,Kanagawa,65_ 69,1990,Heisei,2,252929,114109,138820
14 ,Kanagawa,70_ 74,1990,Heisei,2,183448,77958,105490
14 ,Kanagawa,75_ 79,1990,Heisei,2,140108,58489,81619
14 ,Kanagawa,80_ 84,1990,Heisei,2,79827,30191,49636
14 ,Kanagawa,over_85,1990,Heisei,2,48284,15577,32707
14 ,Kanagawa,total,1995,Heisei,7,8245900,4209525,4036375
14 ,Kanagawa,0_ 4,1995,Heisei,7,392366,200958,191408
14 ,Kanagawa,5_ 9,1995,Heisei,7,395568,202923,192645
14 ,Kanagawa,10_ 14,1995,Heisei,7,444009,227156,216853
14 ,Kanagawa,15_ 19,1995,Heisei,7,552893,287494,265399
14 ,Kanagawa,20_ 24,1995,Heisei,7,775703,416862,358841
14 ,Kanagawa,25_ 29,1995,Heisei,7,725790,394584,331206
14 ,Kanagawa,30_ 34,1995,Heisei,7,624041,336126,287915
14 ,Kanagawa,35_ 39,1995,Heisei,7,525385,277304,248081
14 ,Kanagawa,40_ 44,1995,Heisei,7,576790,296658,280132
14 ,Kanagawa,45_ 49,1995,Heisei,7,714414,360678,353736
14 ,Kanagawa,50_ 54,1995,Heisei,7,629899,316432,313467
14 ,Kanagawa,55_ 59,1995,Heisei,7,530411,271277,259134
14 ,Kanagawa,60_ 64,1995,Heisei,7,443122,223034,220088
14 ,Kanagawa,65_ 69,1995,Heisei,7,338451,165913,172538
14 ,Kanagawa,70_ 74,1995,Heisei,7,231962,100569,131393
14 ,Kanagawa,75_ 79,1995,Heisei,7,158833,63325,95508
14 ,Kanagawa,80_ 84,1995,Heisei,7,108375,41200,67175
14 ,Kanagawa,over_85,1995,Heisei,7,70846,22198,48648
14 ,Kanagawa,total,2000,Heisei,12,8489974,4308786,4181188
14 ,Kanagawa,0_ 4,2000,Heisei,12,404339,207284,197055
14 ,Kanagawa,5_ 9,2000,Heisei,12,385843,197300,188543
14 ,Kanagawa,10_ 14,2000,Heisei,12,394049,202250,191799
14 ,Kanagawa,15_ 19,2000,Heisei,12,478756,247733,231023
14 ,Kanagawa,20_ 24,2000,Heisei,12,629994,336385,293609
14 ,Kanagawa,25_ 29,2000,Heisei,12,761816,401927,359889
14 ,Kanagawa,30_ 34,2000,Heisei,12,722950,384549,338401
14 ,Kanagawa,35_ 39,2000,Heisei,12,615846,328057,287789
14 ,Kanagawa,40_ 44,2000,Heisei,12,519489,271443,248046
14 ,Kanagawa,45_ 49,2000,Heisei,12,569515,290102,279413
14 ,Kanagawa,50_ 54,2000,Heisei,12,699981,350727,349254
14 ,Kanagawa,55_ 59,2000,Heisei,12,612979,305658,307321
14 ,Kanagawa,60_ 64,2000,Heisei,12,510144,257138,253006
14 ,Kanagawa,65_ 69,2000,Heisei,12,418172,205331,212841
14 ,Kanagawa,70_ 74,2000,Heisei,12,311498,147436,164062
14 ,Kanagawa,75_ 79,2000,Heisei,12,206232,85184,121048
14 ,Kanagawa,80_ 84,2000,Heisei,12,128027,47088,80939
14 ,Kanagawa,over_85,2000,Heisei,12,105599,33145,72454
14 ,Kanagawa,total,2005,Heisei,17,8791597,4444555,4347042
14 ,Kanagawa,0_ 4,2005,Heisei,17,394198,201517,192681
14 ,Kanagawa,5_ 9,2005,Heisei,17,403542,206559,196983
14 ,Kanagawa,10_ 14,2005,Heisei,17,386891,198044,188847
14 ,Kanagawa,15_ 19,2005,Heisei,17,425075,222088,202987
14 ,Kanagawa,20_ 24,2005,Heisei,17,551629,294562,257067
14 ,Kanagawa,25_ 29,2005,Heisei,17,631512,332305,299207
14 ,Kanagawa,30_ 34,2005,Heisei,17,774981,402624,372357
14 ,Kanagawa,35_ 39,2005,Heisei,17,722836,380430,342406
14 ,Kanagawa,40_ 44,2005,Heisei,17,618992,327654,291338
14 ,Kanagawa,45_ 49,2005,Heisei,17,517300,268263,249037
14 ,Kanagawa,50_ 54,2005,Heisei,17,563669,285763,277906
14 ,Kanagawa,55_ 59,2005,Heisei,17,686087,341522,344565
14 ,Kanagawa,60_ 64,2005,Heisei,17,596060,294194,301866
14 ,Kanagawa,65_ 69,2005,Heisei,17,489010,242134,246876
14 ,Kanagawa,70_ 74,2005,Heisei,17,392795,187281,205514
14 ,Kanagawa,75_ 79,2005,Heisei,17,280263,126141,154122
14 ,Kanagawa,80_ 84,2005,Heisei,17,171933,65234,106699
14 ,Kanagawa,over_85,2005,Heisei,17,146261,42822,103439
14 ,Kanagawa,total,2010,Heisei,22,9048331,4544545,4503786
14 ,Kanagawa,0_ 4,2010,Heisei,22,386632,198021,188611
14 ,Kanagawa,5_ 9,2010,Heisei,22,394466,201523,192943
14 ,Kanagawa,10_ 14,2010,Heisei,22,406645,208062,198583
14 ,Kanagawa,15_ 19,2010,Heisei,22,421017,218310,202707
14 ,Kanagawa,20_ 24,2010,Heisei,22,497253,264378,232875
14 ,Kanagawa,25_ 29,2010,Heisei,22,560556,293164,267392
14 ,Kanagawa,30_ 34,2010,Heisei,22,649305,336592,312713
14 ,Kanagawa,35_ 39,2010,Heisei,22,781964,403749,378215
14 ,Kanagawa,40_ 44,2010,Heisei,22,725746,379015,346731
14 ,Kanagawa,45_ 49,2010,Heisei,22,615874,323490,292384
14 ,Kanagawa,50_ 54,2010,Heisei,22,513356,263940,249416
14 ,Kanagawa,55_ 59,2010,Heisei,22,555978,279828,276150
14 ,Kanagawa,60_ 64,2010,Heisei,22,667808,328946,338862
14 ,Kanagawa,65_ 69,2010,Heisei,22,572060,277639,294421
14 ,Kanagawa,70_ 74,2010,Heisei,22,458921,220443,238478
14 ,Kanagawa,75_ 79,2010,Heisei,22,354820,160794,194026
14 ,Kanagawa,80_ 84,2010,Heisei,22,235284,96130,139154
14 ,Kanagawa,over_85,2010,Heisei,22,198418,57960,140458
14 ,Kanagawa,total,2015,Heisei,27,9126214,4558978,4567236
14 ,Kanagawa,0_ 4,2015,Heisei,27,364868,186813,178055
14 ,Kanagawa,5_ 9,2015,Heisei,27,380593,194769,185824
14 ,Kanagawa,10_ 14,2015,Heisei,27,395287,201953,193334
14 ,Kanagawa,15_ 19,2015,Heisei,27,435960,225669,210291
14 ,Kanagawa,20_ 24,2015,Heisei,27,475327,248985,226342
14 ,Kanagawa,25_ 29,2015,Heisei,27,488631,254564,234067
14 ,Kanagawa,30_ 34,2015,Heisei,27,559152,288035,271117
14 ,Kanagawa,35_ 39,2015,Heisei,27,645547,332207,313340
14 ,Kanagawa,40_ 44,2015,Heisei,27,775579,397876,377703
14 ,Kanagawa,45_ 49,2015,Heisei,27,718951,373709,345242
14 ,Kanagawa,50_ 54,2015,Heisei,27,606592,316425,290167
14 ,Kanagawa,55_ 59,2015,Heisei,27,502515,257001,245514
14 ,Kanagawa,60_ 64,2015,Heisei,27,536129,267348,268781
14 ,Kanagawa,65_ 69,2015,Heisei,27,638669,309417,329252
14 ,Kanagawa,70_ 74,2015,Heisei,27,535599,252558,283041
14 ,Kanagawa,75_ 79,2015,Heisei,27,416119,191706,224413
14 ,Kanagawa,80_ 84,2015,Heisei,27,299631,125573,174058
14 ,Kanagawa,over_85,2015,Heisei,27,268139,85000,183139
15 ,Niigata,total,1920,Taisho,9,1776474,871532,904942
15 ,Niigata,0_ 4,1920,Taisho,9,251983,126807,125176
15 ,Niigata,5_ 9,1920,Taisho,9,236387,119578,116809
15 ,Niigata,10_ 14,1920,Taisho,9,201721,103974,97747
15 ,Niigata,15_ 19,1920,Taisho,9,150992,78323,72669
15 ,Niigata,20_ 24,1920,Taisho,9,116138,55484,60654
15 ,Niigata,25_ 29,1920,Taisho,9,110199,53688,56511
15 ,Niigata,30_ 34,1920,Taisho,9,110370,53572,56798
15 ,Niigata,35_ 39,1920,Taisho,9,113896,54827,59069
15 ,Niigata,40_ 44,1920,Taisho,9,107820,52117,55703
15 ,Niigata,45_ 49,1920,Taisho,9,88034,42068,45966
15 ,Niigata,50_ 54,1920,Taisho,9,76068,36488,39580
15 ,Niigata,55_ 59,1920,Taisho,9,58564,27377,31187
15 ,Niigata,60_ 64,1920,Taisho,9,54999,25373,29626
15 ,Niigata,65_ 69,1920,Taisho,9,44746,20041,24705
15 ,Niigata,70_ 74,1920,Taisho,9,30732,12911,17821
15 ,Niigata,75_ 79,1920,Taisho,9,16331,6369,9962
15 ,Niigata,over_80,1920,Taisho,9,7494,2535,4959
15 ,Niigata,total,1925,Taisho,14,1849807,913886,935921
15 ,Niigata,0_ 4,1925,Taisho,14,269762,135196,134566
15 ,Niigata,5_ 9,1925,Taisho,14,232957,117395,115562
15 ,Niigata,10_ 14,1925,Taisho,14,215269,112751,102518
15 ,Niigata,15_ 19,1925,Taisho,14,166216,86687,79529
15 ,Niigata,20_ 24,1925,Taisho,14,135456,67652,67804
15 ,Niigata,25_ 29,1925,Taisho,14,113995,56220,57775
15 ,Niigata,30_ 34,1925,Taisho,14,105409,51913,53496
15 ,Niigata,35_ 39,1925,Taisho,14,105805,52011,53794
15 ,Niigata,40_ 44,1925,Taisho,14,108622,52742,55880
15 ,Niigata,45_ 49,1925,Taisho,14,101799,49182,52617
15 ,Niigata,50_ 54,1925,Taisho,14,81185,38386,42799
15 ,Niigata,55_ 59,1925,Taisho,14,67515,31760,35755
15 ,Niigata,60_ 64,1925,Taisho,14,49264,22290,26974
15 ,Niigata,65_ 69,1925,Taisho,14,42171,18507,23664
15 ,Niigata,70_ 74,1925,Taisho,14,29680,12272,17408
15 ,Niigata,75_ 79,1925,Taisho,14,16557,6248,10309
15 ,Niigata,80_ 84,1925,Taisho,14,6429,2149,4280
15 ,Niigata,over_85,1925,Taisho,14,1716,525,1191
15 ,Niigata,total,1930,Showa,5,1933326,955621,977705
15 ,Niigata,0_ 4,1930,Showa,5,282972,142694,140278
15 ,Niigata,5_ 9,1930,Showa,5,252251,126398,125853
15 ,Niigata,10_ 14,1930,Showa,5,214164,110774,103390
15 ,Niigata,15_ 19,1930,Showa,5,175474,93030,82444
15 ,Niigata,20_ 24,1930,Showa,5,149381,73807,75574
15 ,Niigata,25_ 29,1930,Showa,5,129623,64412,65211
15 ,Niigata,30_ 34,1930,Showa,5,108945,53896,55049
15 ,Niigata,35_ 39,1930,Showa,5,100864,49783,51081
15 ,Niigata,40_ 44,1930,Showa,5,100445,49317,51128
15 ,Niigata,45_ 49,1930,Showa,5,102479,49532,52947
15 ,Niigata,50_ 54,1930,Showa,5,93838,44946,48892
15 ,Niigata,55_ 59,1930,Showa,5,72771,33832,38939
15 ,Niigata,60_ 64,1930,Showa,5,57441,26085,31356
15 ,Niigata,65_ 69,1930,Showa,5,38220,16320,21900
15 ,Niigata,70_ 74,1930,Showa,5,28666,11663,17003
15 ,Niigata,75_ 79,1930,Showa,5,16787,6289,10498
15 ,Niigata,over_80,1930,Showa,5,9005,2843,6162
15 ,Niigata,total,1935,Showa,10,1995777,982497,1013280
15 ,Niigata,0_ 4,1935,Showa,10,289253,146248,143005
15 ,Niigata,5_ 9,1935,Showa,10,265754,133887,131867
15 ,Niigata,10_ 14,1935,Showa,10,230785,118732,112053
15 ,Niigata,15_ 19,1935,Showa,10,164467,85452,79015
15 ,Niigata,20_ 24,1935,Showa,10,149311,72702,76609
15 ,Niigata,25_ 29,1935,Showa,10,140648,68122,72526
15 ,Niigata,30_ 34,1935,Showa,10,123410,61148,62262
15 ,Niigata,35_ 39,1935,Showa,10,103519,51073,52446
15 ,Niigata,40_ 44,1935,Showa,10,95518,47186,48332
15 ,Niigata,45_ 49,1935,Showa,10,94840,46395,48445
15 ,Niigata,50_ 54,1935,Showa,10,94661,45408,49253
15 ,Niigata,55_ 59,1935,Showa,10,84145,39535,44610
15 ,Niigata,60_ 64,1935,Showa,10,62327,27957,34370
15 ,Niigata,65_ 69,1935,Showa,10,44909,19276,25633
15 ,Niigata,70_ 74,1935,Showa,10,26347,10382,15965
15 ,Niigata,75_ 79,1935,Showa,10,16232,6007,10225
15 ,Niigata,over_80,1935,Showa,10,9651,2987,6664
15 ,Niigata,total,1940,Showa,15,2064227,1016953,1047274
15 ,Niigata,0_ 4,1940,Showa,15,278315,140590,137725
15 ,Niigata,5_ 9,1940,Showa,15,270503,136708,133795
15 ,Niigata,10_ 14,1940,Showa,15,247759,126810,120949
15 ,Niigata,15_ 19,1940,Showa,15,185038,92893,92145
15 ,Niigata,20_ 24,1940,Showa,15,157281,82316,74965
15 ,Niigata,25_ 29,1940,Showa,15,142559,69643,72916
15 ,Niigata,30_ 34,1940,Showa,15,131265,63076,68189
15 ,Niigata,35_ 39,1940,Showa,15,116897,57430,59467
15 ,Niigata,40_ 44,1940,Showa,15,97642,48065,49577
15 ,Niigata,45_ 49,1940,Showa,15,89489,43927,45562
15 ,Niigata,50_ 54,1940,Showa,15,87647,42366,45281
15 ,Niigata,55_ 59,1940,Showa,15,84922,39961,44961
15 ,Niigata,60_ 64,1940,Showa,15,71514,32286,39228
15 ,Niigata,65_ 69,1940,Showa,15,48777,20597,28180
15 ,Niigata,70_ 74,1940,Showa,15,30672,12120,18552
15 ,Niigata,75_ 79,1940,Showa,15,14769,5273,9496
15 ,Niigata,80_ 84,1940,Showa,15,6701,2235,4466
15 ,Niigata,over_85,1940,Showa,15,2470,655,1815
15 ,Niigata,total,1945,Showa,20,2389653,1095809,1293844
15 ,Niigata,1_ 5,1945,Showa,20,318015,160494,157521
15 ,Niigata,6_ 10,1945,Showa,20,309162,156129,153033
15 ,Niigata,11_ 15,1945,Showa,20,302789,152864,149925
15 ,Niigata,16_ 20,1945,Showa,20,259174,125900,133274
15 ,Niigata,21_ 25,1945,Showa,20,169344,54047,115297
15 ,Niigata,26_ 30,1945,Showa,20,137336,43871,93465
15 ,Niigata,31_ 35,1945,Showa,20,144313,56647,87666
15 ,Niigata,36_ 40,1945,Showa,20,143300,64452,78848
15 ,Niigata,41_ 45,1945,Showa,20,125828,61102,64726
15 ,Niigata,46_ 50,1945,Showa,20,103542,50705,52837
15 ,Niigata,51_ 55,1945,Showa,20,92342,45139,47203
15 ,Niigata,56_ 60,1945,Showa,20,86310,41164,45146
15 ,Niigata,61_ 65,1945,Showa,20,77646,35109,42537
15 ,Niigata,66_ 70,1945,Showa,20,59640,25542,34098
15 ,Niigata,71_ 75,1945,Showa,20,35549,13968,21581
15 ,Niigata,76_ 80,1945,Showa,20,17322,6187,11135
15 ,Niigata,81_ 85,1945,Showa,20,6164,1923,4241
15 ,Niigata,86以上,1945,Showa,20,1877,566,1311
15 ,Niigata,total,1950,Showa,25,2460997,1194929,1266068
15 ,Niigata,0_ 4,1950,Showa,25,336298,170898,165400
15 ,Niigata,5_ 9,1950,Showa,25,286941,145094,141847
15 ,Niigata,10_ 14,1950,Showa,25,286303,144522,141781
15 ,Niigata,15_ 19,1950,Showa,25,252288,129260,123028
15 ,Niigata,20_ 24,1950,Showa,25,216297,105600,110697
15 ,Niigata,25_ 29,1950,Showa,25,172375,77059,95316
15 ,Niigata,30_ 34,1950,Showa,25,145466,65840,79626
15 ,Niigata,35_ 39,1950,Showa,25,143703,66716,76987
15 ,Niigata,40_ 44,1950,Showa,25,133070,63657,69413
15 ,Niigata,45_ 49,1950,Showa,25,114012,56277,57735
15 ,Niigata,50_ 54,1950,Showa,25,92200,45410,46790
15 ,Niigata,55_ 59,1950,Showa,25,80903,39111,41792
15 ,Niigata,60_ 64,1950,Showa,25,72374,33605,38769
15 ,Niigata,65_ 69,1950,Showa,25,59243,25751,33492
15 ,Niigata,70_ 74,1950,Showa,25,39986,16021,23965
15 ,Niigata,75_ 79,1950,Showa,25,19879,7143,12736
15 ,Niigata,over_80,1950,Showa,25,9598,2940,6658
15 ,Niigata,total,1955,Showa,30,2473492,1195872,1277620
15 ,Niigata,0_ 4,1955,Showa,30,274698,140343,134355
15 ,Niigata,5_ 9,1955,Showa,30,321036,163103,157933
15 ,Niigata,10_ 14,1955,Showa,30,277330,140070,137260
15 ,Niigata,15_ 19,1955,Showa,30,231789,114756,117033
15 ,Niigata,20_ 24,1955,Showa,30,205255,97917,107338
15 ,Niigata,25_ 29,1955,Showa,30,194815,95389,99426
15 ,Niigata,30_ 34,1955,Showa,30,162316,72858,89458
15 ,Niigata,35_ 39,1955,Showa,30,137385,61961,75424
15 ,Niigata,40_ 44,1955,Showa,30,136013,62949,73064
15 ,Niigata,45_ 49,1955,Showa,30,126143,60152,65991
15 ,Niigata,50_ 54,1955,Showa,30,107110,52635,54475
15 ,Niigata,55_ 59,1955,Showa,30,85065,41375,43690
15 ,Niigata,60_ 64,1955,Showa,30,71609,33847,37762
15 ,Niigata,65_ 69,1955,Showa,30,59632,26824,32808
15 ,Niigata,70_ 74,1955,Showa,30,44369,18142,26227
15 ,Niigata,75_ 79,1955,Showa,30,25631,9442,16189
15 ,Niigata,80_ 84,1955,Showa,30,10093,3218,6875
15 ,Niigata,over_85,1955,Showa,30,3187,881,2306
15 ,Niigata,total,1960,Showa,35,2442037,1177923,1264114
15 ,Niigata,0_ 4,1960,Showa,35,211060,107839,103221
15 ,Niigata,5_ 9,1960,Showa,35,270698,138117,132581
15 ,Niigata,10_ 14,1960,Showa,35,317050,160951,156099
15 ,Niigata,15_ 19,1960,Showa,35,208357,102606,105751
15 ,Niigata,20_ 24,1960,Showa,35,183567,84604,98963
15 ,Niigata,25_ 29,1960,Showa,35,189882,92315,97567
15 ,Niigata,30_ 34,1960,Showa,35,188477,93210,95267
15 ,Niigata,35_ 39,1960,Showa,35,158257,71310,86947
15 ,Niigata,40_ 44,1960,Showa,35,133865,60580,73285
15 ,Niigata,45_ 49,1960,Showa,35,131224,60675,70549
15 ,Niigata,50_ 54,1960,Showa,35,120052,57147,62905
15 ,Niigata,55_ 59,1960,Showa,35,100187,48712,51475
15 ,Niigata,60_ 64,1960,Showa,35,76546,36468,40078
15 ,Niigata,65_ 69,1960,Showa,35,60627,27657,32970
15 ,Niigata,70_ 74,1960,Showa,35,45712,19328,26384
15 ,Niigata,75_ 79,1960,Showa,35,28789,10792,17997
15 ,Niigata,80_ 84,1960,Showa,35,13179,4371,8808
15 ,Niigata,over_85,1960,Showa,35,4508,1241,3267
15 ,Niigata,total,1965,Showa,40,2398931,1160283,1238648
15 ,Niigata,0_ 4,1965,Showa,40,187337,95460,91877
15 ,Niigata,5_ 9,1965,Showa,40,207933,105860,102073
15 ,Niigata,10_ 14,1965,Showa,40,267189,135931,131258
15 ,Niigata,15_ 19,1965,Showa,40,250759,126873,123886
15 ,Niigata,20_ 24,1965,Showa,40,165907,77070,88837
15 ,Niigata,25_ 29,1965,Showa,40,173011,84168,88843
15 ,Niigata,30_ 34,1965,Showa,40,185440,91732,93708
15 ,Niigata,35_ 39,1965,Showa,40,184486,91595,92891
15 ,Niigata,40_ 44,1965,Showa,40,154619,69826,84793
15 ,Niigata,45_ 49,1965,Showa,40,129603,58593,71010
15 ,Niigata,50_ 54,1965,Showa,40,125073,57757,67316
15 ,Niigata,55_ 59,1965,Showa,40,112458,53173,59285
15 ,Niigata,60_ 64,1965,Showa,40,90475,43068,47407
15 ,Niigata,65_ 69,1965,Showa,40,65556,30146,35410
15 ,Niigata,70_ 74,1965,Showa,40,47316,20392,26924
15 ,Niigata,75_ 79,1965,Showa,40,30541,11921,18620
15 ,Niigata,80_ 84,1965,Showa,40,14970,4983,9987
15 ,Niigata,over_85,1965,Showa,40,6258,1735,4523
15 ,Niigata,total,1970,Showa,45,2360982,1140148,1220834
15 ,Niigata,0_ 4,1970,Showa,45,181091,92986,88105
15 ,Niigata,5_ 9,1970,Showa,45,185752,94808,90944
15 ,Niigata,10_ 14,1970,Showa,45,206571,105300,101271
15 ,Niigata,15_ 19,1970,Showa,45,213807,107657,106150
15 ,Niigata,20_ 24,1970,Showa,45,196810,92977,103833
15 ,Niigata,25_ 29,1970,Showa,45,164398,81046,83352
15 ,Niigata,30_ 34,1970,Showa,45,169816,83741,86075
15 ,Niigata,35_ 39,1970,Showa,45,180848,89164,91684
15 ,Niigata,40_ 44,1970,Showa,45,177378,87826,89552
15 ,Niigata,45_ 49,1970,Showa,45,150642,67483,83159
15 ,Niigata,50_ 54,1970,Showa,45,124548,55932,68616
15 ,Niigata,55_ 59,1970,Showa,45,116042,52999,63043
15 ,Niigata,60_ 64,1970,Showa,45,102994,47660,55334
15 ,Niigata,65_ 69,1970,Showa,45,79447,36355,43092
15 ,Niigata,70_ 74,1970,Showa,45,53308,23123,30185
15 ,Niigata,75_ 79,1970,Showa,45,32933,13048,19885
15 ,Niigata,80_ 84,1970,Showa,45,17009,5889,11120
15 ,Niigata,over_85,1970,Showa,45,7588,2154,5434
15 ,Niigata,total,1975,Showa,50,2391938,1160869,1231069
15 ,Niigata,0_ 4,1975,Showa,50,190992,97461,93531
15 ,Niigata,5_ 9,1975,Showa,50,181412,93168,88244
15 ,Niigata,10_ 14,1975,Showa,50,184875,94396,90479
15 ,Niigata,15_ 19,1975,Showa,50,171210,87343,83867
15 ,Niigata,20_ 24,1975,Showa,50,164204,78302,85902
15 ,Niigata,25_ 29,1975,Showa,50,202303,102056,100247
15 ,Niigata,30_ 34,1975,Showa,50,166461,83781,82680
15 ,Niigata,35_ 39,1975,Showa,50,169152,83828,85324
15 ,Niigata,40_ 44,1975,Showa,50,179355,88654,90701
15 ,Niigata,45_ 49,1975,Showa,50,176784,87136,89648
15 ,Niigata,50_ 54,1975,Showa,50,145544,65020,80524
15 ,Niigata,55_ 59,1975,Showa,50,119349,53109,66240
15 ,Niigata,60_ 64,1975,Showa,50,111302,49864,61438
15 ,Niigata,65_ 69,1975,Showa,50,93495,41841,51654
15 ,Niigata,70_ 74,1975,Showa,50,67001,29123,37878
15 ,Niigata,75_ 79,1975,Showa,50,39094,15762,23332
15 ,Niigata,80_ 84,1975,Showa,50,19820,7176,12644
15 ,Niigata,over_85,1975,Showa,50,9349,2729,6620
15 ,Niigata,total,1980,Showa,55,2451357,1193653,1257704
15 ,Niigata,0_ 4,1980,Showa,55,176969,90182,86787
15 ,Niigata,5_ 9,1980,Showa,55,193069,98392,94677
15 ,Niigata,10_ 14,1980,Showa,55,182080,93495,88585
15 ,Niigata,15_ 19,1980,Showa,55,162266,83506,78760
15 ,Niigata,20_ 24,1980,Showa,55,136295,67202,69093
15 ,Niigata,25_ 29,1980,Showa,55,182587,91235,91352
15 ,Niigata,30_ 34,1980,Showa,55,206724,106228,100496
15 ,Niigata,35_ 39,1980,Showa,55,166816,84076,82740
15 ,Niigata,40_ 44,1980,Showa,55,167663,82947,84716
15 ,Niigata,45_ 49,1980,Showa,55,175939,86315,89624
15 ,Niigata,50_ 54,1980,Showa,55,172407,84262,88145
15 ,Niigata,55_ 59,1980,Showa,55,140803,61997,78806
15 ,Niigata,60_ 64,1980,Showa,55,113904,49815,64089
15 ,Niigata,65_ 69,1980,Showa,55,102684,44770,57914
15 ,Niigata,70_ 74,1980,Showa,55,81152,34689,46463
15 ,Niigata,75_ 79,1980,Showa,55,52119,21058,31061
15 ,Niigata,80_ 84,1980,Showa,55,25138,9276,15862
15 ,Niigata,over_85,1980,Showa,55,12346,3934,8412
15 ,Niigata,total,1985,Showa,60,2478470,1205071,1273399
15 ,Niigata,0_ 4,1985,Showa,60,152967,78121,74846
15 ,Niigata,5_ 9,1985,Showa,60,177576,90294,87282
15 ,Niigata,10_ 14,1985,Showa,60,192942,98254,94688
15 ,Niigata,15_ 19,1985,Showa,60,163557,84035,79522
15 ,Niigata,20_ 24,1985,Showa,60,129879,64237,65642
15 ,Niigata,25_ 29,1985,Showa,60,150292,75738,74554
15 ,Niigata,30_ 34,1985,Showa,60,184723,93462,91261
15 ,Niigata,35_ 39,1985,Showa,60,205695,105498,100197
15 ,Niigata,40_ 44,1985,Showa,60,164830,82898,81932
15 ,Niigata,45_ 49,1985,Showa,60,164638,81016,83622
15 ,Niigata,50_ 54,1985,Showa,60,171810,83687,88123
15 ,Niigata,55_ 59,1985,Showa,60,166973,80508,86465
15 ,Niigata,60_ 64,1985,Showa,60,135260,58608,76652
15 ,Niigata,65_ 69,1985,Showa,60,106767,45684,61083
15 ,Niigata,70_ 74,1985,Showa,60,91518,38121,53397
15 ,Niigata,75_ 79,1985,Showa,60,66141,26328,39813
15 ,Niigata,80_ 84,1985,Showa,60,35670,13012,22658
15 ,Niigata,over_85,1985,Showa,60,17063,5449,11614
15 ,Niigata,total,1990,Heisei,2,2474583,1200376,1274207
15 ,Niigata,0_ 4,1990,Heisei,2,131611,67186,64425
15 ,Niigata,5_ 9,1990,Heisei,2,153655,78604,75051
15 ,Niigata,10_ 14,1990,Heisei,2,177293,90211,87082
15 ,Niigata,15_ 19,1990,Heisei,2,175550,89639,85911
15 ,Niigata,20_ 24,1990,Heisei,2,128808,63670,65138
15 ,Niigata,25_ 29,1990,Heisei,2,137374,68554,68820
15 ,Niigata,30_ 34,1990,Heisei,2,151558,76971,74587
15 ,Niigata,35_ 39,1990,Heisei,2,184548,93246,91302
15 ,Niigata,40_ 44,1990,Heisei,2,203689,104433,99256
15 ,Niigata,45_ 49,1990,Heisei,2,161716,80994,80722
15 ,Niigata,50_ 54,1990,Heisei,2,160805,78519,82286
15 ,Niigata,55_ 59,1990,Heisei,2,167096,80364,86732
15 ,Niigata,60_ 64,1990,Heisei,2,161185,76602,84583
15 ,Niigata,65_ 69,1990,Heisei,2,128142,54267,73875
15 ,Niigata,70_ 74,1990,Heisei,2,97432,40064,57368
15 ,Niigata,75_ 79,1990,Heisei,2,77593,30297,47296
15 ,Niigata,80_ 84,1990,Heisei,2,48323,17301,31022
15 ,Niigata,over_85,1990,Heisei,2,26367,8215,18152
15 ,Niigata,total,1995,Heisei,7,2488364,1209833,1278531
15 ,Niigata,0_ 4,1995,Heisei,7,118385,60403,57982
15 ,Niigata,5_ 9,1995,Heisei,7,134119,68494,65625
15 ,Niigata,10_ 14,1995,Heisei,7,154287,78971,75316
15 ,Niigata,15_ 19,1995,Heisei,7,165490,85257,80233
15 ,Niigata,20_ 24,1995,Heisei,7,149290,75535,73755
15 ,Niigata,25_ 29,1995,Heisei,7,143179,72368,70811
15 ,Niigata,30_ 34,1995,Heisei,7,143352,72460,70892
15 ,Niigata,35_ 39,1995,Heisei,7,154690,78928,75762
15 ,Niigata,40_ 44,1995,Heisei,7,185423,94059,91364
15 ,Niigata,45_ 49,1995,Heisei,7,203061,104218,98843
15 ,Niigata,50_ 54,1995,Heisei,7,160103,79916,80187
15 ,Niigata,55_ 59,1995,Heisei,7,158680,77005,81675
15 ,Niigata,60_ 64,1995,Heisei,7,162621,77275,85346
15 ,Niigata,65_ 69,1995,Heisei,7,153628,71319,82309
15 ,Niigata,70_ 74,1995,Heisei,7,118690,48310,70380
15 ,Niigata,75_ 79,1995,Heisei,7,84183,32366,51817
15 ,Niigata,80_ 84,1995,Heisei,7,58974,20742,38232
15 ,Niigata,over_85,1995,Heisei,7,39589,11758,27831
15 ,Niigata,total,2000,Heisei,12,2475733,1202004,1273729
15 ,Niigata,0_ 4,2000,Heisei,12,111455,56899,54556
15 ,Niigata,5_ 9,2000,Heisei,12,119739,61154,58585
15 ,Niigata,10_ 14,2000,Heisei,12,134473,68581,65892
15 ,Niigata,15_ 19,2000,Heisei,12,143577,73640,69937
15 ,Niigata,20_ 24,2000,Heisei,12,138701,71367,67334
15 ,Niigata,25_ 29,2000,Heisei,12,157996,80253,77743
15 ,Niigata,30_ 34,2000,Heisei,12,145863,74049,71814
15 ,Niigata,35_ 39,2000,Heisei,12,144753,73183,71570
15 ,Niigata,40_ 44,2000,Heisei,12,154592,78787,75805
15 ,Niigata,45_ 49,2000,Heisei,12,183704,93000,90704
15 ,Niigata,50_ 54,2000,Heisei,12,200116,102205,97911
15 ,Niigata,55_ 59,2000,Heisei,12,157054,77478,79576
15 ,Niigata,60_ 64,2000,Heisei,12,154830,74147,80683
15 ,Niigata,65_ 69,2000,Heisei,12,155104,72030,83074
15 ,Niigata,70_ 74,2000,Heisei,12,142419,63699,78720
15 ,Niigata,75_ 79,2000,Heisei,12,105034,40140,64894
15 ,Niigata,80_ 84,2000,Heisei,12,67002,23398,43604
15 ,Niigata,over_85,2000,Heisei,12,56553,16045,40508
15 ,Niigata,total,2005,Heisei,17,2431459,1176919,1254540
15 ,Niigata,0_ 4,2005,Heisei,17,99197,50685,48512
15 ,Niigata,5_ 9,2005,Heisei,17,111721,57162,54559
15 ,Niigata,10_ 14,2005,Heisei,17,119384,60945,58439
15 ,Niigata,15_ 19,2005,Heisei,17,125960,64408,61552
15 ,Niigata,20_ 24,2005,Heisei,17,118520,60612,57908
15 ,Niigata,25_ 29,2005,Heisei,17,139875,71692,68183
15 ,Niigata,30_ 34,2005,Heisei,17,158200,80406,77794
15 ,Niigata,35_ 39,2005,Heisei,17,145146,73621,71525
15 ,Niigata,40_ 44,2005,Heisei,17,143504,72357,71147
15 ,Niigata,45_ 49,2005,Heisei,17,152523,77374,75149
15 ,Niigata,50_ 54,2005,Heisei,17,181060,91169,89891
15 ,Niigata,55_ 59,2005,Heisei,17,196432,99514,96918
15 ,Niigata,60_ 64,2005,Heisei,17,153649,75037,78612
15 ,Niigata,65_ 69,2005,Heisei,17,148429,69861,78568
15 ,Niigata,70_ 74,2005,Heisei,17,144991,65094,79897
15 ,Niigata,75_ 79,2005,Heisei,17,127017,53502,73515
15 ,Niigata,80_ 84,2005,Heisei,17,86111,29764,56347
15 ,Niigata,over_85,2005,Heisei,17,74191,20303,53888
15 ,Niigata,total,2010,Heisei,22,2374450,1148236,1226214
15 ,Niigata,0_ 4,2010,Heisei,22,91041,46864,44177
15 ,Niigata,5_ 9,2010,Heisei,22,99337,50792,48545
15 ,Niigata,10_ 14,2010,Heisei,22,111330,56935,54395
15 ,Niigata,15_ 19,2010,Heisei,22,112142,57313,54829
15 ,Niigata,20_ 24,2010,Heisei,22,102654,52439,50215
15 ,Niigata,25_ 29,2010,Heisei,22,118489,60637,57852
15 ,Niigata,30_ 34,2010,Heisei,22,141181,72188,68993
15 ,Niigata,35_ 39,2010,Heisei,22,158205,80283,77922
15 ,Niigata,40_ 44,2010,Heisei,22,144558,73365,71193
15 ,Niigata,45_ 49,2010,Heisei,22,142180,71568,70612
15 ,Niigata,50_ 54,2010,Heisei,22,150738,76170,74568
15 ,Niigata,55_ 59,2010,Heisei,22,178368,89230,89138
15 ,Niigata,60_ 64,2010,Heisei,22,192747,96750,95997
15 ,Niigata,65_ 69,2010,Heisei,22,147915,71062,76853
15 ,Niigata,70_ 74,2010,Heisei,22,139932,63975,75957
15 ,Niigata,75_ 79,2010,Heisei,22,130566,55597,74969
15 ,Niigata,80_ 84,2010,Heisei,22,105513,40423,65090
15 ,Niigata,over_85,2010,Heisei,22,97261,26317,70944
15 ,Niigata,total,2015,Heisei,27,2304264,1115413,1188851
15 ,Niigata,0_ 4,2015,Heisei,27,83834,42926,40908
15 ,Niigata,5_ 9,2015,Heisei,27,92116,47347,44769
15 ,Niigata,10_ 14,2015,Heisei,27,99995,51193,48802
15 ,Niigata,15_ 19,2015,Heisei,27,106885,54734,52151
15 ,Niigata,20_ 24,2015,Heisei,27,94792,48746,46046
15 ,Niigata,25_ 29,2015,Heisei,27,103813,53342,50471
15 ,Niigata,30_ 34,2015,Heisei,27,119785,61358,58427
15 ,Niigata,35_ 39,2015,Heisei,27,141874,72646,69228
15 ,Niigata,40_ 44,2015,Heisei,27,157930,80098,77832
15 ,Niigata,45_ 49,2015,Heisei,27,143468,72753,70715
15 ,Niigata,50_ 54,2015,Heisei,27,140646,70738,69908
15 ,Niigata,55_ 59,2015,Heisei,27,148933,74962,73971
15 ,Niigata,60_ 64,2015,Heisei,27,175327,87116,88211
15 ,Niigata,65_ 69,2015,Heisei,27,186205,92154,94051
15 ,Niigata,70_ 74,2015,Heisei,27,139553,65339,74214
15 ,Niigata,75_ 79,2015,Heisei,27,127335,55783,71552
15 ,Niigata,80_ 84,2015,Heisei,27,109894,43015,66879
15 ,Niigata,over_85,2015,Heisei,27,122098,35338,86760
16 ,Toyama,total,1920,Taisho,9,724276,354775,369501
16 ,Toyama,0_ 4,1920,Taisho,9,102147,51315,50832
16 ,Toyama,5_ 9,1920,Taisho,9,102558,51834,50724
16 ,Toyama,10_ 14,1920,Taisho,9,86292,44540,41752
16 ,Toyama,15_ 19,1920,Taisho,9,62434,31156,31278
16 ,Toyama,20_ 24,1920,Taisho,9,49484,23332,26152
16 ,Toyama,25_ 29,1920,Taisho,9,43339,20930,22409
16 ,Toyama,30_ 34,1920,Taisho,9,43033,20944,22089
16 ,Toyama,35_ 39,1920,Taisho,9,43444,20803,22641
16 ,Toyama,40_ 44,1920,Taisho,9,44587,21953,22634
16 ,Toyama,45_ 49,1920,Taisho,9,35314,17416,17898
16 ,Toyama,50_ 54,1920,Taisho,9,29085,13816,15269
16 ,Toyama,55_ 59,1920,Taisho,9,22308,10534,11774
16 ,Toyama,60_ 64,1920,Taisho,9,20461,9359,11102
16 ,Toyama,65_ 69,1920,Taisho,9,18227,8158,10069
16 ,Toyama,70_ 74,1920,Taisho,9,12128,5206,6922
16 ,Toyama,75_ 79,1920,Taisho,9,6599,2552,4047
16 ,Toyama,over_80,1920,Taisho,9,2836,927,1909
16 ,Toyama,total,1925,Taisho,14,749243,368593,380650
16 ,Toyama,0_ 4,1925,Taisho,14,105012,52776,52236
16 ,Toyama,5_ 9,1925,Taisho,14,93850,47166,46684
16 ,Toyama,10_ 14,1925,Taisho,14,93155,48216,44939
16 ,Toyama,15_ 19,1925,Taisho,14,68588,34363,34225
16 ,Toyama,20_ 24,1925,Taisho,14,57296,27606,29690
16 ,Toyama,25_ 29,1925,Taisho,14,48570,23937,24633
16 ,Toyama,30_ 34,1925,Taisho,14,41947,20913,21034
16 ,Toyama,35_ 39,1925,Taisho,14,41533,20530,21003
16 ,Toyama,40_ 44,1925,Taisho,14,41503,20115,21388
16 ,Toyama,45_ 49,1925,Taisho,14,42078,20782,21296
16 ,Toyama,50_ 54,1925,Taisho,14,32624,15973,16651
16 ,Toyama,55_ 59,1925,Taisho,14,25770,11991,13779
16 ,Toyama,60_ 64,1925,Taisho,14,18779,8523,10256
16 ,Toyama,65_ 69,1925,Taisho,14,15723,6818,8905
16 ,Toyama,70_ 74,1925,Taisho,14,12516,5167,7349
16 ,Toyama,75_ 79,1925,Taisho,14,6727,2546,4181
16 ,Toyama,80_ 84,1925,Taisho,14,2752,941,1811
16 ,Toyama,over_85,1925,Taisho,14,820,230,590
16 ,Toyama,total,1930,Showa,5,778953,381809,397144
16 ,Toyama,0_ 4,1930,Showa,5,109030,55188,53842
16 ,Toyama,5_ 9,1930,Showa,5,97083,48844,48239
16 ,Toyama,10_ 14,1930,Showa,5,86699,43988,42711
16 ,Toyama,15_ 19,1930,Showa,5,74983,37550,37433
16 ,Toyama,20_ 24,1930,Showa,5,63296,30122,33174
16 ,Toyama,25_ 29,1930,Showa,5,55334,27094,28240
16 ,Toyama,30_ 34,1930,Showa,5,46549,23097,23452
16 ,Toyama,35_ 39,1930,Showa,5,40242,19990,20252
16 ,Toyama,40_ 44,1930,Showa,5,39547,19593,19954
16 ,Toyama,45_ 49,1930,Showa,5,39174,18869,20305
16 ,Toyama,50_ 54,1930,Showa,5,38673,18902,19771
16 ,Toyama,55_ 59,1930,Showa,5,29430,14148,15282
16 ,Toyama,60_ 64,1930,Showa,5,22053,9875,12178
16 ,Toyama,65_ 69,1930,Showa,5,14634,6271,8363
16 ,Toyama,70_ 74,1930,Showa,5,10863,4304,6559
16 ,Toyama,75_ 79,1930,Showa,5,7258,2697,4561
16 ,Toyama,over_80,1930,Showa,5,4105,1277,2828
16 ,Toyama,total,1935,Showa,10,798890,388771,410119
16 ,Toyama,0_ 4,1935,Showa,10,107963,54645,53318
16 ,Toyama,5_ 9,1935,Showa,10,101102,51282,49820
16 ,Toyama,10_ 14,1935,Showa,10,90530,45401,45129
16 ,Toyama,15_ 19,1935,Showa,10,67820,32258,35562
16 ,Toyama,20_ 24,1935,Showa,10,64783,29722,35061
16 ,Toyama,25_ 29,1935,Showa,10,59662,28933,30729
16 ,Toyama,30_ 34,1935,Showa,10,52828,26153,26675
16 ,Toyama,35_ 39,1935,Showa,10,44728,22453,22275
16 ,Toyama,40_ 44,1935,Showa,10,38305,19182,19123
16 ,Toyama,45_ 49,1935,Showa,10,37168,18435,18733
16 ,Toyama,50_ 54,1935,Showa,10,35943,17186,18757
16 ,Toyama,55_ 59,1935,Showa,10,34794,16580,18214
16 ,Toyama,60_ 64,1935,Showa,10,25005,11614,13391
16 ,Toyama,65_ 69,1935,Showa,10,17328,7290,10038
16 ,Toyama,70_ 74,1935,Showa,10,10284,4055,6229
16 ,Toyama,75_ 79,1935,Showa,10,6281,2213,4068
16 ,Toyama,over_80,1935,Showa,10,4366,1369,2997
16 ,Toyama,total,1940,Showa,15,822530,401235,421295
16 ,Toyama,0_ 4,1940,Showa,15,101280,51013,50267
16 ,Toyama,5_ 9,1940,Showa,15,100791,51122,49669
16 ,Toyama,10_ 14,1940,Showa,15,96876,49040,47836
16 ,Toyama,15_ 19,1940,Showa,15,75708,36097,39611
16 ,Toyama,20_ 24,1940,Showa,15,64269,31957,32312
16 ,Toyama,25_ 29,1940,Showa,15,62386,30036,32350
16 ,Toyama,30_ 34,1940,Showa,15,56137,27080,29057
16 ,Toyama,35_ 39,1940,Showa,15,50045,24599,25446
16 ,Toyama,40_ 44,1940,Showa,15,41821,20743,21078
16 ,Toyama,45_ 49,1940,Showa,15,35511,17617,17894
16 ,Toyama,50_ 54,1940,Showa,15,34164,16703,17461
16 ,Toyama,55_ 59,1940,Showa,15,32280,15020,17260
16 ,Toyama,60_ 64,1940,Showa,15,29451,13502,15949
16 ,Toyama,65_ 69,1940,Showa,15,19955,8741,11214
16 ,Toyama,70_ 74,1940,Showa,15,12156,4666,7490
16 ,Toyama,75_ 79,1940,Showa,15,5911,2132,3779
16 ,Toyama,80_ 84,1940,Showa,15,2684,824,1860
16 ,Toyama,over_85,1940,Showa,15,1103,343,760
16 ,Toyama,total,1945,Showa,20,953834,442490,511344
16 ,Toyama,1_ 5,1945,Showa,20,127810,64861,62949
16 ,Toyama,6_ 10,1945,Showa,20,112369,56798,55571
16 ,Toyama,11_ 15,1945,Showa,20,114978,57981,56997
16 ,Toyama,16_ 20,1945,Showa,20,100131,48987,51144
16 ,Toyama,21_ 25,1945,Showa,20,68100,24426,43674
16 ,Toyama,26_ 30,1945,Showa,20,56775,19459,37316
16 ,Toyama,31_ 35,1945,Showa,20,62907,24967,37940
16 ,Toyama,36_ 40,1945,Showa,20,59873,26752,33121
16 ,Toyama,41_ 45,1945,Showa,20,54840,27036,27804
16 ,Toyama,46_ 50,1945,Showa,20,45083,22788,22295
16 ,Toyama,51_ 55,1945,Showa,20,36750,18334,18416
16 ,Toyama,56_ 60,1945,Showa,20,34280,16576,17704
16 ,Toyama,61_ 65,1945,Showa,20,29601,13304,16297
16 ,Toyama,66_ 70,1945,Showa,20,24771,10636,14135
16 ,Toyama,71_ 75,1945,Showa,20,15152,6052,9100
16 ,Toyama,76_ 80,1945,Showa,20,7028,2479,4549
16 ,Toyama,81_ 85,1945,Showa,20,2546,801,1745
16 ,Toyama,86以上,1945,Showa,20,840,253,587
16 ,Toyama,total,1950,Showa,25,1008790,488850,519940
16 ,Toyama,0_ 4,1950,Showa,25,141716,72475,69241
16 ,Toyama,5_ 9,1950,Showa,25,116561,59048,57513
16 ,Toyama,10_ 14,1950,Showa,25,103280,52174,51106
16 ,Toyama,15_ 19,1950,Showa,25,101679,49256,52423
16 ,Toyama,20_ 24,1950,Showa,25,87157,41685,45472
16 ,Toyama,25_ 29,1950,Showa,25,71144,32856,38288
16 ,Toyama,30_ 34,1950,Showa,25,62439,28726,33713
16 ,Toyama,35_ 39,1950,Showa,25,64208,30211,33997
16 ,Toyama,40_ 44,1950,Showa,25,57089,27298,29791
16 ,Toyama,45_ 49,1950,Showa,25,49531,24506,25025
16 ,Toyama,50_ 54,1950,Showa,25,39960,19979,19981
16 ,Toyama,55_ 59,1950,Showa,25,32343,15822,16521
16 ,Toyama,60_ 64,1950,Showa,25,28523,13345,15178
16 ,Toyama,65_ 69,1950,Showa,25,23011,9985,13026
16 ,Toyama,70_ 74,1950,Showa,25,17322,7017,10305
16 ,Toyama,75_ 79,1950,Showa,25,8723,3205,5518
16 ,Toyama,over_80,1950,Showa,25,4061,1243,2818
16 ,Toyama,total,1955,Showa,30,1021121,494109,527012
16 ,Toyama,0_ 4,1955,Showa,30,97485,49800,47685
16 ,Toyama,5_ 9,1955,Showa,30,135996,69477,66519
16 ,Toyama,10_ 14,1955,Showa,30,114012,57717,56295
16 ,Toyama,15_ 19,1955,Showa,30,89093,44155,44938
16 ,Toyama,20_ 24,1955,Showa,30,86481,39838,46643
16 ,Toyama,25_ 29,1955,Showa,30,82102,39767,42335
16 ,Toyama,30_ 34,1955,Showa,30,68409,31613,36796
16 ,Toyama,35_ 39,1955,Showa,30,60088,27584,32504
16 ,Toyama,40_ 44,1955,Showa,30,61765,28964,32801
16 ,Toyama,45_ 49,1955,Showa,30,54313,25907,28406
16 ,Toyama,50_ 54,1955,Showa,30,46859,23054,23805
16 ,Toyama,55_ 59,1955,Showa,30,37059,18340,18719
16 ,Toyama,60_ 64,1955,Showa,30,28803,13794,15009
16 ,Toyama,65_ 69,1955,Showa,30,23733,10727,13006
16 ,Toyama,70_ 74,1955,Showa,30,17628,7234,10394
16 ,Toyama,75_ 79,1955,Showa,30,11400,4274,7126
16 ,Toyama,80_ 84,1955,Showa,30,4537,1503,3034
16 ,Toyama,over_85,1955,Showa,30,1347,358,989
16 ,Toyama,total,1960,Showa,35,1032614,500545,532069
16 ,Toyama,0_ 4,1960,Showa,35,77321,39452,37869
16 ,Toyama,5_ 9,1960,Showa,35,96248,49152,47096
16 ,Toyama,10_ 14,1960,Showa,35,134354,68590,65764
16 ,Toyama,15_ 19,1960,Showa,35,100515,48850,51665
16 ,Toyama,20_ 24,1960,Showa,35,79346,37187,42159
16 ,Toyama,25_ 29,1960,Showa,35,84050,40874,43176
16 ,Toyama,30_ 34,1960,Showa,35,81228,40105,41123
16 ,Toyama,35_ 39,1960,Showa,35,67678,31609,36069
16 ,Toyama,40_ 44,1960,Showa,35,59169,27497,31672
16 ,Toyama,45_ 49,1960,Showa,35,60051,28345,31706
16 ,Toyama,50_ 54,1960,Showa,35,52308,24945,27363
16 ,Toyama,55_ 59,1960,Showa,35,44111,21449,22662
16 ,Toyama,60_ 64,1960,Showa,35,33562,16295,17267
16 ,Toyama,65_ 69,1960,Showa,35,24553,11432,13121
16 ,Toyama,70_ 74,1960,Showa,35,18429,7856,10573
16 ,Toyama,75_ 79,1960,Showa,35,11637,4372,7265
16 ,Toyama,80_ 84,1960,Showa,35,5987,1971,4016
16 ,Toyama,over_85,1960,Showa,35,2067,564,1503
16 ,Toyama,total,1965,Showa,40,1025465,491662,533803
16 ,Toyama,0_ 4,1965,Showa,40,74855,38220,36635
16 ,Toyama,5_ 9,1965,Showa,40,76402,38846,37556
16 ,Toyama,10_ 14,1965,Showa,40,95027,48264,46763
16 ,Toyama,15_ 19,1965,Showa,40,120760,58670,62090
16 ,Toyama,20_ 24,1965,Showa,40,82596,37203,45393
16 ,Toyama,25_ 29,1965,Showa,40,76434,36807,39627
16 ,Toyama,30_ 34,1965,Showa,40,81616,39549,42067
16 ,Toyama,35_ 39,1965,Showa,40,79080,38799,40281
16 ,Toyama,40_ 44,1965,Showa,40,65623,30355,35268
16 ,Toyama,45_ 49,1965,Showa,40,57303,26385,30918
16 ,Toyama,50_ 54,1965,Showa,40,57278,26728,30550
16 ,Toyama,55_ 59,1965,Showa,40,48974,23179,25795
16 ,Toyama,60_ 64,1965,Showa,40,40049,19078,20971
16 ,Toyama,65_ 69,1965,Showa,40,28801,13469,15332
16 ,Toyama,70_ 74,1965,Showa,40,19265,8469,10796
16 ,Toyama,75_ 79,1965,Showa,40,12403,4858,7545
16 ,Toyama,80_ 84,1965,Showa,40,6124,1989,4135
16 ,Toyama,over_85,1965,Showa,40,2875,794,2081
16 ,Toyama,total,1970,Showa,45,1029695,492492,537203
16 ,Toyama,0_ 4,1970,Showa,45,79073,40828,38245
16 ,Toyama,5_ 9,1970,Showa,45,74675,38208,36467
16 ,Toyama,10_ 14,1970,Showa,45,75910,38702,37208
16 ,Toyama,15_ 19,1970,Showa,45,86723,41677,45046
16 ,Toyama,20_ 24,1970,Showa,45,96483,43388,53095
16 ,Toyama,25_ 29,1970,Showa,45,81897,39839,42058
16 ,Toyama,30_ 34,1970,Showa,45,75634,36822,38812
16 ,Toyama,35_ 39,1970,Showa,45,80353,38954,41399
16 ,Toyama,40_ 44,1970,Showa,45,76690,37516,39174
16 ,Toyama,45_ 49,1970,Showa,45,64336,29703,34633
16 ,Toyama,50_ 54,1970,Showa,45,55398,25345,30053
16 ,Toyama,55_ 59,1970,Showa,45,53880,24875,29005
16 ,Toyama,60_ 64,1970,Showa,45,45437,20954,24483
16 ,Toyama,65_ 69,1970,Showa,45,35342,16252,19090
16 ,Toyama,70_ 74,1970,Showa,45,23711,10516,13195
16 ,Toyama,75_ 79,1970,Showa,45,13598,5481,8117
16 ,Toyama,80_ 84,1970,Showa,45,7212,2490,4722
16 ,Toyama,over_85,1970,Showa,45,3343,942,2401
16 ,Toyama,total,1975,Showa,50,1070791,514991,555800
16 ,Toyama,0_ 4,1975,Showa,50,91767,46995,44772
16 ,Toyama,5_ 9,1975,Showa,50,79867,41347,38520
16 ,Toyama,10_ 14,1975,Showa,50,74765,38284,36481
16 ,Toyama,15_ 19,1975,Showa,50,71129,34832,36297
16 ,Toyama,20_ 24,1975,Showa,50,70592,32155,38437
16 ,Toyama,25_ 29,1975,Showa,50,99791,49057,50734
16 ,Toyama,30_ 34,1975,Showa,50,83316,41308,42008
16 ,Toyama,35_ 39,1975,Showa,50,75324,36624,38700
16 ,Toyama,40_ 44,1975,Showa,50,79545,38478,41067
16 ,Toyama,45_ 49,1975,Showa,50,75979,37002,38977
16 ,Toyama,50_ 54,1975,Showa,50,62550,28708,33842
16 ,Toyama,55_ 59,1975,Showa,50,53316,24182,29134
16 ,Toyama,60_ 64,1975,Showa,50,51482,23315,28167
16 ,Toyama,65_ 69,1975,Showa,50,41220,18251,22969
16 ,Toyama,70_ 74,1975,Showa,50,29982,12978,17004
16 ,Toyama,75_ 79,1975,Showa,50,17569,7231,10338
16 ,Toyama,80_ 84,1975,Showa,50,8259,2991,5268
16 ,Toyama,over_85,1975,Showa,50,4235,1194,3041
16 ,Toyama,total,1980,Showa,55,1103459,532686,570773
16 ,Toyama,0_ 4,1980,Showa,55,76452,39442,37010
16 ,Toyama,5_ 9,1980,Showa,55,93102,47655,45447
16 ,Toyama,10_ 14,1980,Showa,55,80381,41551,38830
16 ,Toyama,15_ 19,1980,Showa,55,70385,35210,35175
16 ,Toyama,20_ 24,1980,Showa,55,58340,26867,31473
16 ,Toyama,25_ 29,1980,Showa,55,75599,36986,38613
16 ,Toyama,30_ 34,1980,Showa,55,101823,50896,50927
16 ,Toyama,35_ 39,1980,Showa,55,83752,41523,42229
16 ,Toyama,40_ 44,1980,Showa,55,75178,36659,38519
16 ,Toyama,45_ 49,1980,Showa,55,78705,38064,40641
16 ,Toyama,50_ 54,1980,Showa,55,74668,36121,38547
16 ,Toyama,55_ 59,1980,Showa,55,60711,27693,33018
16 ,Toyama,60_ 64,1980,Showa,55,50938,22761,28177
16 ,Toyama,65_ 69,1980,Showa,55,47482,20938,26544
16 ,Toyama,70_ 74,1980,Showa,55,35766,15080,20686
16 ,Toyama,75_ 79,1980,Showa,55,23457,9424,14033
16 ,Toyama,80_ 84,1980,Showa,55,11392,4190,7202
16 ,Toyama,over_85,1980,Showa,55,5310,1616,3694
16 ,Toyama,total,1985,Showa,60,1118369,538955,579414
16 ,Toyama,0_ 4,1985,Showa,60,63268,32485,30783
16 ,Toyama,5_ 9,1985,Showa,60,77185,39830,37355
16 ,Toyama,10_ 14,1985,Showa,60,93512,47944,45568
16 ,Toyama,15_ 19,1985,Showa,60,76168,38655,37513
16 ,Toyama,20_ 24,1985,Showa,60,58438,27333,31105
16 ,Toyama,25_ 29,1985,Showa,60,62254,30498,31756
16 ,Toyama,30_ 34,1985,Showa,60,76673,37845,38828
16 ,Toyama,35_ 39,1985,Showa,60,102300,51129,51171
16 ,Toyama,40_ 44,1985,Showa,60,83153,41167,41986
16 ,Toyama,45_ 49,1985,Showa,60,73925,35882,38043
16 ,Toyama,50_ 54,1985,Showa,60,77051,36928,40123
16 ,Toyama,55_ 59,1985,Showa,60,72462,34654,37808
16 ,Toyama,60_ 64,1985,Showa,60,58304,26115,32189
16 ,Toyama,65_ 69,1985,Showa,60,47683,20755,26928
16 ,Toyama,70_ 74,1985,Showa,60,42708,18070,24638
16 ,Toyama,75_ 79,1985,Showa,60,29271,11467,17804
16 ,Toyama,80_ 84,1985,Showa,60,16167,5808,10359
16 ,Toyama,over_85,1985,Showa,60,7817,2375,5442
16 ,Toyama,total,1990,Heisei,2,1120161,538640,581521
16 ,Toyama,0_ 4,1990,Heisei,2,54028,27581,26447
16 ,Toyama,5_ 9,1990,Heisei,2,63983,32842,31141
16 ,Toyama,10_ 14,1990,Heisei,2,77587,39979,37608
16 ,Toyama,15_ 19,1990,Heisei,2,87158,44196,42962
16 ,Toyama,20_ 24,1990,Heisei,2,63149,30180,32969
16 ,Toyama,25_ 29,1990,Heisei,2,61940,30422,31518
16 ,Toyama,30_ 34,1990,Heisei,2,62938,31167,31771
16 ,Toyama,35_ 39,1990,Heisei,2,77136,38129,39007
16 ,Toyama,40_ 44,1990,Heisei,2,101926,50995,50931
16 ,Toyama,45_ 49,1990,Heisei,2,82011,40504,41507
16 ,Toyama,50_ 54,1990,Heisei,2,72585,35064,37521
16 ,Toyama,55_ 59,1990,Heisei,2,75237,35643,39594
16 ,Toyama,60_ 64,1990,Heisei,2,70001,32995,37006
16 ,Toyama,65_ 69,1990,Heisei,2,55193,24100,31093
16 ,Toyama,70_ 74,1990,Heisei,2,43391,18136,25255
16 ,Toyama,75_ 79,1990,Heisei,2,36356,14405,21951
16 ,Toyama,80_ 84,1990,Heisei,2,21666,7570,14096
16 ,Toyama,over_85,1990,Heisei,2,12340,3642,8698
16 ,Toyama,total,1995,Heisei,7,1123125,540921,582204
16 ,Toyama,0_ 4,1995,Heisei,7,49912,25483,24429
16 ,Toyama,5_ 9,1995,Heisei,7,55319,28275,27044
16 ,Toyama,10_ 14,1995,Heisei,7,64814,33285,31529
16 ,Toyama,15_ 19,1995,Heisei,7,72069,37083,34986
16 ,Toyama,20_ 24,1995,Heisei,7,76616,38323,38293
16 ,Toyama,25_ 29,1995,Heisei,7,68464,34236,34228
16 ,Toyama,30_ 34,1995,Heisei,7,63768,31705,32063
16 ,Toyama,35_ 39,1995,Heisei,7,64604,32134,32470
16 ,Toyama,40_ 44,1995,Heisei,7,77965,38637,39328
16 ,Toyama,45_ 49,1995,Heisei,7,101994,51196,50798
16 ,Toyama,50_ 54,1995,Heisei,7,81453,40170,41283
16 ,Toyama,55_ 59,1995,Heisei,7,71701,34420,37281
16 ,Toyama,60_ 64,1995,Heisei,7,73005,34032,38973
16 ,Toyama,65_ 69,1995,Heisei,7,66507,30592,35915
16 ,Toyama,70_ 74,1995,Heisei,7,50910,21414,29496
16 ,Toyama,75_ 79,1995,Heisei,7,37645,14774,22871
16 ,Toyama,80_ 84,1995,Heisei,7,27802,9874,17928
16 ,Toyama,over_85,1995,Heisei,7,18456,5204,13252
16 ,Toyama,total,2000,Heisei,12,1120851,540212,580639
16 ,Toyama,0_ 4,2000,Heisei,12,50534,25928,24606
16 ,Toyama,5_ 9,2000,Heisei,12,50839,25988,24851
16 ,Toyama,10_ 14,2000,Heisei,12,55806,28542,27264
16 ,Toyama,15_ 19,2000,Heisei,12,59620,30626,28994
16 ,Toyama,20_ 24,2000,Heisei,12,62474,32118,30356
16 ,Toyama,25_ 29,2000,Heisei,12,81589,41556,40033
16 ,Toyama,30_ 34,2000,Heisei,12,69232,34976,34256
16 ,Toyama,35_ 39,2000,Heisei,12,64665,32260,32405
16 ,Toyama,40_ 44,2000,Heisei,12,64879,32246,32633
16 ,Toyama,45_ 49,2000,Heisei,12,77532,38426,39106
16 ,Toyama,50_ 54,2000,Heisei,12,100632,50206,50426
16 ,Toyama,55_ 59,2000,Heisei,12,80186,39207,40979
16 ,Toyama,60_ 64,2000,Heisei,12,69732,32989,36743
16 ,Toyama,65_ 69,2000,Heisei,12,69443,31599,37844
16 ,Toyama,70_ 74,2000,Heisei,12,61506,27245,34261
16 ,Toyama,75_ 79,2000,Heisei,12,45046,17879,27167
16 ,Toyama,80_ 84,2000,Heisei,12,29943,10690,19253
16 ,Toyama,over_85,2000,Heisei,12,26795,7446,19349
16 ,Toyama,total,2005,Heisei,17,1111729,535617,576112
16 ,Toyama,0_ 4,2005,Heisei,17,47824,24587,23237
16 ,Toyama,5_ 9,2005,Heisei,17,50853,26077,24776
16 ,Toyama,10_ 14,2005,Heisei,17,50868,26009,24859
16 ,Toyama,15_ 19,2005,Heisei,17,51494,26562,24932
16 ,Toyama,20_ 24,2005,Heisei,17,51522,26625,24897
16 ,Toyama,25_ 29,2005,Heisei,17,65935,33906,32029
16 ,Toyama,30_ 34,2005,Heisei,17,82200,42192,40008
16 ,Toyama,35_ 39,2005,Heisei,17,69191,35039,34152
16 ,Toyama,40_ 44,2005,Heisei,17,64666,32214,32452
16 ,Toyama,45_ 49,2005,Heisei,17,64323,31948,32375
16 ,Toyama,50_ 54,2005,Heisei,17,76499,37701,38798
16 ,Toyama,55_ 59,2005,Heisei,17,98774,48840,49934
16 ,Toyama,60_ 64,2005,Heisei,17,78320,37912,40408
16 ,Toyama,65_ 69,2005,Heisei,17,66807,30990,35817
16 ,Toyama,70_ 74,2005,Heisei,17,64814,28465,36349
16 ,Toyama,75_ 79,2005,Heisei,17,54888,23024,31864
16 ,Toyama,80_ 84,2005,Heisei,17,37172,13405,23767
16 ,Toyama,over_85,2005,Heisei,17,34636,9452,25184
16 ,Toyama,total,2010,Heisei,22,1093247,526605,566642
16 ,Toyama,0_ 4,2010,Heisei,22,42738,21975,20763
16 ,Toyama,5_ 9,2010,Heisei,22,48215,24740,23475
16 ,Toyama,10_ 14,2010,Heisei,22,50983,26137,24846
16 ,Toyama,15_ 19,2010,Heisei,22,47585,24511,23074
16 ,Toyama,20_ 24,2010,Heisei,22,44071,22530,21541
16 ,Toyama,25_ 29,2010,Heisei,22,53673,27680,25993
16 ,Toyama,30_ 34,2010,Heisei,22,66040,34141,31899
16 ,Toyama,35_ 39,2010,Heisei,22,81937,41948,39989
16 ,Toyama,40_ 44,2010,Heisei,22,69028,34887,34141
16 ,Toyama,45_ 49,2010,Heisei,22,63874,31767,32107
16 ,Toyama,50_ 54,2010,Heisei,22,63623,31413,32210
16 ,Toyama,55_ 59,2010,Heisei,22,75561,37054,38507
16 ,Toyama,60_ 64,2010,Heisei,22,96680,47436,49244
16 ,Toyama,65_ 69,2010,Heisei,22,75348,35841,39507
16 ,Toyama,70_ 74,2010,Heisei,22,62771,28250,34521
16 ,Toyama,75_ 79,2010,Heisei,22,58370,24300,34070
16 ,Toyama,80_ 84,2010,Heisei,22,45739,17490,28249
16 ,Toyama,over_85,2010,Heisei,22,42874,11799,31075
16 ,Toyama,total,2015,Heisei,27,1066328,515147,551181
16 ,Toyama,0_ 4,2015,Heisei,27,37998,19567,18431
16 ,Toyama,5_ 9,2015,Heisei,27,42815,21967,20848
16 ,Toyama,10_ 14,2015,Heisei,27,48035,24677,23358
16 ,Toyama,15_ 19,2015,Heisei,27,48020,24846,23174
16 ,Toyama,20_ 24,2015,Heisei,27,41579,21699,19880
16 ,Toyama,25_ 29,2015,Heisei,27,46886,24452,22434
16 ,Toyama,30_ 34,2015,Heisei,27,53780,27777,26003
16 ,Toyama,35_ 39,2015,Heisei,27,65902,34023,31879
16 ,Toyama,40_ 44,2015,Heisei,27,81658,41787,39871
16 ,Toyama,45_ 49,2015,Heisei,27,68320,34502,33818
16 ,Toyama,50_ 54,2015,Heisei,27,63104,31382,31722
16 ,Toyama,55_ 59,2015,Heisei,27,62574,30800,31774
16 ,Toyama,60_ 64,2015,Heisei,27,73722,35853,37869
16 ,Toyama,65_ 69,2015,Heisei,27,93135,45047,48088
16 ,Toyama,70_ 74,2015,Heisei,27,70923,32961,37962
16 ,Toyama,75_ 79,2015,Heisei,27,56776,24426,32350
16 ,Toyama,80_ 84,2015,Heisei,27,49130,18833,30297
16 ,Toyama,over_85,2015,Heisei,27,52935,15298,37637
17 ,Ishikawa,total,1920,Taisho,9,747360,364375,382985
17 ,Ishikawa,0_ 4,1920,Taisho,9,97473,49119,48354
17 ,Ishikawa,5_ 9,1920,Taisho,9,96830,49197,47633
17 ,Ishikawa,10_ 14,1920,Taisho,9,85459,43503,41956
17 ,Ishikawa,15_ 19,1920,Taisho,9,66172,32472,33700
17 ,Ishikawa,20_ 24,1920,Taisho,9,54518,28102,26416
17 ,Ishikawa,25_ 29,1920,Taisho,9,45257,22023,23234
17 ,Ishikawa,30_ 34,1920,Taisho,9,44413,21298,23115
17 ,Ishikawa,35_ 39,1920,Taisho,9,47274,22420,24854
17 ,Ishikawa,40_ 44,1920,Taisho,9,46155,22539,23616
17 ,Ishikawa,45_ 49,1920,Taisho,9,35779,17104,18675
17 ,Ishikawa,50_ 54,1920,Taisho,9,30536,14350,16186
17 ,Ishikawa,55_ 59,1920,Taisho,9,24516,11378,13138
17 ,Ishikawa,60_ 64,1920,Taisho,9,23690,10713,12977
17 ,Ishikawa,65_ 69,1920,Taisho,9,21233,9179,12054
17 ,Ishikawa,70_ 74,1920,Taisho,9,15416,6423,8993
17 ,Ishikawa,75_ 79,1920,Taisho,9,8769,3343,5426
17 ,Ishikawa,over_80,1920,Taisho,9,3870,1212,2658
17 ,Ishikawa,total,1925,Taisho,14,750854,365597,385257
17 ,Ishikawa,0_ 4,1925,Taisho,14,97526,49018,48508
17 ,Ishikawa,5_ 9,1925,Taisho,14,88822,45028,43794
17 ,Ishikawa,10_ 14,1925,Taisho,14,90297,46117,44180
17 ,Ishikawa,15_ 19,1925,Taisho,14,70245,34282,35963
17 ,Ishikawa,20_ 24,1925,Taisho,14,57897,28997,28900
17 ,Ishikawa,25_ 29,1925,Taisho,14,46663,22903,23760
17 ,Ishikawa,30_ 34,1925,Taisho,14,42113,20632,21481
17 ,Ishikawa,35_ 39,1925,Taisho,14,41971,20348,21623
17 ,Ishikawa,40_ 44,1925,Taisho,14,44339,21189,23150
17 ,Ishikawa,45_ 49,1925,Taisho,14,43143,21007,22136
17 ,Ishikawa,50_ 54,1925,Taisho,14,32980,15661,17319
17 ,Ishikawa,55_ 59,1925,Taisho,14,27050,12510,14540
17 ,Ishikawa,60_ 64,1925,Taisho,14,20759,9220,11539
17 ,Ishikawa,65_ 69,1925,Taisho,14,18576,7935,10641
17 ,Ishikawa,70_ 74,1925,Taisho,14,14822,5952,8870
17 ,Ishikawa,75_ 79,1925,Taisho,14,8851,3324,5527
17 ,Ishikawa,80_ 84,1925,Taisho,14,3783,1214,2569
17 ,Ishikawa,over_85,1925,Taisho,14,1017,260,757
17 ,Ishikawa,total,1930,Showa,5,756835,368402,388433
17 ,Ishikawa,0_ 4,1930,Showa,5,96758,48922,47836
17 ,Ishikawa,5_ 9,1930,Showa,5,89781,45180,44601
17 ,Ishikawa,10_ 14,1930,Showa,5,82942,41939,41003
17 ,Ishikawa,15_ 19,1930,Showa,5,72866,35432,37434
17 ,Ishikawa,20_ 24,1930,Showa,5,61699,30792,30907
17 ,Ishikawa,25_ 29,1930,Showa,5,51716,25501,26215
17 ,Ishikawa,30_ 34,1930,Showa,5,44143,21814,22329
17 ,Ishikawa,35_ 39,1930,Showa,5,40176,19808,20368
17 ,Ishikawa,40_ 44,1930,Showa,5,39747,19350,20397
17 ,Ishikawa,45_ 49,1930,Showa,5,41516,19695,21821
17 ,Ishikawa,50_ 54,1930,Showa,5,39502,19045,20457
17 ,Ishikawa,55_ 59,1930,Showa,5,29442,13827,15615
17 ,Ishikawa,60_ 64,1930,Showa,5,23061,10230,12831
17 ,Ishikawa,65_ 69,1930,Showa,5,16423,6858,9565
17 ,Ishikawa,70_ 74,1930,Showa,5,13081,5193,7888
17 ,Ishikawa,75_ 79,1930,Showa,5,8623,3109,5514
17 ,Ishikawa,over_80,1930,Showa,5,5359,1707,3652
17 ,Ishikawa,total,1935,Showa,10,768416,370907,397509
17 ,Ishikawa,0_ 4,1935,Showa,10,95827,48076,47751
17 ,Ishikawa,5_ 9,1935,Showa,10,90670,45866,44804
17 ,Ishikawa,10_ 14,1935,Showa,10,85928,42736,43192
17 ,Ishikawa,15_ 19,1935,Showa,10,67299,31318,35981
17 ,Ishikawa,20_ 24,1935,Showa,10,62776,29389,33387
17 ,Ishikawa,25_ 29,1935,Showa,10,56030,27357,28673
17 ,Ishikawa,30_ 34,1935,Showa,10,49753,24821,24932
17 ,Ishikawa,35_ 39,1935,Showa,10,42373,21118,21255
17 ,Ishikawa,40_ 44,1935,Showa,10,38314,19077,19237
17 ,Ishikawa,45_ 49,1935,Showa,10,37618,18333,19285
17 ,Ishikawa,50_ 54,1935,Showa,10,38358,18140,20218
17 ,Ishikawa,55_ 59,1935,Showa,10,35414,16807,18607
17 ,Ishikawa,60_ 64,1935,Showa,10,25184,11439,13745
17 ,Ishikawa,65_ 69,1935,Showa,10,18241,7659,10582
17 ,Ishikawa,70_ 74,1935,Showa,10,11643,4493,7150
17 ,Ishikawa,75_ 79,1935,Showa,10,7629,2714,4915
17 ,Ishikawa,over_80,1935,Showa,10,5359,1564,3795
17 ,Ishikawa,total,1940,Showa,15,757598,363874,393724
17 ,Ishikawa,0_ 4,1940,Showa,15,86846,43793,43053
17 ,Ishikawa,5_ 9,1940,Showa,15,88389,44395,43994
17 ,Ishikawa,10_ 14,1940,Showa,15,86073,43196,42877
17 ,Ishikawa,15_ 19,1940,Showa,15,67633,31136,36497
17 ,Ishikawa,20_ 24,1940,Showa,15,58943,28865,30078
17 ,Ishikawa,25_ 29,1940,Showa,15,55744,26281,29463
17 ,Ishikawa,30_ 34,1940,Showa,15,50870,24378,26492
17 ,Ishikawa,35_ 39,1940,Showa,15,45968,22315,23653
17 ,Ishikawa,40_ 44,1940,Showa,15,39276,19311,19965
17 ,Ishikawa,45_ 49,1940,Showa,15,35406,17260,18146
17 ,Ishikawa,50_ 54,1940,Showa,15,34303,16495,17808
17 ,Ishikawa,55_ 59,1940,Showa,15,34079,15624,18455
17 ,Ishikawa,60_ 64,1940,Showa,15,29854,13690,16164
17 ,Ishikawa,65_ 69,1940,Showa,15,19864,8470,11394
17 ,Ishikawa,70_ 74,1940,Showa,15,12760,4923,7837
17 ,Ishikawa,75_ 79,1940,Showa,15,6846,2362,4484
17 ,Ishikawa,80_ 84,1940,Showa,15,3262,1006,2256
17 ,Ishikawa,over_85,1940,Showa,15,1480,373,1107
17 ,Ishikawa,total,1945,Showa,20,887510,405264,482246
17 ,Ishikawa,1_ 5,1945,Showa,20,116721,59161,57560
17 ,Ishikawa,6_ 10,1945,Showa,20,99760,50310,49450
17 ,Ishikawa,11_ 15,1945,Showa,20,102212,51208,51004
17 ,Ishikawa,16_ 20,1945,Showa,20,90154,43467,46687
17 ,Ishikawa,21_ 25,1945,Showa,20,64412,23622,40790
17 ,Ishikawa,26_ 30,1945,Showa,20,53469,17981,35488
17 ,Ishikawa,31_ 35,1945,Showa,20,56729,21361,35368
17 ,Ishikawa,36_ 40,1945,Showa,20,54205,23260,30945
17 ,Ishikawa,41_ 45,1945,Showa,20,51066,24574,26492
17 ,Ishikawa,46_ 50,1945,Showa,20,42985,21174,21811
17 ,Ishikawa,51_ 55,1945,Showa,20,36847,17991,18856
17 ,Ishikawa,56_ 60,1945,Showa,20,34686,16513,18173
17 ,Ishikawa,61_ 65,1945,Showa,20,31483,13889,17594
17 ,Ishikawa,66_ 70,1945,Showa,20,25501,10900,14601
17 ,Ishikawa,71_ 75,1945,Showa,20,15360,5920,9440
17 ,Ishikawa,76_ 80,1945,Showa,20,7633,2715,4918
17 ,Ishikawa,81_ 85,1945,Showa,20,3158,934,2224
17 ,Ishikawa,86以上,1945,Showa,20,1129,284,845
17 ,Ishikawa,total,1950,Showa,25,957279,460859,496420
17 ,Ishikawa,0_ 4,1950,Showa,25,133734,68158,65576
17 ,Ishikawa,5_ 9,1950,Showa,25,108626,55126,53500
17 ,Ishikawa,10_ 14,1950,Showa,25,93501,47143,46358
17 ,Ishikawa,15_ 19,1950,Showa,25,91367,44979,46388
17 ,Ishikawa,20_ 24,1950,Showa,25,80829,38486,42343
17 ,Ishikawa,25_ 29,1950,Showa,25,67864,30832,37032
17 ,Ishikawa,30_ 34,1950,Showa,25,60154,27497,32657
17 ,Ishikawa,35_ 39,1950,Showa,25,60207,27625,32582
17 ,Ishikawa,40_ 44,1950,Showa,25,54033,25787,28246
17 ,Ishikawa,45_ 49,1950,Showa,25,47528,23365,24163
17 ,Ishikawa,50_ 54,1950,Showa,25,38640,19050,19590
17 ,Ishikawa,55_ 59,1950,Showa,25,33408,16057,17351
17 ,Ishikawa,60_ 64,1950,Showa,25,29619,13740,15879
17 ,Ishikawa,65_ 69,1950,Showa,25,25331,10834,14497
17 ,Ishikawa,70_ 74,1950,Showa,25,18233,7397,10836
17 ,Ishikawa,75_ 79,1950,Showa,25,9285,3332,5953
17 ,Ishikawa,over_80,1950,Showa,25,4897,1443,3454
17 ,Ishikawa,total,1955,Showa,30,966187,463477,502710
17 ,Ishikawa,0_ 4,1955,Showa,30,92503,47468,45035
17 ,Ishikawa,5_ 9,1955,Showa,30,127632,65153,62479
17 ,Ishikawa,10_ 14,1955,Showa,30,105522,53489,52033
17 ,Ishikawa,15_ 19,1955,Showa,30,82852,39531,43321
17 ,Ishikawa,20_ 24,1955,Showa,30,79628,37236,42392
17 ,Ishikawa,25_ 29,1955,Showa,30,75513,36078,39435
17 ,Ishikawa,30_ 34,1955,Showa,30,64368,29248,35120
17 ,Ishikawa,35_ 39,1955,Showa,30,56930,25947,30983
17 ,Ishikawa,40_ 44,1955,Showa,30,57189,26138,31051
17 ,Ishikawa,45_ 49,1955,Showa,30,51311,24385,26926
17 ,Ishikawa,50_ 54,1955,Showa,30,44706,21832,22874
17 ,Ishikawa,55_ 59,1955,Showa,30,35907,17728,18179
17 ,Ishikawa,60_ 64,1955,Showa,30,29692,14003,15689
17 ,Ishikawa,65_ 69,1955,Showa,30,24804,11148,13656
17 ,Ishikawa,70_ 74,1955,Showa,30,19464,7871,11593
17 ,Ishikawa,75_ 79,1955,Showa,30,11818,4351,7467
17 ,Ishikawa,80_ 84,1955,Showa,30,4768,1494,3274
17 ,Ishikawa,over_85,1955,Showa,30,1580,377,1203
17 ,Ishikawa,total,1960,Showa,35,973418,464889,508529
17 ,Ishikawa,0_ 4,1960,Showa,35,77401,39568,37833
17 ,Ishikawa,5_ 9,1960,Showa,35,91017,46655,44362
17 ,Ishikawa,10_ 14,1960,Showa,35,125649,64108,61541
17 ,Ishikawa,15_ 19,1960,Showa,35,94419,43719,50700
17 ,Ishikawa,20_ 24,1960,Showa,35,72915,33496,39419
17 ,Ishikawa,25_ 29,1960,Showa,35,75458,36054,39404
17 ,Ishikawa,30_ 34,1960,Showa,35,73707,35638,38069
17 ,Ishikawa,35_ 39,1960,Showa,35,62988,28672,34316
17 ,Ishikawa,40_ 44,1960,Showa,35,55678,25437,30241
17 ,Ishikawa,45_ 49,1960,Showa,35,55214,25319,29895
17 ,Ishikawa,50_ 54,1960,Showa,35,49092,23268,25824
17 ,Ishikawa,55_ 59,1960,Showa,35,41943,20416,21527
17 ,Ishikawa,60_ 64,1960,Showa,35,32388,15652,16736
17 ,Ishikawa,65_ 69,1960,Showa,35,25262,11546,13716
17 ,Ishikawa,70_ 74,1960,Showa,35,19196,8114,11082
17 ,Ishikawa,75_ 79,1960,Showa,35,12834,4731,8103
17 ,Ishikawa,80_ 84,1960,Showa,35,6087,1958,4129
17 ,Ishikawa,over_85,1960,Showa,35,2170,538,1632
17 ,Ishikawa,total,1965,Showa,40,980499,468518,511981
17 ,Ishikawa,0_ 4,1965,Showa,40,76826,39112,37714
17 ,Ishikawa,5_ 9,1965,Showa,40,76913,39144,37769
17 ,Ishikawa,10_ 14,1965,Showa,40,90277,46023,44254
17 ,Ishikawa,15_ 19,1965,Showa,40,114617,54776,59841
17 ,Ishikawa,20_ 24,1965,Showa,40,80380,37139,43241
17 ,Ishikawa,25_ 29,1965,Showa,40,70200,33720,36480
17 ,Ishikawa,30_ 34,1965,Showa,40,74991,36263,38728
17 ,Ishikawa,35_ 39,1965,Showa,40,72813,35253,37560
17 ,Ishikawa,40_ 44,1965,Showa,40,61793,28266,33527
17 ,Ishikawa,45_ 49,1965,Showa,40,54109,24781,29328
17 ,Ishikawa,50_ 54,1965,Showa,40,52971,24256,28715
17 ,Ishikawa,55_ 59,1965,Showa,40,46254,21930,24324
17 ,Ishikawa,60_ 64,1965,Showa,40,38011,18172,19839
17 ,Ishikawa,65_ 69,1965,Showa,40,27914,13064,14850
17 ,Ishikawa,70_ 74,1965,Showa,40,19922,8631,11291
17 ,Ishikawa,75_ 79,1965,Showa,40,13011,5066,7945
17 ,Ishikawa,80_ 84,1965,Showa,40,6666,2161,4505
17 ,Ishikawa,over_85,1965,Showa,40,2831,761,2070
17 ,Ishikawa,total,1970,Showa,45,1002420,480380,522040
17 ,Ishikawa,0_ 4,1970,Showa,45,81105,41526,39579
17 ,Ishikawa,5_ 9,1970,Showa,45,77407,39546,37861
17 ,Ishikawa,10_ 14,1970,Showa,45,76868,39141,37727
17 ,Ishikawa,15_ 19,1970,Showa,45,84420,41301,43119
17 ,Ishikawa,20_ 24,1970,Showa,45,98906,46591,52315
17 ,Ishikawa,25_ 29,1970,Showa,45,79929,39090,40839
17 ,Ishikawa,30_ 34,1970,Showa,45,70892,34403,36489
17 ,Ishikawa,35_ 39,1970,Showa,45,74302,35856,38446
17 ,Ishikawa,40_ 44,1970,Showa,45,70990,34306,36684
17 ,Ishikawa,45_ 49,1970,Showa,45,60773,27584,33189
17 ,Ishikawa,50_ 54,1970,Showa,45,52483,23795,28688
17 ,Ishikawa,55_ 59,1970,Showa,45,49904,22694,27210
17 ,Ishikawa,60_ 64,1970,Showa,45,42701,19766,22935
17 ,Ishikawa,65_ 69,1970,Showa,45,33706,15445,18261
17 ,Ishikawa,70_ 74,1970,Showa,45,22922,10082,12840
17 ,Ishikawa,75_ 79,1970,Showa,45,14126,5679,8447
17 ,Ishikawa,80_ 84,1970,Showa,45,7405,2578,4827
17 ,Ishikawa,over_85,1970,Showa,45,3581,997,2584
17 ,Ishikawa,total,1975,Showa,50,1069872,518594,551278
17 ,Ishikawa,0_ 4,1975,Showa,50,97506,50085,47421
17 ,Ishikawa,5_ 9,1975,Showa,50,82657,42346,40311
17 ,Ishikawa,10_ 14,1975,Showa,50,77968,39853,38115
17 ,Ishikawa,15_ 19,1975,Showa,50,74689,37628,37061
17 ,Ishikawa,20_ 24,1975,Showa,50,77868,38574,39294
17 ,Ishikawa,25_ 29,1975,Showa,50,102853,51260,51593
17 ,Ishikawa,30_ 34,1975,Showa,50,82942,41234,41708
17 ,Ishikawa,35_ 39,1975,Showa,50,71625,34952,36673
17 ,Ishikawa,40_ 44,1975,Showa,50,74549,35923,38626
17 ,Ishikawa,45_ 49,1975,Showa,50,71088,34215,36873
17 ,Ishikawa,50_ 54,1975,Showa,50,59433,26835,32598
17 ,Ishikawa,55_ 59,1975,Showa,50,50655,22857,27798
17 ,Ishikawa,60_ 64,1975,Showa,50,47988,21347,26641
17 ,Ishikawa,65_ 69,1975,Showa,50,39077,17493,21584
17 ,Ishikawa,70_ 74,1975,Showa,50,28546,12455,16091
17 ,Ishikawa,75_ 79,1975,Showa,50,17337,7040,10297
17 ,Ishikawa,80_ 84,1975,Showa,50,8712,3161,5551
17 ,Ishikawa,over_85,1975,Showa,50,4153,1196,2957
17 ,Ishikawa,total,1980,Showa,55,1119304,542782,576522
17 ,Ishikawa,0_ 4,1980,Showa,55,83466,42662,40804
17 ,Ishikawa,5_ 9,1980,Showa,55,99238,50907,48331
17 ,Ishikawa,10_ 14,1980,Showa,55,83264,42686,40578
17 ,Ishikawa,15_ 19,1980,Showa,55,75841,38550,37291
17 ,Ishikawa,20_ 24,1980,Showa,55,69244,34294,34950
17 ,Ishikawa,25_ 29,1980,Showa,55,79798,39402,40396
17 ,Ishikawa,30_ 34,1980,Showa,55,105394,52902,52492
17 ,Ishikawa,35_ 39,1980,Showa,55,83964,41795,42169
17 ,Ishikawa,40_ 44,1980,Showa,55,71322,34695,36627
17 ,Ishikawa,45_ 49,1980,Showa,55,73543,35176,38367
17 ,Ishikawa,50_ 54,1980,Showa,55,69723,33268,36455
17 ,Ishikawa,55_ 59,1980,Showa,55,57743,25775,31968
17 ,Ishikawa,60_ 64,1980,Showa,55,48526,21536,26990
17 ,Ishikawa,65_ 69,1980,Showa,55,44609,19361,25248
17 ,Ishikawa,70_ 74,1980,Showa,55,34030,14536,19494
17 ,Ishikawa,75_ 79,1980,Showa,55,22382,9037,13345
17 ,Ishikawa,80_ 84,1980,Showa,55,11122,4080,7042
17 ,Ishikawa,over_85,1980,Showa,55,5437,1651,3786
17 ,Ishikawa,total,1985,Showa,60,1152325,557664,594661
17 ,Ishikawa,0_ 4,1985,Showa,60,70341,36025,34316
17 ,Ishikawa,5_ 9,1985,Showa,60,84087,42934,41153
17 ,Ishikawa,10_ 14,1985,Showa,60,99681,51148,48533
17 ,Ishikawa,15_ 19,1985,Showa,60,81742,41528,40214
17 ,Ishikawa,20_ 24,1985,Showa,60,71219,35496,35723
17 ,Ishikawa,25_ 29,1985,Showa,60,70020,34462,35558
17 ,Ishikawa,30_ 34,1985,Showa,60,81264,40194,41070
17 ,Ishikawa,35_ 39,1985,Showa,60,106227,53257,52970
17 ,Ishikawa,40_ 44,1985,Showa,60,83906,41665,42241
17 ,Ishikawa,45_ 49,1985,Showa,60,70564,34214,36350
17 ,Ishikawa,50_ 54,1985,Showa,60,72227,34287,37940
17 ,Ishikawa,55_ 59,1985,Showa,60,68104,32150,35954
17 ,Ishikawa,60_ 64,1985,Showa,60,55899,24687,31212
17 ,Ishikawa,65_ 69,1985,Showa,60,45583,19723,25860
17 ,Ishikawa,70_ 74,1985,Showa,60,40061,16605,23456
17 ,Ishikawa,75_ 79,1985,Showa,60,28023,11148,16875
17 ,Ishikawa,80_ 84,1985,Showa,60,15458,5524,9934
17 ,Ishikawa,over_85,1985,Showa,60,7647,2427,5220
17 ,Ishikawa,total,1990,Heisei,2,1164628,562684,601944
17 ,Ishikawa,0_ 4,1990,Heisei,2,60995,31164,29831
17 ,Ishikawa,5_ 9,1990,Heisei,2,70247,35931,34316
17 ,Ishikawa,10_ 14,1990,Heisei,2,83929,42962,40967
17 ,Ishikawa,15_ 19,1990,Heisei,2,96913,49382,47531
17 ,Ishikawa,20_ 24,1990,Heisei,2,76551,38633,37918
17 ,Ishikawa,25_ 29,1990,Heisei,2,68729,33521,35208
17 ,Ishikawa,30_ 34,1990,Heisei,2,69984,34527,35457
17 ,Ishikawa,35_ 39,1990,Heisei,2,80928,39961,40967
17 ,Ishikawa,40_ 44,1990,Heisei,2,105442,52791,52651
17 ,Ishikawa,45_ 49,1990,Heisei,2,82510,40980,41530
17 ,Ishikawa,50_ 54,1990,Heisei,2,69139,33304,35835
17 ,Ishikawa,55_ 59,1990,Heisei,2,70447,32998,37449
17 ,Ishikawa,60_ 64,1990,Heisei,2,65735,30599,35136
17 ,Ishikawa,65_ 69,1990,Heisei,2,52934,22977,29957
17 ,Ishikawa,70_ 74,1990,Heisei,2,41753,17477,24276
17 ,Ishikawa,75_ 79,1990,Heisei,2,34098,13207,20891
17 ,Ishikawa,80_ 84,1990,Heisei,2,20533,7367,13166
17 ,Ishikawa,over_85,1990,Heisei,2,11374,3431,7943
17 ,Ishikawa,total,1995,Heisei,7,1180068,570835,609233
17 ,Ishikawa,0_ 4,1995,Heisei,7,56775,28933,27842
17 ,Ishikawa,5_ 9,1995,Heisei,7,62178,31746,30432
17 ,Ishikawa,10_ 14,1995,Heisei,7,70788,36164,34624
17 ,Ishikawa,15_ 19,1995,Heisei,7,83149,43079,40070
17 ,Ishikawa,20_ 24,1995,Heisei,7,93666,48281,45385
17 ,Ishikawa,25_ 29,1995,Heisei,7,74748,36883,37865
17 ,Ishikawa,30_ 34,1995,Heisei,7,70787,34847,35940
17 ,Ishikawa,35_ 39,1995,Heisei,7,71394,35303,36091
17 ,Ishikawa,40_ 44,1995,Heisei,7,81815,40616,41199
17 ,Ishikawa,45_ 49,1995,Heisei,7,105146,52656,52490
17 ,Ishikawa,50_ 54,1995,Heisei,7,81843,40541,41302
17 ,Ishikawa,55_ 59,1995,Heisei,7,68288,32653,35635
17 ,Ishikawa,60_ 64,1995,Heisei,7,68502,31770,36732
17 ,Ishikawa,65_ 69,1995,Heisei,7,62599,28519,34080
17 ,Ishikawa,70_ 74,1995,Heisei,7,48975,20492,28483
17 ,Ishikawa,75_ 79,1995,Heisei,7,36234,14231,22003
17 ,Ishikawa,80_ 84,1995,Heisei,7,25989,9097,16892
17 ,Ishikawa,over_85,1995,Heisei,7,17108,4969,12139
17 ,Ishikawa,total,2000,Heisei,12,1180977,572244,608733
17 ,Ishikawa,0_ 4,2000,Heisei,12,56639,28980,27659
17 ,Ishikawa,5_ 9,2000,Heisei,12,57145,29066,28079
17 ,Ishikawa,10_ 14,2000,Heisei,12,61785,31514,30271
17 ,Ishikawa,15_ 19,2000,Heisei,12,68890,35832,33058
17 ,Ishikawa,20_ 24,2000,Heisei,12,77759,41415,36344
17 ,Ishikawa,25_ 29,2000,Heisei,12,88659,44506,44153
17 ,Ishikawa,30_ 34,2000,Heisei,12,75042,37190,37852
17 ,Ishikawa,35_ 39,2000,Heisei,12,70798,34914,35884
17 ,Ishikawa,40_ 44,2000,Heisei,12,70697,34917,35780
17 ,Ishikawa,45_ 49,2000,Heisei,12,80278,39765,40513
17 ,Ishikawa,50_ 54,2000,Heisei,12,102844,51202,51642
17 ,Ishikawa,55_ 59,2000,Heisei,12,79743,39144,40599
17 ,Ishikawa,60_ 64,2000,Heisei,12,66427,31418,35009
17 ,Ishikawa,65_ 69,2000,Heisei,12,65235,29616,35619
17 ,Ishikawa,70_ 74,2000,Heisei,12,57890,25470,32420
17 ,Ishikawa,75_ 79,2000,Heisei,12,43317,17102,26215
17 ,Ishikawa,80_ 84,2000,Heisei,12,28739,10275,18464
17 ,Ishikawa,over_85,2000,Heisei,12,24485,6699,17786
17 ,Ishikawa,total,2005,Heisei,17,1174026,567060,606966
17 ,Ishikawa,0_ 4,2005,Heisei,17,53024,27012,26012
17 ,Ishikawa,5_ 9,2005,Heisei,17,56590,29017,27573
17 ,Ishikawa,10_ 14,2005,Heisei,17,56561,28815,27746
17 ,Ishikawa,15_ 19,2005,Heisei,17,61675,32415,29260
17 ,Ishikawa,20_ 24,2005,Heisei,17,66066,35136,30930
17 ,Ishikawa,25_ 29,2005,Heisei,17,72674,36861,35813
17 ,Ishikawa,30_ 34,2005,Heisei,17,87944,44275,43669
17 ,Ishikawa,35_ 39,2005,Heisei,17,74753,37117,37636
17 ,Ishikawa,40_ 44,2005,Heisei,17,70223,34524,35699
17 ,Ishikawa,45_ 49,2005,Heisei,17,69727,34346,35381
17 ,Ishikawa,50_ 54,2005,Heisei,17,78987,38900,40087
17 ,Ishikawa,55_ 59,2005,Heisei,17,100957,49815,51142
17 ,Ishikawa,60_ 64,2005,Heisei,17,78251,37983,40268
17 ,Ishikawa,65_ 69,2005,Heisei,17,64166,29894,34272
17 ,Ishikawa,70_ 74,2005,Heisei,17,61141,26950,34191
17 ,Ishikawa,75_ 79,2005,Heisei,17,51977,21647,30330
17 ,Ishikawa,80_ 84,2005,Heisei,17,35667,12813,22854
17 ,Ishikawa,over_85,2005,Heisei,17,32788,9001,23787
17 ,Ishikawa,total,2010,Heisei,22,1169788,564972,604816
17 ,Ishikawa,0_ 4,2010,Heisei,22,49550,25107,24443
17 ,Ishikawa,5_ 9,2010,Heisei,22,53302,27223,26079
17 ,Ishikawa,10_ 14,2010,Heisei,22,56431,28883,27548
17 ,Ishikawa,15_ 19,2010,Heisei,22,56755,29790,26965
17 ,Ishikawa,20_ 24,2010,Heisei,22,57742,30569,27173
17 ,Ishikawa,25_ 29,2010,Heisei,22,60618,30521,30097
17 ,Ishikawa,30_ 34,2010,Heisei,22,72802,36869,35933
17 ,Ishikawa,35_ 39,2010,Heisei,22,88290,44632,43658
17 ,Ishikawa,40_ 44,2010,Heisei,22,74567,36930,37637
17 ,Ishikawa,45_ 49,2010,Heisei,22,69465,34211,35254
17 ,Ishikawa,50_ 54,2010,Heisei,22,68878,33855,35023
17 ,Ishikawa,55_ 59,2010,Heisei,22,77731,37994,39737
17 ,Ishikawa,60_ 64,2010,Heisei,22,99103,48527,50576
17 ,Ishikawa,65_ 69,2010,Heisei,22,75312,36027,39285
17 ,Ishikawa,70_ 74,2010,Heisei,22,60002,27185,32817
17 ,Ishikawa,75_ 79,2010,Heisei,22,55124,23001,32123
17 ,Ishikawa,80_ 84,2010,Heisei,22,43280,16210,27070
17 ,Ishikawa,over_85,2010,Heisei,22,41619,11430,30189
17 ,Ishikawa,total,2015,Heisei,27,1154008,558589,595419
17 ,Ishikawa,0_ 4,2015,Heisei,27,45642,23287,22355
17 ,Ishikawa,5_ 9,2015,Heisei,27,49670,25164,24506
17 ,Ishikawa,10_ 14,2015,Heisei,27,53060,27133,25927
17 ,Ishikawa,15_ 19,2015,Heisei,27,57473,30055,27418
17 ,Ishikawa,20_ 24,2015,Heisei,27,54552,28932,25620
17 ,Ishikawa,25_ 29,2015,Heisei,27,54125,27831,26294
17 ,Ishikawa,30_ 34,2015,Heisei,27,60143,30420,29723
17 ,Ishikawa,35_ 39,2015,Heisei,27,72581,36696,35885
17 ,Ishikawa,40_ 44,2015,Heisei,27,87967,44385,43582
17 ,Ishikawa,45_ 49,2015,Heisei,27,73829,36698,37131
17 ,Ishikawa,50_ 54,2015,Heisei,27,68362,33653,34709
17 ,Ishikawa,55_ 59,2015,Heisei,27,67644,33115,34529
17 ,Ishikawa,60_ 64,2015,Heisei,27,75839,36842,38997
17 ,Ishikawa,65_ 69,2015,Heisei,27,95296,46110,49186
17 ,Ishikawa,70_ 74,2015,Heisei,27,70655,33010,37645
17 ,Ishikawa,75_ 79,2015,Heisei,27,54466,23722,30744
17 ,Ishikawa,80_ 84,2015,Heisei,27,46346,17754,28592
17 ,Ishikawa,over_85,2015,Heisei,27,50388,14344,36044
18 ,Fukui,total,1920,Taisho,9,599155,293181,305974
18 ,Fukui,0_ 4,1920,Taisho,9,79068,39696,39372
18 ,Fukui,5_ 9,1920,Taisho,9,77200,39390,37810
18 ,Fukui,10_ 14,1920,Taisho,9,66793,33955,32838
18 ,Fukui,15_ 19,1920,Taisho,9,51775,25478,26297
18 ,Fukui,20_ 24,1920,Taisho,9,41723,20364,21359
18 ,Fukui,25_ 29,1920,Taisho,9,37033,18229,18804
18 ,Fukui,30_ 34,1920,Taisho,9,35562,17440,18122
18 ,Fukui,35_ 39,1920,Taisho,9,36817,17687,19130
18 ,Fukui,40_ 44,1920,Taisho,9,36813,18047,18766
18 ,Fukui,45_ 49,1920,Taisho,9,28600,13851,14749
18 ,Fukui,50_ 54,1920,Taisho,9,24958,11950,13008
18 ,Fukui,55_ 59,1920,Taisho,9,20559,9714,10845
18 ,Fukui,60_ 64,1920,Taisho,9,20500,9578,10922
18 ,Fukui,65_ 69,1920,Taisho,9,18373,8295,10078
18 ,Fukui,70_ 74,1920,Taisho,9,13184,5684,7500
18 ,Fukui,75_ 79,1920,Taisho,9,7012,2761,4251
18 ,Fukui,over_80,1920,Taisho,9,3185,1062,2123
18 ,Fukui,total,1925,Taisho,14,597899,293039,304860
18 ,Fukui,0_ 4,1925,Taisho,14,80705,40638,40067
18 ,Fukui,5_ 9,1925,Taisho,14,71337,36094,35243
18 ,Fukui,10_ 14,1925,Taisho,14,69862,35736,34126
18 ,Fukui,15_ 19,1925,Taisho,14,50981,25030,25951
18 ,Fukui,20_ 24,1925,Taisho,14,44265,21972,22293
18 ,Fukui,25_ 29,1925,Taisho,14,37226,18519,18707
18 ,Fukui,30_ 34,1925,Taisho,14,34002,16810,17192
18 ,Fukui,35_ 39,1925,Taisho,14,33081,16157,16924
18 ,Fukui,40_ 44,1925,Taisho,14,34155,16518,17637
18 ,Fukui,45_ 49,1925,Taisho,14,34466,16860,17606
18 ,Fukui,50_ 54,1925,Taisho,14,26198,12561,13637
18 ,Fukui,55_ 59,1925,Taisho,14,22243,10471,11772
18 ,Fukui,60_ 64,1925,Taisho,14,17732,8207,9525
18 ,Fukui,65_ 69,1925,Taisho,14,16441,7422,9019
18 ,Fukui,70_ 74,1925,Taisho,14,13206,5624,7582
18 ,Fukui,75_ 79,1925,Taisho,14,7858,3038,4820
18 ,Fukui,80_ 84,1925,Taisho,14,3257,1141,2116
18 ,Fukui,over_85,1925,Taisho,14,884,241,643
18 ,Fukui,total,1930,Showa,5,618144,304525,313619
18 ,Fukui,0_ 4,1930,Showa,5,81361,41209,40152
18 ,Fukui,5_ 9,1930,Showa,5,75167,37982,37185
18 ,Fukui,10_ 14,1930,Showa,5,66721,33700,33021
18 ,Fukui,15_ 19,1930,Showa,5,56256,27418,28838
18 ,Fukui,20_ 24,1930,Showa,5,48431,24335,24096
18 ,Fukui,25_ 29,1930,Showa,5,41854,21247,20607
18 ,Fukui,30_ 34,1930,Showa,5,36301,18502,17799
18 ,Fukui,35_ 39,1930,Showa,5,33084,16565,16519
18 ,Fukui,40_ 44,1930,Showa,5,31863,15755,16108
18 ,Fukui,45_ 49,1930,Showa,5,32457,15706,16751
18 ,Fukui,50_ 54,1930,Showa,5,32135,15683,16452
18 ,Fukui,55_ 59,1930,Showa,5,23864,11304,12560
18 ,Fukui,60_ 64,1930,Showa,5,19357,8924,10433
18 ,Fukui,65_ 69,1930,Showa,5,14394,6384,8010
18 ,Fukui,70_ 74,1930,Showa,5,11879,5062,6817
18 ,Fukui,75_ 79,1930,Showa,5,8056,3123,4933
18 ,Fukui,over_80,1930,Showa,5,4964,1626,3338
18 ,Fukui,total,1935,Showa,10,646659,316424,330235
18 ,Fukui,0_ 4,1935,Showa,10,81509,41410,40099
18 ,Fukui,5_ 9,1935,Showa,10,77011,39123,37888
18 ,Fukui,10_ 14,1935,Showa,10,73870,36412,37458
18 ,Fukui,15_ 19,1935,Showa,10,57678,26651,31027
18 ,Fukui,20_ 24,1935,Showa,10,52686,25167,27519
18 ,Fukui,25_ 29,1935,Showa,10,46321,23287,23034
18 ,Fukui,30_ 34,1935,Showa,10,40889,20914,19975
18 ,Fukui,35_ 39,1935,Showa,10,35237,18059,17178
18 ,Fukui,40_ 44,1935,Showa,10,31713,16124,15589
18 ,Fukui,45_ 49,1935,Showa,10,30265,15020,15245
18 ,Fukui,50_ 54,1935,Showa,10,30415,14618,15797
18 ,Fukui,55_ 59,1935,Showa,10,29375,14190,15185
18 ,Fukui,60_ 64,1935,Showa,10,21009,9712,11297
18 ,Fukui,65_ 69,1935,Showa,10,15785,6900,8885
18 ,Fukui,70_ 74,1935,Showa,10,10566,4374,6192
18 ,Fukui,75_ 79,1935,Showa,10,7119,2738,4381
18 ,Fukui,over_80,1935,Showa,10,5211,1725,3486
18 ,Fukui,total,1940,Showa,15,643815,312017,331798
18 ,Fukui,0_ 4,1940,Showa,15,76070,38444,37626
18 ,Fukui,5_ 9,1940,Showa,15,75625,38491,37134
18 ,Fukui,10_ 14,1940,Showa,15,74317,36749,37568
18 ,Fukui,15_ 19,1940,Showa,15,59753,26686,33067
18 ,Fukui,20_ 24,1940,Showa,15,49675,24042,25633
18 ,Fukui,25_ 29,1940,Showa,15,46441,22258,24183
18 ,Fukui,30_ 34,1940,Showa,15,41745,20443,21302
18 ,Fukui,35_ 39,1940,Showa,15,37783,19005,18778
18 ,Fukui,40_ 44,1940,Showa,15,32819,16622,16197
18 ,Fukui,45_ 49,1940,Showa,15,29556,14790,14766
18 ,Fukui,50_ 54,1940,Showa,15,27933,13708,14225
18 ,Fukui,55_ 59,1940,Showa,15,27494,12896,14598
18 ,Fukui,60_ 64,1940,Showa,15,25434,11906,13528
18 ,Fukui,65_ 69,1940,Showa,15,16884,7467,9417
18 ,Fukui,70_ 74,1940,Showa,15,11365,4623,6742
18 ,Fukui,75_ 79,1940,Showa,15,6375,2421,3954
18 ,Fukui,80_ 84,1940,Showa,15,3153,1048,2105
18 ,Fukui,over_85,1940,Showa,15,1393,418,975
18 ,Fukui,total,1945,Showa,20,724856,332461,392395
18 ,Fukui,1_ 5,1945,Showa,20,92769,46757,46012
18 ,Fukui,6_ 10,1945,Showa,20,83945,42517,41428
18 ,Fukui,11_ 15,1945,Showa,20,86053,43409,42644
18 ,Fukui,16_ 20,1945,Showa,20,74762,35670,39092
18 ,Fukui,21_ 25,1945,Showa,20,52704,18451,34253
18 ,Fukui,26_ 30,1945,Showa,20,41589,13147,28442
18 ,Fukui,31_ 35,1945,Showa,20,43555,15658,27897
18 ,Fukui,36_ 40,1945,Showa,20,43768,19424,24344
18 ,Fukui,41_ 45,1945,Showa,20,40812,20017,20795
18 ,Fukui,46_ 50,1945,Showa,20,35357,17901,17456
18 ,Fukui,51_ 55,1945,Showa,20,30634,15280,15354
18 ,Fukui,56_ 60,1945,Showa,20,28221,13766,14455
18 ,Fukui,61_ 65,1945,Showa,20,25396,11648,13748
18 ,Fukui,66_ 70,1945,Showa,20,21753,9663,12090
18 ,Fukui,71_ 75,1945,Showa,20,13139,5443,7696
18 ,Fukui,76_ 80,1945,Showa,20,6534,2416,4118
18 ,Fukui,81_ 85,1945,Showa,20,2863,994,1869
18 ,Fukui,86以上,1945,Showa,20,1002,300,702
18 ,Fukui,total,1950,Showa,25,752374,364343,388031
18 ,Fukui,0_ 4,1950,Showa,25,98639,50549,48090
18 ,Fukui,5_ 9,1950,Showa,25,82994,42136,40858
18 ,Fukui,10_ 14,1950,Showa,25,77006,39129,37877
18 ,Fukui,15_ 19,1950,Showa,25,75189,37228,37961
18 ,Fukui,20_ 24,1950,Showa,25,66440,32407,34033
18 ,Fukui,25_ 29,1950,Showa,25,53010,23230,29780
18 ,Fukui,30_ 34,1950,Showa,25,45957,20329,25628
18 ,Fukui,35_ 39,1950,Showa,25,45379,20514,24865
18 ,Fukui,40_ 44,1950,Showa,25,41694,20078,21616
18 ,Fukui,45_ 49,1950,Showa,25,37318,18765,18553
18 ,Fukui,50_ 54,1950,Showa,25,31119,15806,15313
18 ,Fukui,55_ 59,1950,Showa,25,27061,13472,13589
18 ,Fukui,60_ 64,1950,Showa,25,23479,11141,12338
18 ,Fukui,65_ 69,1950,Showa,25,19739,8750,10989
18 ,Fukui,70_ 74,1950,Showa,25,15446,6503,8943
18 ,Fukui,75_ 79,1950,Showa,25,7720,2988,4732
18 ,Fukui,over_80,1950,Showa,25,4156,1312,2844
18 ,Fukui,total,1955,Showa,30,754055,363770,390285
18 ,Fukui,0_ 4,1955,Showa,30,77295,39622,37673
18 ,Fukui,5_ 9,1955,Showa,30,93512,47830,45682
18 ,Fukui,10_ 14,1955,Showa,30,80404,40874,39530
18 ,Fukui,15_ 19,1955,Showa,30,63982,30651,33331
18 ,Fukui,20_ 24,1955,Showa,30,62093,29224,32869
18 ,Fukui,25_ 29,1955,Showa,30,61405,30435,30970
18 ,Fukui,30_ 34,1955,Showa,30,49915,22013,27902
18 ,Fukui,35_ 39,1955,Showa,30,43281,19012,24269
18 ,Fukui,40_ 44,1955,Showa,30,42996,19309,23687
18 ,Fukui,45_ 49,1955,Showa,30,39432,18981,20451
18 ,Fukui,50_ 54,1955,Showa,30,34985,17555,17430
18 ,Fukui,55_ 59,1955,Showa,30,28948,14564,14384
18 ,Fukui,60_ 64,1955,Showa,30,24259,11905,12354
18 ,Fukui,65_ 69,1955,Showa,30,19882,9156,10726
18 ,Fukui,70_ 74,1955,Showa,30,15529,6587,8942
18 ,Fukui,75_ 79,1955,Showa,30,10458,4108,6350
18 ,Fukui,80_ 84,1955,Showa,30,4219,1506,2713
18 ,Fukui,over_85,1955,Showa,30,1454,433,1021
18 ,Fukui,total,1960,Showa,35,752696,360288,392408
18 ,Fukui,0_ 4,1960,Showa,35,63078,32396,30682
18 ,Fukui,5_ 9,1960,Showa,35,75954,38883,37071
18 ,Fukui,10_ 14,1960,Showa,35,91918,46947,44971
18 ,Fukui,15_ 19,1960,Showa,35,67528,31229,36299
18 ,Fukui,20_ 24,1960,Showa,35,53112,23673,29439
18 ,Fukui,25_ 29,1960,Showa,35,59279,28785,30494
18 ,Fukui,30_ 34,1960,Showa,35,59459,29674,29785
18 ,Fukui,35_ 39,1960,Showa,35,48317,21296,27021
18 ,Fukui,40_ 44,1960,Showa,35,41844,18431,23413
18 ,Fukui,45_ 49,1960,Showa,35,41284,18471,22813
18 ,Fukui,50_ 54,1960,Showa,35,37449,17933,19516
18 ,Fukui,55_ 59,1960,Showa,35,32843,16305,16538
18 ,Fukui,60_ 64,1960,Showa,35,26184,12941,13243
18 ,Fukui,65_ 69,1960,Showa,35,20929,9946,10983
18 ,Fukui,70_ 74,1960,Showa,35,15565,6790,8775
18 ,Fukui,75_ 79,1960,Showa,35,10426,4046,6380
18 ,Fukui,80_ 84,1960,Showa,35,5584,1949,3635
18 ,Fukui,over_85,1960,Showa,35,1943,593,1350
18 ,Fukui,total,1965,Showa,40,750557,359649,390908
18 ,Fukui,0_ 4,1965,Showa,40,60016,30710,29306
18 ,Fukui,5_ 9,1965,Showa,40,62266,31742,30524
18 ,Fukui,10_ 14,1965,Showa,40,74677,38053,36624
18 ,Fukui,15_ 19,1965,Showa,40,80101,38545,41556
18 ,Fukui,20_ 24,1965,Showa,40,53419,23780,29639
18 ,Fukui,25_ 29,1965,Showa,40,51796,24777,27019
18 ,Fukui,30_ 34,1965,Showa,40,58308,28677,29631
18 ,Fukui,35_ 39,1965,Showa,40,58343,29243,29100
18 ,Fukui,40_ 44,1965,Showa,40,47284,20954,26330
18 ,Fukui,45_ 49,1965,Showa,40,40671,17990,22681
18 ,Fukui,50_ 54,1965,Showa,40,39520,17704,21816
18 ,Fukui,55_ 59,1965,Showa,40,35314,16887,18427
18 ,Fukui,60_ 64,1965,Showa,40,30064,14729,15335
18 ,Fukui,65_ 69,1965,Showa,40,22934,11036,11898
18 ,Fukui,70_ 74,1965,Showa,40,16876,7733,9143
18 ,Fukui,75_ 79,1965,Showa,40,10817,4416,6401
18 ,Fukui,80_ 84,1965,Showa,40,5511,1928,3583
18 ,Fukui,over_85,1965,Showa,40,2640,745,1895
18 ,Fukui,total,1970,Showa,45,744230,356639,387591
18 ,Fukui,0_ 4,1970,Showa,45,56538,28904,27634
18 ,Fukui,5_ 9,1970,Showa,45,59804,30617,29187
18 ,Fukui,10_ 14,1970,Showa,45,61714,31572,30142
18 ,Fukui,15_ 19,1970,Showa,45,63585,30996,32589
18 ,Fukui,20_ 24,1970,Showa,45,62001,28405,33596
18 ,Fukui,25_ 29,1970,Showa,45,53368,26139,27229
18 ,Fukui,30_ 34,1970,Showa,45,51368,24752,26616
18 ,Fukui,35_ 39,1970,Showa,45,57308,28033,29275
18 ,Fukui,40_ 44,1970,Showa,45,56586,28222,28364
18 ,Fukui,45_ 49,1970,Showa,45,46008,20283,25725
18 ,Fukui,50_ 54,1970,Showa,45,39287,17241,22046
18 ,Fukui,55_ 59,1970,Showa,45,37129,16489,20640
18 ,Fukui,60_ 64,1970,Showa,45,32502,15226,17276
18 ,Fukui,65_ 69,1970,Showa,45,26550,12612,13938
18 ,Fukui,70_ 74,1970,Showa,45,18905,8716,10189
18 ,Fukui,75_ 79,1970,Showa,45,12237,5146,7091
18 ,Fukui,80_ 84,1970,Showa,45,6331,2376,3955
18 ,Fukui,over_85,1970,Showa,45,3009,910,2099
18 ,Fukui,total,1975,Showa,50,773599,373416,400183
18 ,Fukui,0_ 4,1975,Showa,50,65161,33285,31876
18 ,Fukui,5_ 9,1975,Showa,50,57604,29469,28135
18 ,Fukui,10_ 14,1975,Showa,50,59905,30661,29244
18 ,Fukui,15_ 19,1975,Showa,50,54930,27613,27317
18 ,Fukui,20_ 24,1975,Showa,50,52491,24610,27881
18 ,Fukui,25_ 29,1975,Showa,50,65901,32749,33152
18 ,Fukui,30_ 34,1975,Showa,50,55384,27585,27799
18 ,Fukui,35_ 39,1975,Showa,50,51736,25123,26613
18 ,Fukui,40_ 44,1975,Showa,50,57174,28128,29046
18 ,Fukui,45_ 49,1975,Showa,50,56291,28062,28229
18 ,Fukui,50_ 54,1975,Showa,50,44955,19695,25260
18 ,Fukui,55_ 59,1975,Showa,50,37878,16422,21456
18 ,Fukui,60_ 64,1975,Showa,50,35738,15695,20043
18 ,Fukui,65_ 69,1975,Showa,50,29999,13734,16265
18 ,Fukui,70_ 74,1975,Showa,50,22848,10404,12444
18 ,Fukui,75_ 79,1975,Showa,50,14384,6164,8220
18 ,Fukui,80_ 84,1975,Showa,50,7555,2855,4700
18 ,Fukui,over_85,1975,Showa,50,3563,1104,2459
18 ,Fukui,total,1980,Showa,55,794354,384269,410085
18 ,Fukui,0_ 4,1980,Showa,55,57358,29330,28028
18 ,Fukui,5_ 9,1980,Showa,55,66108,33748,32360
18 ,Fukui,10_ 14,1980,Showa,55,58030,29684,28346
18 ,Fukui,15_ 19,1980,Showa,55,53723,27288,26435
18 ,Fukui,20_ 24,1980,Showa,55,45790,21944,23846
18 ,Fukui,25_ 29,1980,Showa,55,56609,28035,28574
18 ,Fukui,30_ 34,1980,Showa,55,67317,34030,33287
18 ,Fukui,35_ 39,1980,Showa,55,55551,27635,27916
18 ,Fukui,40_ 44,1980,Showa,55,51289,24878,26411
18 ,Fukui,45_ 49,1980,Showa,55,56039,27359,28680
18 ,Fukui,50_ 54,1980,Showa,55,55055,27207,27848
18 ,Fukui,55_ 59,1980,Showa,55,43681,18951,24730
18 ,Fukui,60_ 64,1980,Showa,55,36132,15505,20627
18 ,Fukui,65_ 69,1980,Showa,55,33087,14168,18919
18 ,Fukui,70_ 74,1980,Showa,55,26246,11582,14664
18 ,Fukui,75_ 79,1980,Showa,55,17974,7646,10328
18 ,Fukui,80_ 84,1980,Showa,55,9497,3756,5741
18 ,Fukui,over_85,1980,Showa,55,4791,1478,3313
18 ,Fukui,total,1985,Showa,60,817633,397115,420518
18 ,Fukui,0_ 4,1985,Showa,60,51542,26333,25209
18 ,Fukui,5_ 9,1985,Showa,60,58295,29760,28535
18 ,Fukui,10_ 14,1985,Showa,60,66298,33891,32407
18 ,Fukui,15_ 19,1985,Showa,60,53831,27442,26389
18 ,Fukui,20_ 24,1985,Showa,60,47128,23002,24126
18 ,Fukui,25_ 29,1985,Showa,60,50777,25238,25539
18 ,Fukui,30_ 34,1985,Showa,60,58623,29597,29026
18 ,Fukui,35_ 39,1985,Showa,60,68372,34836,33536
18 ,Fukui,40_ 44,1985,Showa,60,55681,27921,27760
18 ,Fukui,45_ 49,1985,Showa,60,51038,24879,26159
18 ,Fukui,50_ 54,1985,Showa,60,55264,26933,28331
18 ,Fukui,55_ 59,1985,Showa,60,53765,26388,27377
18 ,Fukui,60_ 64,1985,Showa,60,42200,18084,24116
18 ,Fukui,65_ 69,1985,Showa,60,33981,14352,19629
18 ,Fukui,70_ 74,1985,Showa,60,29817,12312,17505
18 ,Fukui,75_ 79,1985,Showa,60,21621,8997,12624
18 ,Fukui,80_ 84,1985,Showa,60,12658,4929,7729
18 ,Fukui,over_85,1985,Showa,60,6717,2207,4510
18 ,Fukui,total,1990,Heisei,2,823585,400391,423194
18 ,Fukui,0_ 4,1990,Heisei,2,46287,23758,22529
18 ,Fukui,5_ 9,1990,Heisei,2,51758,26435,25323
18 ,Fukui,10_ 14,1990,Heisei,2,57953,29490,28463
18 ,Fukui,15_ 19,1990,Heisei,2,60539,31054,29485
18 ,Fukui,20_ 24,1990,Heisei,2,45657,22555,23102
18 ,Fukui,25_ 29,1990,Heisei,2,49521,24566,24955
18 ,Fukui,30_ 34,1990,Heisei,2,51307,25723,25584
18 ,Fukui,35_ 39,1990,Heisei,2,58810,29797,29013
18 ,Fukui,40_ 44,1990,Heisei,2,68130,34872,33258
18 ,Fukui,45_ 49,1990,Heisei,2,54933,27635,27298
18 ,Fukui,50_ 54,1990,Heisei,2,50269,24451,25818
18 ,Fukui,55_ 59,1990,Heisei,2,54094,26216,27878
18 ,Fukui,60_ 64,1990,Heisei,2,52037,25172,26865
18 ,Fukui,65_ 69,1990,Heisei,2,39873,16773,23100
18 ,Fukui,70_ 74,1990,Heisei,2,31140,12651,18489
18 ,Fukui,75_ 79,1990,Heisei,2,25372,9818,15554
18 ,Fukui,80_ 84,1990,Heisei,2,15861,6001,9860
18 ,Fukui,over_85,1990,Heisei,2,9694,3179,6515
18 ,Fukui,total,1995,Heisei,7,826996,401860,425136
18 ,Fukui,0_ 4,1995,Heisei,7,42120,21787,20333
18 ,Fukui,5_ 9,1995,Heisei,7,46805,24011,22794
18 ,Fukui,10_ 14,1995,Heisei,7,51668,26355,25313
18 ,Fukui,15_ 19,1995,Heisei,7,53405,27838,25567
18 ,Fukui,20_ 24,1995,Heisei,7,53589,27526,26063
18 ,Fukui,25_ 29,1995,Heisei,7,48866,24230,24636
18 ,Fukui,30_ 34,1995,Heisei,7,50538,25179,25359
18 ,Fukui,35_ 39,1995,Heisei,7,51669,25886,25783
18 ,Fukui,40_ 44,1995,Heisei,7,58654,29652,29002
18 ,Fukui,45_ 49,1995,Heisei,7,67321,34209,33112
18 ,Fukui,50_ 54,1995,Heisei,7,54189,26950,27239
18 ,Fukui,55_ 59,1995,Heisei,7,49195,23557,25638
18 ,Fukui,60_ 64,1995,Heisei,7,52166,24791,27375
18 ,Fukui,65_ 69,1995,Heisei,7,49478,23425,26053
18 ,Fukui,70_ 74,1995,Heisei,7,36992,14958,22034
18 ,Fukui,75_ 79,1995,Heisei,7,27134,10390,16744
18 ,Fukui,80_ 84,1995,Heisei,7,19509,6842,12667
18 ,Fukui,over_85,1995,Heisei,7,13615,4216,9399
18 ,Fukui,total,2000,Heisei,12,828944,402367,426577
18 ,Fukui,0_ 4,2000,Heisei,12,40944,20873,20071
18 ,Fukui,5_ 9,2000,Heisei,12,42415,21968,20447
18 ,Fukui,10_ 14,2000,Heisei,12,46784,23965,22819
18 ,Fukui,15_ 19,2000,Heisei,12,47453,24580,22873
18 ,Fukui,20_ 24,2000,Heisei,12,46436,24053,22383
18 ,Fukui,25_ 29,2000,Heisei,12,56914,28828,28086
18 ,Fukui,30_ 34,2000,Heisei,12,49882,24933,24949
18 ,Fukui,35_ 39,2000,Heisei,12,50810,25343,25467
18 ,Fukui,40_ 44,2000,Heisei,12,51669,25919,25750
18 ,Fukui,45_ 49,2000,Heisei,12,58053,29282,28771
18 ,Fukui,50_ 54,2000,Heisei,12,66466,33675,32791
18 ,Fukui,55_ 59,2000,Heisei,12,53297,26316,26981
18 ,Fukui,60_ 64,2000,Heisei,12,48037,22696,25341
18 ,Fukui,65_ 69,2000,Heisei,12,49822,23158,26664
18 ,Fukui,70_ 74,2000,Heisei,12,45875,21009,24866
18 ,Fukui,75_ 79,2000,Heisei,12,32946,12567,20379
18 ,Fukui,80_ 84,2000,Heisei,12,21775,7563,14212
18 ,Fukui,over_85,2000,Heisei,12,19071,5425,13646
18 ,Fukui,total,2005,Heisei,17,821592,397271,424321
18 ,Fukui,0_ 4,2005,Heisei,17,37428,19185,18243
18 ,Fukui,5_ 9,2005,Heisei,17,41051,20973,20078
18 ,Fukui,10_ 14,2005,Heisei,17,42266,21910,20356
18 ,Fukui,15_ 19,2005,Heisei,17,42642,21989,20653
18 ,Fukui,20_ 24,2005,Heisei,17,40231,20101,20130
18 ,Fukui,25_ 29,2005,Heisei,17,48789,24665,24124
18 ,Fukui,30_ 34,2005,Heisei,17,56934,28952,27982
18 ,Fukui,35_ 39,2005,Heisei,17,49652,24674,24978
18 ,Fukui,40_ 44,2005,Heisei,17,50400,25084,25316
18 ,Fukui,45_ 49,2005,Heisei,17,50898,25482,25416
18 ,Fukui,50_ 54,2005,Heisei,17,57178,28638,28540
18 ,Fukui,55_ 59,2005,Heisei,17,65184,32770,32414
18 ,Fukui,60_ 64,2005,Heisei,17,51950,25242,26708
18 ,Fukui,65_ 69,2005,Heisei,17,46086,21429,24657
18 ,Fukui,70_ 74,2005,Heisei,17,46514,21025,25489
18 ,Fukui,75_ 79,2005,Heisei,17,41045,17890,23155
18 ,Fukui,80_ 84,2005,Heisei,17,27267,9560,17707
18 ,Fukui,over_85,2005,Heisei,17,24589,6556,18033
18 ,Fukui,total,2010,Heisei,22,806314,389712,416602
18 ,Fukui,0_ 4,2010,Heisei,22,34634,17782,16852
18 ,Fukui,5_ 9,2010,Heisei,22,37062,19003,18059
18 ,Fukui,10_ 14,2010,Heisei,22,40496,20712,19784
18 ,Fukui,15_ 19,2010,Heisei,22,38693,20255,18438
18 ,Fukui,20_ 24,2010,Heisei,22,34902,17528,17374
18 ,Fukui,25_ 29,2010,Heisei,22,40594,20368,20226
18 ,Fukui,30_ 34,2010,Heisei,22,47851,24355,23496
18 ,Fukui,35_ 39,2010,Heisei,22,55484,28198,27286
18 ,Fukui,40_ 44,2010,Heisei,22,48618,24048,24570
18 ,Fukui,45_ 49,2010,Heisei,22,49439,24496,24943
18 ,Fukui,50_ 54,2010,Heisei,22,49935,24835,25100
18 ,Fukui,55_ 59,2010,Heisei,22,56140,27888,28252
18 ,Fukui,60_ 64,2010,Heisei,22,63753,31741,32012
18 ,Fukui,65_ 69,2010,Heisei,22,49933,24009,25924
18 ,Fukui,70_ 74,2010,Heisei,22,43413,19667,23746
18 ,Fukui,75_ 79,2010,Heisei,22,42042,18095,23947
18 ,Fukui,80_ 84,2010,Heisei,22,34195,13666,20529
18 ,Fukui,over_85,2010,Heisei,22,31359,8404,22955
18 ,Fukui,total,2015,Heisei,27,786740,381474,405266
18 ,Fukui,0_ 4,2015,Heisei,27,31183,15997,15186
18 ,Fukui,5_ 9,2015,Heisei,27,34772,17835,16937
18 ,Fukui,10_ 14,2015,Heisei,27,37031,18964,18067
18 ,Fukui,15_ 19,2015,Heisei,27,38113,19713,18400
18 ,Fukui,20_ 24,2015,Heisei,27,32689,17115,15574
18 ,Fukui,25_ 29,2015,Heisei,27,36288,18638,17650
18 ,Fukui,30_ 34,2015,Heisei,27,40738,20513,20225
18 ,Fukui,35_ 39,2015,Heisei,27,47627,24186,23441
18 ,Fukui,40_ 44,2015,Heisei,27,55078,27863,27215
18 ,Fukui,45_ 49,2015,Heisei,27,48011,23820,24191
18 ,Fukui,50_ 54,2015,Heisei,27,48745,24168,24577
18 ,Fukui,55_ 59,2015,Heisei,27,49215,24423,24792
18 ,Fukui,60_ 64,2015,Heisei,27,54905,27119,27786
18 ,Fukui,65_ 69,2015,Heisei,27,61484,30255,31229
18 ,Fukui,70_ 74,2015,Heisei,27,47068,22221,24847
18 ,Fukui,75_ 79,2015,Heisei,27,39340,17177,22163
18 ,Fukui,80_ 84,2015,Heisei,27,35292,14147,21145
18 ,Fukui,over_85,2015,Heisei,27,39224,11885,27339
19 ,Yamanashi,total,1920,Taisho,9,583453,290817,292636
19 ,Yamanashi,0_ 4,1920,Taisho,9,86222,43178,43044
19 ,Yamanashi,5_ 9,1920,Taisho,9,78685,39574,39111
19 ,Yamanashi,10_ 14,1920,Taisho,9,64766,34416,30350
19 ,Yamanashi,15_ 19,1920,Taisho,9,49972,26371,23601
19 ,Yamanashi,20_ 24,1920,Taisho,9,40635,20035,20600
19 ,Yamanashi,25_ 29,1920,Taisho,9,36460,17680,18780
19 ,Yamanashi,30_ 34,1920,Taisho,9,37442,17977,19465
19 ,Yamanashi,35_ 39,1920,Taisho,9,35625,17112,18513
19 ,Yamanashi,40_ 44,1920,Taisho,9,34425,16936,17489
19 ,Yamanashi,45_ 49,1920,Taisho,9,27177,13530,13647
19 ,Yamanashi,50_ 54,1920,Taisho,9,22075,11108,10967
19 ,Yamanashi,55_ 59,1920,Taisho,9,20332,9995,10337
19 ,Yamanashi,60_ 64,1920,Taisho,9,17383,8345,9038
19 ,Yamanashi,65_ 69,1920,Taisho,9,14506,6859,7647
19 ,Yamanashi,70_ 74,1920,Taisho,9,9795,4471,5324
19 ,Yamanashi,75_ 79,1920,Taisho,9,5214,2204,3010
19 ,Yamanashi,over_80,1920,Taisho,9,2739,1026,1713
19 ,Yamanashi,total,1925,Taisho,14,600675,300289,300386
19 ,Yamanashi,0_ 4,1925,Taisho,14,88498,44687,43811
19 ,Yamanashi,5_ 9,1925,Taisho,14,79032,39557,39475
19 ,Yamanashi,10_ 14,1925,Taisho,14,69708,37031,32677
19 ,Yamanashi,15_ 19,1925,Taisho,14,52037,27719,24318
19 ,Yamanashi,20_ 24,1925,Taisho,14,43722,21505,22217
19 ,Yamanashi,25_ 29,1925,Taisho,14,37907,18711,19196
19 ,Yamanashi,30_ 34,1925,Taisho,14,34261,16913,17348
19 ,Yamanashi,35_ 39,1925,Taisho,14,35264,17122,18142
19 ,Yamanashi,40_ 44,1925,Taisho,14,33285,16170,17115
19 ,Yamanashi,45_ 49,1925,Taisho,14,32086,15835,16251
19 ,Yamanashi,50_ 54,1925,Taisho,14,24794,12291,12503
19 ,Yamanashi,55_ 59,1925,Taisho,14,19579,9655,9924
19 ,Yamanashi,60_ 64,1925,Taisho,14,17347,8346,9001
19 ,Yamanashi,65_ 69,1925,Taisho,14,13755,6441,7314
19 ,Yamanashi,70_ 74,1925,Taisho,14,10338,4626,5712
19 ,Yamanashi,75_ 79,1925,Taisho,14,5817,2476,3341
19 ,Yamanashi,80_ 84,1925,Taisho,14,2414,925,1489
19 ,Yamanashi,over_85,1925,Taisho,14,831,279,552
19 ,Yamanashi,total,1930,Showa,5,631042,315327,315715
19 ,Yamanashi,0_ 4,1930,Showa,5,93657,47326,46331
19 ,Yamanashi,5_ 9,1930,Showa,5,83393,42055,41338
19 ,Yamanashi,10_ 14,1930,Showa,5,71005,37123,33882
19 ,Yamanashi,15_ 19,1930,Showa,5,56315,29925,26390
19 ,Yamanashi,20_ 24,1930,Showa,5,47636,23573,24063
19 ,Yamanashi,25_ 29,1930,Showa,5,42470,20974,21496
19 ,Yamanashi,30_ 34,1930,Showa,5,36623,18330,18293
19 ,Yamanashi,35_ 39,1930,Showa,5,32750,16126,16624
19 ,Yamanashi,40_ 44,1930,Showa,5,33518,16465,17053
19 ,Yamanashi,45_ 49,1930,Showa,5,31339,15243,16096
19 ,Yamanashi,50_ 54,1930,Showa,5,29388,14449,14939
19 ,Yamanashi,55_ 59,1930,Showa,5,22285,10882,11403
19 ,Yamanashi,60_ 64,1930,Showa,5,16771,8038,8733
19 ,Yamanashi,65_ 69,1930,Showa,5,13932,6485,7447
19 ,Yamanashi,70_ 74,1930,Showa,5,9942,4364,5578
19 ,Yamanashi,75_ 79,1930,Showa,5,6316,2633,3683
19 ,Yamanashi,over_80,1930,Showa,5,3702,1336,2366
19 ,Yamanashi,total,1935,Showa,10,646727,319924,326803
19 ,Yamanashi,0_ 4,1935,Showa,10,93143,47029,46114
19 ,Yamanashi,5_ 9,1935,Showa,10,88368,44642,43726
19 ,Yamanashi,10_ 14,1935,Showa,10,75034,38684,36350
19 ,Yamanashi,15_ 19,1935,Showa,10,52869,26750,26119
19 ,Yamanashi,20_ 24,1935,Showa,10,48020,22870,25150
19 ,Yamanashi,25_ 29,1935,Showa,10,43651,21234,22417
19 ,Yamanashi,30_ 34,1935,Showa,10,39978,19766,20212
19 ,Yamanashi,35_ 39,1935,Showa,10,34671,17411,17260
19 ,Yamanashi,40_ 44,1935,Showa,10,31011,15366,15645
19 ,Yamanashi,45_ 49,1935,Showa,10,31492,15472,16020
19 ,Yamanashi,50_ 54,1935,Showa,10,28796,13967,14829
19 ,Yamanashi,55_ 59,1935,Showa,10,26670,12978,13692
19 ,Yamanashi,60_ 64,1935,Showa,10,19126,9138,9988
19 ,Yamanashi,65_ 69,1935,Showa,10,13525,6230,7295
19 ,Yamanashi,70_ 74,1935,Showa,10,10069,4426,5643
19 ,Yamanashi,75_ 79,1935,Showa,10,6092,2455,3637
19 ,Yamanashi,over_80,1935,Showa,10,4212,1506,2706
19 ,Yamanashi,total,1940,Showa,15,662915,327983,334932
19 ,Yamanashi,0_ 4,1940,Showa,15,89897,45484,44413
19 ,Yamanashi,5_ 9,1940,Showa,15,88151,44442,43709
19 ,Yamanashi,10_ 14,1940,Showa,15,80908,41409,39499
19 ,Yamanashi,15_ 19,1940,Showa,15,55283,26608,28675
19 ,Yamanashi,20_ 24,1940,Showa,15,50915,25903,25012
19 ,Yamanashi,25_ 29,1940,Showa,15,42981,20912,22069
19 ,Yamanashi,30_ 34,1940,Showa,15,40519,19905,20614
19 ,Yamanashi,35_ 39,1940,Showa,15,38329,18935,19394
19 ,Yamanashi,40_ 44,1940,Showa,15,33197,16897,16300
19 ,Yamanashi,45_ 49,1940,Showa,15,29331,14559,14772
19 ,Yamanashi,50_ 54,1940,Showa,15,29103,14238,14865
19 ,Yamanashi,55_ 59,1940,Showa,15,26036,12461,13575
19 ,Yamanashi,60_ 64,1940,Showa,15,22808,10913,11895
19 ,Yamanashi,65_ 69,1940,Showa,15,15544,7120,8424
19 ,Yamanashi,70_ 74,1940,Showa,15,9728,4228,5500
19 ,Yamanashi,75_ 79,1940,Showa,15,6186,2542,3644
19 ,Yamanashi,80_ 84,1940,Showa,15,2789,1025,1764
19 ,Yamanashi,over_85,1940,Showa,15,1206,399,807
19 ,Yamanashi,total,1945,Showa,20,839057,384255,454802
19 ,Yamanashi,1_ 5,1945,Showa,20,114748,58081,56667
19 ,Yamanashi,6_ 10,1945,Showa,20,111595,56267,55328
19 ,Yamanashi,11_ 15,1945,Showa,20,105781,53198,52583
19 ,Yamanashi,16_ 20,1945,Showa,20,88899,42668,46231
19 ,Yamanashi,21_ 25,1945,Showa,20,61462,20809,40653
19 ,Yamanashi,26_ 30,1945,Showa,20,49350,16227,33123
19 ,Yamanashi,31_ 35,1945,Showa,20,48118,17271,30847
19 ,Yamanashi,36_ 40,1945,Showa,20,46985,20210,26775
19 ,Yamanashi,41_ 45,1945,Showa,20,44738,21517,23221
19 ,Yamanashi,46_ 50,1945,Showa,20,37184,18440,18744
19 ,Yamanashi,51_ 55,1945,Showa,20,31287,15332,15955
19 ,Yamanashi,56_ 60,1945,Showa,20,30320,14416,15904
19 ,Yamanashi,61_ 65,1945,Showa,20,25366,11612,13754
19 ,Yamanashi,66_ 70,1945,Showa,20,20767,9221,11546
19 ,Yamanashi,71_ 75,1945,Showa,20,12362,5312,7050
19 ,Yamanashi,76_ 80,1945,Showa,20,6218,2361,3857
19 ,Yamanashi,81_ 85,1945,Showa,20,2878,993,1885
19 ,Yamanashi,86以上,1945,Showa,20,999,320,679
19 ,Yamanashi,total,1950,Showa,25,811369,393550,417819
19 ,Yamanashi,0_ 4,1950,Showa,25,102933,52357,50576
19 ,Yamanashi,5_ 9,1950,Showa,25,98594,49997,48597
19 ,Yamanashi,10_ 14,1950,Showa,25,96982,48957,48025
19 ,Yamanashi,15_ 19,1950,Showa,25,84367,42462,41905
19 ,Yamanashi,20_ 24,1950,Showa,25,70613,33742,36871
19 ,Yamanashi,25_ 29,1950,Showa,25,55529,24826,30703
19 ,Yamanashi,30_ 34,1950,Showa,25,47739,21428,26311
19 ,Yamanashi,35_ 39,1950,Showa,25,46272,21166,25106
19 ,Yamanashi,40_ 44,1950,Showa,25,42474,20444,22030
19 ,Yamanashi,45_ 49,1950,Showa,25,38485,19003,19482
19 ,Yamanashi,50_ 54,1950,Showa,25,31577,15723,15854
19 ,Yamanashi,55_ 59,1950,Showa,25,26764,13043,13721
19 ,Yamanashi,60_ 64,1950,Showa,25,24908,11742,13166
19 ,Yamanashi,65_ 69,1950,Showa,25,19067,8498,10569
19 ,Yamanashi,70_ 74,1950,Showa,25,13884,5978,7906
19 ,Yamanashi,75_ 79,1950,Showa,25,7072,2828,4244
19 ,Yamanashi,over_80,1950,Showa,25,3871,1242,2629
19 ,Yamanashi,total,1955,Showa,30,807044,390205,416839
19 ,Yamanashi,0_ 4,1955,Showa,30,84930,43551,41379
19 ,Yamanashi,5_ 9,1955,Showa,30,98229,50016,48213
19 ,Yamanashi,10_ 14,1955,Showa,30,94819,48013,46806
19 ,Yamanashi,15_ 19,1955,Showa,30,78500,37970,40530
19 ,Yamanashi,20_ 24,1955,Showa,30,68200,31230,36970
19 ,Yamanashi,25_ 29,1955,Showa,30,62183,30706,31477
19 ,Yamanashi,30_ 34,1955,Showa,30,51519,23542,27977
19 ,Yamanashi,35_ 39,1955,Showa,30,45190,20431,24759
19 ,Yamanashi,40_ 44,1955,Showa,30,43540,20041,23499
19 ,Yamanashi,45_ 49,1955,Showa,30,40249,19400,20849
19 ,Yamanashi,50_ 54,1955,Showa,30,36073,17768,18305
19 ,Yamanashi,55_ 59,1955,Showa,30,29205,14468,14737
19 ,Yamanashi,60_ 64,1955,Showa,30,24000,11551,12449
19 ,Yamanashi,65_ 69,1955,Showa,30,20985,9662,11323
19 ,Yamanashi,70_ 74,1955,Showa,30,14767,6282,8485
19 ,Yamanashi,75_ 79,1955,Showa,30,9345,3736,5609
19 ,Yamanashi,80_ 84,1955,Showa,30,3867,1406,2461
19 ,Yamanashi,over_85,1955,Showa,30,1436,428,1008
19 ,Yamanashi,total,1960,Showa,35,782062,379057,403005
19 ,Yamanashi,0_ 4,1960,Showa,35,67272,34496,32776
19 ,Yamanashi,5_ 9,1960,Showa,35,83265,42618,40647
19 ,Yamanashi,10_ 14,1960,Showa,35,96190,48940,47250
19 ,Yamanashi,15_ 19,1960,Showa,35,70753,33983,36770
19 ,Yamanashi,20_ 24,1960,Showa,35,58723,26626,32097
19 ,Yamanashi,25_ 29,1960,Showa,35,59000,28866,30134
19 ,Yamanashi,30_ 34,1960,Showa,35,58380,29652,28728
19 ,Yamanashi,35_ 39,1960,Showa,35,50176,23188,26988
19 ,Yamanashi,40_ 44,1960,Showa,35,43808,20054,23754
19 ,Yamanashi,45_ 49,1960,Showa,35,41938,19437,22501
19 ,Yamanashi,50_ 54,1960,Showa,35,38320,18528,19792
19 ,Yamanashi,55_ 59,1960,Showa,35,33579,16485,17094
19 ,Yamanashi,60_ 64,1960,Showa,35,26356,12864,13492
19 ,Yamanashi,65_ 69,1960,Showa,35,20513,9580,10933
19 ,Yamanashi,70_ 74,1960,Showa,35,16366,7213,9153
19 ,Yamanashi,75_ 79,1960,Showa,35,10171,3999,6172
19 ,Yamanashi,80_ 84,1960,Showa,35,5250,1922,3328
19 ,Yamanashi,over_85,1960,Showa,35,2002,606,1396
19 ,Yamanashi,total,1965,Showa,40,763194,367739,395455
19 ,Yamanashi,0_ 4,1965,Showa,40,61233,31283,29950
19 ,Yamanashi,5_ 9,1965,Showa,40,66380,33907,32473
19 ,Yamanashi,10_ 14,1965,Showa,40,82168,41786,40382
19 ,Yamanashi,15_ 19,1965,Showa,40,80103,38873,41230
19 ,Yamanashi,20_ 24,1965,Showa,40,54395,24121,30274
19 ,Yamanashi,25_ 29,1965,Showa,40,51302,24572,26730
19 ,Yamanashi,30_ 34,1965,Showa,40,55422,27622,27800
19 ,Yamanashi,35_ 39,1965,Showa,40,56569,28624,27945
19 ,Yamanashi,40_ 44,1965,Showa,40,48246,22081,26165
19 ,Yamanashi,45_ 49,1965,Showa,40,42041,19028,23013
19 ,Yamanashi,50_ 54,1965,Showa,40,39589,18177,21412
19 ,Yamanashi,55_ 59,1965,Showa,40,35718,17202,18516
19 ,Yamanashi,60_ 64,1965,Showa,40,30461,14680,15781
19 ,Yamanashi,65_ 69,1965,Showa,40,22798,10806,11992
19 ,Yamanashi,70_ 74,1965,Showa,40,16584,7399,9185
19 ,Yamanashi,75_ 79,1965,Showa,40,11543,4697,6846
19 ,Yamanashi,80_ 84,1965,Showa,40,5874,2060,3814
19 ,Yamanashi,over_85,1965,Showa,40,2768,821,1947
19 ,Yamanashi,total,1970,Showa,45,762029,366925,395104
19 ,Yamanashi,0_ 4,1970,Showa,45,60238,30968,29270
19 ,Yamanashi,5_ 9,1970,Showa,45,62005,31761,30244
19 ,Yamanashi,10_ 14,1970,Showa,45,66206,33833,32373
19 ,Yamanashi,15_ 19,1970,Showa,45,69646,33481,36165
19 ,Yamanashi,20_ 24,1970,Showa,45,62876,28785,34091
19 ,Yamanashi,25_ 29,1970,Showa,45,52234,25172,27062
19 ,Yamanashi,30_ 34,1970,Showa,45,51531,25524,26007
19 ,Yamanashi,35_ 39,1970,Showa,45,55386,27577,27809
19 ,Yamanashi,40_ 44,1970,Showa,45,55188,27829,27359
19 ,Yamanashi,45_ 49,1970,Showa,45,47342,21478,25864
19 ,Yamanashi,50_ 54,1970,Showa,45,40647,18227,22420
19 ,Yamanashi,55_ 59,1970,Showa,45,37418,17012,20406
19 ,Yamanashi,60_ 64,1970,Showa,45,32969,15502,17467
19 ,Yamanashi,65_ 69,1970,Showa,45,27083,12672,14411
19 ,Yamanashi,70_ 74,1970,Showa,45,18826,8531,10295
19 ,Yamanashi,75_ 79,1970,Showa,45,12098,5018,7080
19 ,Yamanashi,80_ 84,1970,Showa,45,6977,2549,4428
19 ,Yamanashi,over_85,1970,Showa,45,3359,1006,2353
19 ,Yamanashi,total,1975,Showa,50,783050,379283,403767
19 ,Yamanashi,0_ 4,1975,Showa,50,62471,31867,30604
19 ,Yamanashi,5_ 9,1975,Showa,50,61976,31815,30161
19 ,Yamanashi,10_ 14,1975,Showa,50,62600,32097,30503
19 ,Yamanashi,15_ 19,1975,Showa,50,58612,28982,29630
19 ,Yamanashi,20_ 24,1975,Showa,50,54824,25405,29419
19 ,Yamanashi,25_ 29,1975,Showa,50,62501,30913,31588
19 ,Yamanashi,30_ 34,1975,Showa,50,55071,27515,27556
19 ,Yamanashi,35_ 39,1975,Showa,50,53004,26412,26592
19 ,Yamanashi,40_ 44,1975,Showa,50,55611,27744,27867
19 ,Yamanashi,45_ 49,1975,Showa,50,54969,27627,27342
19 ,Yamanashi,50_ 54,1975,Showa,50,46228,20874,25354
19 ,Yamanashi,55_ 59,1975,Showa,50,39230,17444,21786
19 ,Yamanashi,60_ 64,1975,Showa,50,35920,16099,19821
19 ,Yamanashi,65_ 69,1975,Showa,50,30299,13778,16521
19 ,Yamanashi,70_ 74,1975,Showa,50,23186,10301,12885
19 ,Yamanashi,75_ 79,1975,Showa,50,14500,6101,8399
19 ,Yamanashi,80_ 84,1975,Showa,50,7711,2932,4779
19 ,Yamanashi,over_85,1975,Showa,50,4174,1273,2901
19 ,Yamanashi,total,1980,Showa,55,804256,391649,412607
19 ,Yamanashi,0_ 4,1980,Showa,55,55028,28032,26996
19 ,Yamanashi,5_ 9,1980,Showa,55,64265,32825,31440
19 ,Yamanashi,10_ 14,1980,Showa,55,62873,32319,30554
19 ,Yamanashi,15_ 19,1980,Showa,55,58499,29735,28764
19 ,Yamanashi,20_ 24,1980,Showa,55,48220,23318,24902
19 ,Yamanashi,25_ 29,1980,Showa,55,56157,27798,28359
19 ,Yamanashi,30_ 34,1980,Showa,55,64151,32544,31607
19 ,Yamanashi,35_ 39,1980,Showa,55,56273,28162,28111
19 ,Yamanashi,40_ 44,1980,Showa,55,53224,26576,26648
19 ,Yamanashi,45_ 49,1980,Showa,55,54852,27190,27662
19 ,Yamanashi,50_ 54,1980,Showa,55,54173,26975,27198
19 ,Yamanashi,55_ 59,1980,Showa,55,45150,20188,24962
19 ,Yamanashi,60_ 64,1980,Showa,55,37872,16590,21282
19 ,Yamanashi,65_ 69,1980,Showa,55,33483,14646,18837
19 ,Yamanashi,70_ 74,1980,Showa,55,26681,11674,15007
19 ,Yamanashi,75_ 79,1980,Showa,55,18349,7624,10725
19 ,Yamanashi,80_ 84,1980,Showa,55,9565,3672,5893
19 ,Yamanashi,over_85,1980,Showa,55,5260,1664,3596
19 ,Yamanashi,total,1985,Showa,60,832832,407910,424922
19 ,Yamanashi,0_ 4,1985,Showa,60,50012,25500,24512
19 ,Yamanashi,5_ 9,1985,Showa,60,57236,29239,27997
19 ,Yamanashi,10_ 14,1985,Showa,60,65627,33499,32128
19 ,Yamanashi,15_ 19,1985,Showa,60,62192,32050,30142
19 ,Yamanashi,20_ 24,1985,Showa,60,52479,26511,25968
19 ,Yamanashi,25_ 29,1985,Showa,60,50729,25455,25274
19 ,Yamanashi,30_ 34,1985,Showa,60,58818,29947,28871
19 ,Yamanashi,35_ 39,1985,Showa,60,66483,33934,32549
19 ,Yamanashi,40_ 44,1985,Showa,60,57160,28782,28378
19 ,Yamanashi,45_ 49,1985,Showa,60,53095,26588,26507
19 ,Yamanashi,50_ 54,1985,Showa,60,54290,26784,27506
19 ,Yamanashi,55_ 59,1985,Showa,60,53161,26178,26983
19 ,Yamanashi,60_ 64,1985,Showa,60,43852,19369,24483
19 ,Yamanashi,65_ 69,1985,Showa,60,35709,15256,20453
19 ,Yamanashi,70_ 74,1985,Showa,60,30234,12729,17505
19 ,Yamanashi,75_ 79,1985,Showa,60,21885,8967,12918
19 ,Yamanashi,80_ 84,1985,Showa,60,12817,4863,7954
19 ,Yamanashi,over_85,1985,Showa,60,7045,2254,4791
19 ,Yamanashi,total,1990,Heisei,2,852966,418701,434265
19 ,Yamanashi,0_ 4,1990,Heisei,2,46026,23526,22500
19 ,Yamanashi,5_ 9,1990,Heisei,2,51715,26408,25307
19 ,Yamanashi,10_ 14,1990,Heisei,2,58108,29614,28494
19 ,Yamanashi,15_ 19,1990,Heisei,2,65121,33776,31345
19 ,Yamanashi,20_ 24,1990,Heisei,2,55825,28206,27619
19 ,Yamanashi,25_ 29,1990,Heisei,2,53290,26969,26321
19 ,Yamanashi,30_ 34,1990,Heisei,2,52622,26716,25906
19 ,Yamanashi,35_ 39,1990,Heisei,2,60533,30971,29562
19 ,Yamanashi,40_ 44,1990,Heisei,2,67537,34597,32940
19 ,Yamanashi,45_ 49,1990,Heisei,2,57083,28814,28269
19 ,Yamanashi,50_ 54,1990,Heisei,2,52698,26284,26414
19 ,Yamanashi,55_ 59,1990,Heisei,2,53345,26046,27299
19 ,Yamanashi,60_ 64,1990,Heisei,2,51751,25134,26617
19 ,Yamanashi,65_ 69,1990,Heisei,2,41819,18050,23769
19 ,Yamanashi,70_ 74,1990,Heisei,2,32781,13530,19251
19 ,Yamanashi,75_ 79,1990,Heisei,2,25745,10292,15453
19 ,Yamanashi,80_ 84,1990,Heisei,2,16183,6034,10149
19 ,Yamanashi,over_85,1990,Heisei,2,10055,3226,6829
19 ,Yamanashi,total,1995,Heisei,7,881996,434707,447289
19 ,Yamanashi,0_ 4,1995,Heisei,7,45132,23145,21987
19 ,Yamanashi,5_ 9,1995,Heisei,7,48172,24614,23558
19 ,Yamanashi,10_ 14,1995,Heisei,7,52744,26863,25881
19 ,Yamanashi,15_ 19,1995,Heisei,7,58100,29945,28155
19 ,Yamanashi,20_ 24,1995,Heisei,7,62612,32721,29891
19 ,Yamanashi,25_ 29,1995,Heisei,7,59008,30174,28834
19 ,Yamanashi,30_ 34,1995,Heisei,7,56583,28975,27608
19 ,Yamanashi,35_ 39,1995,Heisei,7,55317,28320,26997
19 ,Yamanashi,40_ 44,1995,Heisei,7,62445,32185,30260
19 ,Yamanashi,45_ 49,1995,Heisei,7,68465,35288,33177
19 ,Yamanashi,50_ 54,1995,Heisei,7,57467,28958,28509
19 ,Yamanashi,55_ 59,1995,Heisei,7,52378,25907,26471
19 ,Yamanashi,60_ 64,1995,Heisei,7,52346,25144,27202
19 ,Yamanashi,65_ 69,1995,Heisei,7,49443,23455,25988
19 ,Yamanashi,70_ 74,1995,Heisei,7,38947,16242,22705
19 ,Yamanashi,75_ 79,1995,Heisei,7,28610,11137,17473
19 ,Yamanashi,80_ 84,1995,Heisei,7,19964,7248,12716
19 ,Yamanashi,over_85,1995,Heisei,7,14184,4330,9854
19 ,Yamanashi,total,2000,Heisei,12,888172,436837,451335
19 ,Yamanashi,0_ 4,2000,Heisei,12,43200,22301,20899
19 ,Yamanashi,5_ 9,2000,Heisei,12,45913,23609,22304
19 ,Yamanashi,10_ 14,2000,Heisei,12,48481,24778,23703
19 ,Yamanashi,15_ 19,2000,Heisei,12,52159,27007,25152
19 ,Yamanashi,20_ 24,2000,Heisei,12,53198,27424,25774
19 ,Yamanashi,25_ 29,2000,Heisei,12,61271,31629,29642
19 ,Yamanashi,30_ 34,2000,Heisei,12,59320,30401,28919
19 ,Yamanashi,35_ 39,2000,Heisei,12,57400,29361,28039
19 ,Yamanashi,40_ 44,2000,Heisei,12,55623,28450,27173
19 ,Yamanashi,45_ 49,2000,Heisei,12,62034,31836,30198
19 ,Yamanashi,50_ 54,2000,Heisei,12,67603,34465,33138
19 ,Yamanashi,55_ 59,2000,Heisei,12,56711,28082,28629
19 ,Yamanashi,60_ 64,2000,Heisei,12,51448,24955,26493
19 ,Yamanashi,65_ 69,2000,Heisei,12,50161,23552,26609
19 ,Yamanashi,70_ 74,2000,Heisei,12,46136,21152,24984
19 ,Yamanashi,75_ 79,2000,Heisei,12,34618,13641,20977
19 ,Yamanashi,80_ 84,2000,Heisei,12,23062,8190,14872
19 ,Yamanashi,over_85,2000,Heisei,12,19603,5840,13763
19 ,Yamanashi,total,2005,Heisei,17,884515,433569,450946
19 ,Yamanashi,0_ 4,2005,Heisei,17,38490,19877,18613
19 ,Yamanashi,5_ 9,2005,Heisei,17,43319,22393,20926
19 ,Yamanashi,10_ 14,2005,Heisei,17,45818,23500,22318
19 ,Yamanashi,15_ 19,2005,Heisei,17,48072,24660,23412
19 ,Yamanashi,20_ 24,2005,Heisei,17,47312,24411,22901
19 ,Yamanashi,25_ 29,2005,Heisei,17,51221,26192,25029
19 ,Yamanashi,30_ 34,2005,Heisei,17,61001,31473,29528
19 ,Yamanashi,35_ 39,2005,Heisei,17,58952,30118,28834
19 ,Yamanashi,40_ 44,2005,Heisei,17,56985,29089,27896
19 ,Yamanashi,45_ 49,2005,Heisei,17,54865,27848,27017
19 ,Yamanashi,50_ 54,2005,Heisei,17,61228,31146,30082
19 ,Yamanashi,55_ 59,2005,Heisei,17,66683,33563,33120
19 ,Yamanashi,60_ 64,2005,Heisei,17,56176,27539,28637
19 ,Yamanashi,65_ 69,2005,Heisei,17,49873,23820,26053
19 ,Yamanashi,70_ 74,2005,Heisei,17,47157,21449,25708
19 ,Yamanashi,75_ 79,2005,Heisei,17,41434,18072,23362
19 ,Yamanashi,80_ 84,2005,Heisei,17,28778,10395,18383
19 ,Yamanashi,over_85,2005,Heisei,17,26338,7576,18762
19 ,Yamanashi,total,2010,Heisei,22,863075,422526,440549
19 ,Yamanashi,0_ 4,2010,Heisei,22,34075,17481,16594
19 ,Yamanashi,5_ 9,2010,Heisei,22,38282,19835,18447
19 ,Yamanashi,10_ 14,2010,Heisei,22,42980,22236,20744
19 ,Yamanashi,15_ 19,2010,Heisei,22,45018,23081,21937
19 ,Yamanashi,20_ 24,2010,Heisei,22,40689,20677,20012
19 ,Yamanashi,25_ 29,2010,Heisei,22,42833,22073,20760
19 ,Yamanashi,30_ 34,2010,Heisei,22,49746,25390,24356
19 ,Yamanashi,35_ 39,2010,Heisei,22,59641,30625,29016
19 ,Yamanashi,40_ 44,2010,Heisei,22,58086,29600,28486
19 ,Yamanashi,45_ 49,2010,Heisei,22,55667,28253,27414
19 ,Yamanashi,50_ 54,2010,Heisei,22,53970,27272,26698
19 ,Yamanashi,55_ 59,2010,Heisei,22,60061,30211,29850
19 ,Yamanashi,60_ 64,2010,Heisei,22,65744,32700,33044
19 ,Yamanashi,65_ 69,2010,Heisei,22,54397,26261,28136
19 ,Yamanashi,70_ 74,2010,Heisei,22,46943,21846,25097
19 ,Yamanashi,75_ 79,2010,Heisei,22,42420,18374,24046
19 ,Yamanashi,80_ 84,2010,Heisei,22,34400,13816,20584
19 ,Yamanashi,over_85,2010,Heisei,22,33421,9564,23857
19 ,Yamanashi,total,2015,Heisei,27,834930,408327,426603
19 ,Yamanashi,0_ 4,2015,Heisei,27,30196,15326,14870
19 ,Yamanashi,5_ 9,2015,Heisei,27,34091,17417,16674
19 ,Yamanashi,10_ 14,2015,Heisei,27,37983,19728,18255
19 ,Yamanashi,15_ 19,2015,Heisei,27,42895,22281,20614
19 ,Yamanashi,20_ 24,2015,Heisei,27,37785,19437,18348
19 ,Yamanashi,25_ 29,2015,Heisei,27,37226,19275,17951
19 ,Yamanashi,30_ 34,2015,Heisei,27,41489,21231,20258
19 ,Yamanashi,35_ 39,2015,Heisei,27,48350,24534,23816
19 ,Yamanashi,40_ 44,2015,Heisei,27,58353,29900,28453
19 ,Yamanashi,45_ 49,2015,Heisei,27,56461,28514,27947
19 ,Yamanashi,50_ 54,2015,Heisei,27,54295,27439,26856
19 ,Yamanashi,55_ 59,2015,Heisei,27,52897,26537,26360
19 ,Yamanashi,60_ 64,2015,Heisei,27,59094,29550,29544
19 ,Yamanashi,65_ 69,2015,Heisei,27,63778,31336,32442
19 ,Yamanashi,70_ 74,2015,Heisei,27,51441,24290,27151
19 ,Yamanashi,75_ 79,2015,Heisei,27,42682,19214,23468
19 ,Yamanashi,80_ 84,2015,Heisei,27,35849,14447,21402
19 ,Yamanashi,over_85,2015,Heisei,27,40794,12725,28069
20 ,Nagano,total,1920,Taisho,9,1562722,758639,804083
20 ,Nagano,0_ 4,1920,Taisho,9,205224,103493,101731
20 ,Nagano,5_ 9,1920,Taisho,9,187632,94216,93416
20 ,Nagano,10_ 14,1920,Taisho,9,175061,82700,92361
20 ,Nagano,15_ 19,1920,Taisho,9,157944,72596,85348
20 ,Nagano,20_ 24,1920,Taisho,9,117480,52977,64503
20 ,Nagano,25_ 29,1920,Taisho,9,103499,50907,52592
20 ,Nagano,30_ 34,1920,Taisho,9,103534,51175,52359
20 ,Nagano,35_ 39,1920,Taisho,9,96814,47229,49585
20 ,Nagano,40_ 44,1920,Taisho,9,93743,46781,46962
20 ,Nagano,45_ 49,1920,Taisho,9,75399,37738,37661
20 ,Nagano,50_ 54,1920,Taisho,9,61175,30628,30547
20 ,Nagano,55_ 59,1920,Taisho,9,53463,26447,27016
20 ,Nagano,60_ 64,1920,Taisho,9,47385,23200,24185
20 ,Nagano,65_ 69,1920,Taisho,9,37843,18103,19740
20 ,Nagano,70_ 74,1920,Taisho,9,26063,11898,14165
20 ,Nagano,75_ 79,1920,Taisho,9,13837,6001,7836
20 ,Nagano,over_80,1920,Taisho,9,6626,2550,4076
20 ,Nagano,total,1925,Taisho,14,1629217,793875,835342
20 ,Nagano,0_ 4,1925,Taisho,14,220808,111069,109739
20 ,Nagano,5_ 9,1925,Taisho,14,191246,96211,95035
20 ,Nagano,10_ 14,1925,Taisho,14,188567,90327,98240
20 ,Nagano,15_ 19,1925,Taisho,14,158994,73021,85973
20 ,Nagano,20_ 24,1925,Taisho,14,130393,61491,68902
20 ,Nagano,25_ 29,1925,Taisho,14,110204,54578,55626
20 ,Nagano,30_ 34,1925,Taisho,14,96768,48240,48528
20 ,Nagano,35_ 39,1925,Taisho,14,98413,49432,48981
20 ,Nagano,40_ 44,1925,Taisho,14,91188,44691,46497
20 ,Nagano,45_ 49,1925,Taisho,14,87960,43751,44209
20 ,Nagano,50_ 54,1925,Taisho,14,69465,34392,35073
20 ,Nagano,55_ 59,1925,Taisho,14,54439,26734,27705
20 ,Nagano,60_ 64,1925,Taisho,14,45405,21845,23560
20 ,Nagano,65_ 69,1925,Taisho,14,36727,17202,19525
20 ,Nagano,70_ 74,1925,Taisho,14,26016,11681,14335
20 ,Nagano,75_ 79,1925,Taisho,14,14883,6275,8608
20 ,Nagano,80_ 84,1925,Taisho,14,6034,2387,3647
20 ,Nagano,over_85,1925,Taisho,14,1707,548,1159
20 ,Nagano,total,1930,Showa,5,1717118,832312,884806
20 ,Nagano,0_ 4,1930,Showa,5,240103,120954,119149
20 ,Nagano,5_ 9,1930,Showa,5,207313,104208,103105
20 ,Nagano,10_ 14,1930,Showa,5,191680,92128,99552
20 ,Nagano,15_ 19,1930,Showa,5,173994,79363,94631
20 ,Nagano,20_ 24,1930,Showa,5,133005,60705,72300
20 ,Nagano,25_ 29,1930,Showa,5,120499,58975,61524
20 ,Nagano,30_ 34,1930,Showa,5,104363,51880,52483
20 ,Nagano,35_ 39,1930,Showa,5,92132,45936,46196
20 ,Nagano,40_ 44,1930,Showa,5,92882,46489,46393
20 ,Nagano,45_ 49,1930,Showa,5,85575,41594,43981
20 ,Nagano,50_ 54,1930,Showa,5,81164,40061,41103
20 ,Nagano,55_ 59,1930,Showa,5,62370,30457,31913
20 ,Nagano,60_ 64,1930,Showa,5,46380,22152,24228
20 ,Nagano,65_ 69,1930,Showa,5,35705,16361,19344
20 ,Nagano,70_ 74,1930,Showa,5,25644,11435,14209
20 ,Nagano,75_ 79,1930,Showa,5,15282,6312,8970
20 ,Nagano,over_80,1930,Showa,5,9027,3302,5725
20 ,Nagano,total,1935,Showa,10,1714000,840103,873897
20 ,Nagano,0_ 4,1935,Showa,10,232074,117704,114370
20 ,Nagano,5_ 9,1935,Showa,10,226254,113953,112301
20 ,Nagano,10_ 14,1935,Showa,10,192153,96508,95645
20 ,Nagano,15_ 19,1935,Showa,10,142568,69001,73567
20 ,Nagano,20_ 24,1935,Showa,10,127498,58726,68772
20 ,Nagano,25_ 29,1935,Showa,10,117510,56860,60650
20 ,Nagano,30_ 34,1935,Showa,10,111995,55030,56965
20 ,Nagano,35_ 39,1935,Showa,10,98199,48791,49408
20 ,Nagano,40_ 44,1935,Showa,10,86909,43470,43439
20 ,Nagano,45_ 49,1935,Showa,10,87256,43674,43582
20 ,Nagano,50_ 54,1935,Showa,10,78985,38221,40764
20 ,Nagano,55_ 59,1935,Showa,10,72888,35465,37423
20 ,Nagano,60_ 64,1935,Showa,10,53535,25618,27917
20 ,Nagano,65_ 69,1935,Showa,10,36464,16649,19815
20 ,Nagano,70_ 74,1935,Showa,10,25192,10786,14406
20 ,Nagano,75_ 79,1935,Showa,10,15014,6218,8796
20 ,Nagano,over_80,1935,Showa,10,9506,3429,6077
20 ,Nagano,total,1940,Showa,15,1710519,833851,876668
20 ,Nagano,0_ 4,1940,Showa,15,214886,108842,106044
20 ,Nagano,5_ 9,1940,Showa,15,216944,109707,107237
20 ,Nagano,10_ 14,1940,Showa,15,209055,105128,103927
20 ,Nagano,15_ 19,1940,Showa,15,144032,66570,77462
20 ,Nagano,20_ 24,1940,Showa,15,127111,62564,64547
20 ,Nagano,25_ 29,1940,Showa,15,111411,52203,59208
20 ,Nagano,30_ 34,1940,Showa,15,106336,50757,55579
20 ,Nagano,35_ 39,1940,Showa,15,104409,50881,53528
20 ,Nagano,40_ 44,1940,Showa,15,91376,45142,46234
20 ,Nagano,45_ 49,1940,Showa,15,80935,40131,40804
20 ,Nagano,50_ 54,1940,Showa,15,80147,39838,40309
20 ,Nagano,55_ 59,1940,Showa,15,70622,33700,36922
20 ,Nagano,60_ 64,1940,Showa,15,62199,29406,32793
20 ,Nagano,65_ 69,1940,Showa,15,42228,19422,22806
20 ,Nagano,70_ 74,1940,Showa,15,25399,10812,14587
20 ,Nagano,75_ 79,1940,Showa,15,14372,5562,8810
20 ,Nagano,80_ 84,1940,Showa,15,6536,2444,4092
20 ,Nagano,over_85,1940,Showa,15,2513,736,1777
20 ,Nagano,total,1945,Showa,20,2121050,973871,1147179
20 ,Nagano,1_ 5,1945,Showa,20,274082,138975,135107
20 ,Nagano,6_ 10,1945,Showa,20,263691,133360,130331
20 ,Nagano,11_ 15,1945,Showa,20,262087,132570,129517
20 ,Nagano,16_ 20,1945,Showa,20,224354,106165,118189
20 ,Nagano,21_ 25,1945,Showa,20,156137,54288,101849
20 ,Nagano,26_ 30,1945,Showa,20,124954,40856,84098
20 ,Nagano,31_ 35,1945,Showa,20,126050,47468,78582
20 ,Nagano,36_ 40,1945,Showa,20,122336,52908,69428
20 ,Nagano,41_ 45,1945,Showa,20,119306,57127,62179
20 ,Nagano,46_ 50,1945,Showa,20,101695,49844,51851
20 ,Nagano,51_ 55,1945,Showa,20,85651,42338,43313
20 ,Nagano,56_ 60,1945,Showa,20,81777,39767,42010
20 ,Nagano,61_ 65,1945,Showa,20,66985,30851,36134
20 ,Nagano,66_ 70,1945,Showa,20,54905,24394,30511
20 ,Nagano,71_ 75,1945,Showa,20,32947,13985,18962
20 ,Nagano,76_ 80,1945,Showa,20,15488,6106,9382
20 ,Nagano,81_ 85,1945,Showa,20,6456,2171,4285
20 ,Nagano,86以上,1945,Showa,20,2149,698,1451
20 ,Nagano,total,1950,Showa,25,2060831,1001192,1059639
20 ,Nagano,0_ 4,1950,Showa,25,245432,125453,119979
20 ,Nagano,5_ 9,1950,Showa,25,241509,122665,118844
20 ,Nagano,10_ 14,1950,Showa,25,230307,116417,113890
20 ,Nagano,15_ 19,1950,Showa,25,202311,105514,96797
20 ,Nagano,20_ 24,1950,Showa,25,180842,86177,94665
20 ,Nagano,25_ 29,1950,Showa,25,149170,67670,81500
20 ,Nagano,30_ 34,1950,Showa,25,124726,55242,69484
20 ,Nagano,35_ 39,1950,Showa,25,122060,55801,66259
20 ,Nagano,40_ 44,1950,Showa,25,112595,53268,59327
20 ,Nagano,45_ 49,1950,Showa,25,105295,51326,53969
20 ,Nagano,50_ 54,1950,Showa,25,88496,43570,44926
20 ,Nagano,55_ 59,1950,Showa,25,74477,36533,37944
20 ,Nagano,60_ 64,1950,Showa,25,68162,32665,35497
20 ,Nagano,65_ 69,1950,Showa,25,50865,22820,28045
20 ,Nagano,70_ 74,1950,Showa,25,36882,15679,21203
20 ,Nagano,75_ 79,1950,Showa,25,18575,7378,11197
20 ,Nagano,over_80,1950,Showa,25,9068,2986,6082
20 ,Nagano,total,1955,Showa,30,2021292,979004,1042288
20 ,Nagano,0_ 4,1955,Showa,30,187666,95776,91890
20 ,Nagano,5_ 9,1955,Showa,30,234999,120085,114914
20 ,Nagano,10_ 14,1955,Showa,30,232721,118221,114500
20 ,Nagano,15_ 19,1955,Showa,30,179028,91461,87567
20 ,Nagano,20_ 24,1955,Showa,30,162329,76745,85584
20 ,Nagano,25_ 29,1955,Showa,30,165554,79273,86281
20 ,Nagano,30_ 34,1955,Showa,30,140178,64189,75989
20 ,Nagano,35_ 39,1955,Showa,30,117566,52338,65228
20 ,Nagano,40_ 44,1955,Showa,30,115458,52823,62635
20 ,Nagano,45_ 49,1955,Showa,30,106764,50629,56135
20 ,Nagano,50_ 54,1955,Showa,30,99167,48372,50795
20 ,Nagano,55_ 59,1955,Showa,30,81929,40090,41839
20 ,Nagano,60_ 64,1955,Showa,30,66454,32247,34207
20 ,Nagano,65_ 69,1955,Showa,30,56462,26558,29904
20 ,Nagano,70_ 74,1955,Showa,30,38366,16427,21939
20 ,Nagano,75_ 79,1955,Showa,30,23834,9387,14447
20 ,Nagano,80_ 84,1955,Showa,30,9647,3477,6170
20 ,Nagano,over_85,1955,Showa,30,3152,894,2258
20 ,Nagano,total,1960,Showa,35,1981506,954712,1026794
20 ,Nagano,0_ 4,1960,Showa,35,154882,79061,75821
20 ,Nagano,5_ 9,1960,Showa,35,185252,94394,90858
20 ,Nagano,10_ 14,1960,Showa,35,231645,118333,113312
20 ,Nagano,15_ 19,1960,Showa,35,179592,89979,89613
20 ,Nagano,20_ 24,1960,Showa,35,143256,64703,78553
20 ,Nagano,25_ 29,1960,Showa,35,153200,73219,79981
20 ,Nagano,30_ 34,1960,Showa,35,159343,77682,81661
20 ,Nagano,35_ 39,1960,Showa,35,136830,63199,73631
20 ,Nagano,40_ 44,1960,Showa,35,114269,51150,63119
20 ,Nagano,45_ 49,1960,Showa,35,111537,51200,60337
20 ,Nagano,50_ 54,1960,Showa,35,101732,48266,53466
20 ,Nagano,55_ 59,1960,Showa,35,93176,45283,47893
20 ,Nagano,60_ 64,1960,Showa,35,74208,35934,38274
20 ,Nagano,65_ 69,1960,Showa,35,56583,26847,29736
20 ,Nagano,70_ 74,1960,Showa,35,43516,19500,24016
20 ,Nagano,75_ 79,1960,Showa,35,25283,10077,15206
20 ,Nagano,80_ 84,1960,Showa,35,12745,4529,8216
20 ,Nagano,over_85,1960,Showa,35,4457,1356,3101
20 ,Nagano,total,1965,Showa,40,1958007,937219,1020788
20 ,Nagano,0_ 4,1965,Showa,40,147500,75093,72407
20 ,Nagano,5_ 9,1965,Showa,40,153621,77914,75707
20 ,Nagano,10_ 14,1965,Showa,40,183581,93111,90470
20 ,Nagano,15_ 19,1965,Showa,40,194983,96429,98554
20 ,Nagano,20_ 24,1965,Showa,40,143887,62596,81291
20 ,Nagano,25_ 29,1965,Showa,40,137085,64874,72211
20 ,Nagano,30_ 34,1965,Showa,40,148955,73072,75883
20 ,Nagano,35_ 39,1965,Showa,40,156654,76989,79665
20 ,Nagano,40_ 44,1965,Showa,40,134186,62101,72085
20 ,Nagano,45_ 49,1965,Showa,40,111435,49831,61604
20 ,Nagano,50_ 54,1965,Showa,40,107205,49201,58004
20 ,Nagano,55_ 59,1965,Showa,40,96169,45666,50503
20 ,Nagano,60_ 64,1965,Showa,40,84778,40682,44096
20 ,Nagano,65_ 69,1965,Showa,40,64521,30475,34046
20 ,Nagano,70_ 74,1965,Showa,40,44748,20299,24449
20 ,Nagano,75_ 79,1965,Showa,40,29606,12373,17233
20 ,Nagano,80_ 84,1965,Showa,40,13206,4763,8443
20 ,Nagano,over_85,1965,Showa,40,5887,1750,4137
20 ,Nagano,total,1970,Showa,45,1956917,936354,1020563
20 ,Nagano,0_ 4,1970,Showa,45,148097,75830,72267
20 ,Nagano,5_ 9,1970,Showa,45,148148,75550,72598
20 ,Nagano,10_ 14,1970,Showa,45,153288,78144,75144
20 ,Nagano,15_ 19,1970,Showa,45,157023,77027,79996
20 ,Nagano,20_ 24,1970,Showa,45,155899,69696,86203
20 ,Nagano,25_ 29,1970,Showa,45,143593,69091,74502
20 ,Nagano,30_ 34,1970,Showa,45,136139,66611,69528
20 ,Nagano,35_ 39,1970,Showa,45,147666,72461,75205
20 ,Nagano,40_ 44,1970,Showa,45,152919,74800,78119
20 ,Nagano,45_ 49,1970,Showa,45,131600,60446,71154
20 ,Nagano,50_ 54,1970,Showa,45,108286,48063,60223
20 ,Nagano,55_ 59,1970,Showa,45,101331,46143,55188
20 ,Nagano,60_ 64,1970,Showa,45,89209,41474,47735
20 ,Nagano,65_ 69,1970,Showa,45,74990,34970,40020
20 ,Nagano,70_ 74,1970,Showa,45,53074,24060,29014
20 ,Nagano,75_ 79,1970,Showa,45,31972,13516,18456
20 ,Nagano,80_ 84,1970,Showa,45,16884,6431,10453
20 ,Nagano,over_85,1970,Showa,45,6799,2041,4758
20 ,Nagano,total,1975,Showa,50,2017564,972471,1045093
20 ,Nagano,0_ 4,1975,Showa,50,164571,84501,80070
20 ,Nagano,5_ 9,1975,Showa,50,150889,77402,73487
20 ,Nagano,10_ 14,1975,Showa,50,148967,75973,72994
20 ,Nagano,15_ 19,1975,Showa,50,132157,65856,66301
20 ,Nagano,20_ 24,1975,Showa,50,124336,56593,67743
20 ,Nagano,25_ 29,1975,Showa,50,163695,80424,83271
20 ,Nagano,30_ 34,1975,Showa,50,147870,73932,73938
20 ,Nagano,35_ 39,1975,Showa,50,137701,67911,69790
20 ,Nagano,40_ 44,1975,Showa,50,147998,72857,75141
20 ,Nagano,45_ 49,1975,Showa,50,152389,74353,78036
20 ,Nagano,50_ 54,1975,Showa,50,128957,58972,69985
20 ,Nagano,55_ 59,1975,Showa,50,104976,46335,58641
20 ,Nagano,60_ 64,1975,Showa,50,97581,43887,53694
20 ,Nagano,65_ 69,1975,Showa,50,82162,37310,44852
20 ,Nagano,70_ 74,1975,Showa,50,64265,28595,35670
20 ,Nagano,75_ 79,1975,Showa,50,40187,17073,23114
20 ,Nagano,80_ 84,1975,Showa,50,19484,7394,12090
20 ,Nagano,over_85,1975,Showa,50,9230,3002,6228
20 ,Nagano,total,1980,Showa,55,2083934,1008885,1075049
20 ,Nagano,0_ 4,1980,Showa,55,147543,75757,71786
20 ,Nagano,5_ 9,1980,Showa,55,168140,86393,81747
20 ,Nagano,10_ 14,1980,Showa,55,152930,78473,74457
20 ,Nagano,15_ 19,1980,Showa,55,133384,67339,66045
20 ,Nagano,20_ 24,1980,Showa,55,108102,50482,57620
20 ,Nagano,25_ 29,1980,Showa,55,140036,68956,71080
20 ,Nagano,30_ 34,1980,Showa,55,168870,85056,83814
20 ,Nagano,35_ 39,1980,Showa,55,150494,75613,74881
20 ,Nagano,40_ 44,1980,Showa,55,138260,68219,70041
20 ,Nagano,45_ 49,1980,Showa,55,146304,71575,74729
20 ,Nagano,50_ 54,1980,Showa,55,149885,72677,77208
20 ,Nagano,55_ 59,1980,Showa,55,125995,57093,68902
20 ,Nagano,60_ 64,1980,Showa,55,100862,43903,56959
20 ,Nagano,65_ 69,1980,Showa,55,90901,39966,50935
20 ,Nagano,70_ 74,1980,Showa,55,72428,31640,40788
20 ,Nagano,75_ 79,1980,Showa,55,50633,21261,29372
20 ,Nagano,80_ 84,1980,Showa,55,26735,10374,16361
20 ,Nagano,over_85,1980,Showa,55,12423,4102,8321
20 ,Nagano,total,1985,Showa,60,2136927,1038070,1098857
20 ,Nagano,0_ 4,1985,Showa,60,126554,64821,61733
20 ,Nagano,5_ 9,1985,Showa,60,150160,77041,73119
20 ,Nagano,10_ 14,1985,Showa,60,169835,87248,82587
20 ,Nagano,15_ 19,1985,Showa,60,141763,72279,69484
20 ,Nagano,20_ 24,1985,Showa,60,113176,54602,58574
20 ,Nagano,25_ 29,1985,Showa,60,124513,62033,62480
20 ,Nagano,30_ 34,1985,Showa,60,144722,72860,71862
20 ,Nagano,35_ 39,1985,Showa,60,171945,87072,84873
20 ,Nagano,40_ 44,1985,Showa,60,150893,75979,74914
20 ,Nagano,45_ 49,1985,Showa,60,137454,67715,69739
20 ,Nagano,50_ 54,1985,Showa,60,144538,70459,74079
20 ,Nagano,55_ 59,1985,Showa,60,147242,70879,76363
20 ,Nagano,60_ 64,1985,Showa,60,122504,54901,67603
20 ,Nagano,65_ 69,1985,Showa,60,95320,40674,54646
20 ,Nagano,70_ 74,1985,Showa,60,82109,34924,47185
20 ,Nagano,75_ 79,1985,Showa,60,59938,24655,35283
20 ,Nagano,80_ 84,1985,Showa,60,35499,13667,21832
20 ,Nagano,over_85,1985,Showa,60,18751,6257,12494
20 ,Nagano,total,1990,Heisei,2,2156627,1048109,1108518
20 ,Nagano,0_ 4,1990,Heisei,2,113466,58103,55363
20 ,Nagano,5_ 9,1990,Heisei,2,128327,65806,62521
20 ,Nagano,10_ 14,1990,Heisei,2,151096,77538,73558
20 ,Nagano,15_ 19,1990,Heisei,2,155667,79467,76200
20 ,Nagano,20_ 24,1990,Heisei,2,118656,57872,60784
20 ,Nagano,25_ 29,1990,Heisei,2,125045,62710,62335
20 ,Nagano,30_ 34,1990,Heisei,2,127102,63950,63152
20 ,Nagano,35_ 39,1990,Heisei,2,146395,74073,72322
20 ,Nagano,40_ 44,1990,Heisei,2,172231,87420,84811
20 ,Nagano,45_ 49,1990,Heisei,2,149648,75262,74386
20 ,Nagano,50_ 54,1990,Heisei,2,135675,66622,69053
20 ,Nagano,55_ 59,1990,Heisei,2,142153,68650,73503
20 ,Nagano,60_ 64,1990,Heisei,2,143553,68375,75178
20 ,Nagano,65_ 69,1990,Heisei,2,117051,51648,65403
20 ,Nagano,70_ 74,1990,Heisei,2,87756,36261,51495
20 ,Nagano,75_ 79,1990,Heisei,2,70265,28338,41927
20 ,Nagano,80_ 84,1990,Heisei,2,44449,16739,27710
20 ,Nagano,over_85,1990,Heisei,2,27685,8987,18698
20 ,Nagano,total,1995,Heisei,7,2193984,1070471,1123513
20 ,Nagano,0_ 4,1995,Heisei,7,108174,55290,52884
20 ,Nagano,5_ 9,1995,Heisei,7,116808,59795,57013
20 ,Nagano,10_ 14,1995,Heisei,7,130285,66725,63560
20 ,Nagano,15_ 19,1995,Heisei,7,137822,70668,67154
20 ,Nagano,20_ 24,1995,Heisei,7,136533,68673,67860
20 ,Nagano,25_ 29,1995,Heisei,7,137417,70130,67287
20 ,Nagano,30_ 34,1995,Heisei,7,131962,67064,64898
20 ,Nagano,35_ 39,1995,Heisei,7,131879,66842,65037
20 ,Nagano,40_ 44,1995,Heisei,7,149331,76022,73309
20 ,Nagano,45_ 49,1995,Heisei,7,173278,88232,85046
20 ,Nagano,50_ 54,1995,Heisei,7,149300,74921,74379
20 ,Nagano,55_ 59,1995,Heisei,7,134746,65744,69002
20 ,Nagano,60_ 64,1995,Heisei,7,139514,66848,72666
20 ,Nagano,65_ 69,1995,Heisei,7,137801,64372,73429
20 ,Nagano,70_ 74,1995,Heisei,7,108928,46542,62386
20 ,Nagano,75_ 79,1995,Heisei,7,76819,30116,46703
20 ,Nagano,80_ 84,1995,Heisei,7,54470,20149,34321
20 ,Nagano,over_85,1995,Heisei,7,38590,12089,26501
20 ,Nagano,total,2000,Heisei,12,2215168,1080986,1134182
20 ,Nagano,0_ 4,2000,Heisei,12,106834,55013,51821
20 ,Nagano,5_ 9,2000,Heisei,12,109570,55911,53659
20 ,Nagano,10_ 14,2000,Heisei,12,117902,60308,57594
20 ,Nagano,15_ 19,2000,Heisei,12,117721,60074,57647
20 ,Nagano,20_ 24,2000,Heisei,12,119340,60210,59130
20 ,Nagano,25_ 29,2000,Heisei,12,156026,80564,75462
20 ,Nagano,30_ 34,2000,Heisei,12,142153,72693,69460
20 ,Nagano,35_ 39,2000,Heisei,12,134417,68247,66170
20 ,Nagano,40_ 44,2000,Heisei,12,133213,67481,65732
20 ,Nagano,45_ 49,2000,Heisei,12,148748,75510,73238
20 ,Nagano,50_ 54,2000,Heisei,12,171588,86824,84764
20 ,Nagano,55_ 59,2000,Heisei,12,148010,73402,74608
20 ,Nagano,60_ 64,2000,Heisei,12,133359,64269,69090
20 ,Nagano,65_ 69,2000,Heisei,12,134188,63186,71002
20 ,Nagano,70_ 74,2000,Heisei,12,128854,58393,70461
20 ,Nagano,75_ 79,2000,Heisei,12,97292,39531,57761
20 ,Nagano,80_ 84,2000,Heisei,12,61454,22219,39235
20 ,Nagano,over_85,2000,Heisei,12,53339,16368,36971
20 ,Nagano,total,2005,Heisei,17,2196114,1068203,1127911
20 ,Nagano,0_ 4,2005,Heisei,17,99957,51291,48666
20 ,Nagano,5_ 9,2005,Heisei,17,106926,55044,51882
20 ,Nagano,10_ 14,2005,Heisei,17,109485,55898,53587
20 ,Nagano,15_ 19,2005,Heisei,17,105262,53778,51484
20 ,Nagano,20_ 24,2005,Heisei,17,97914,49698,48216
20 ,Nagano,25_ 29,2005,Heisei,17,131127,67149,63978
20 ,Nagano,30_ 34,2005,Heisei,17,154908,79613,75295
20 ,Nagano,35_ 39,2005,Heisei,17,140689,71438,69251
20 ,Nagano,40_ 44,2005,Heisei,17,133317,67381,65936
20 ,Nagano,45_ 49,2005,Heisei,17,130910,65791,65119
20 ,Nagano,50_ 54,2005,Heisei,17,146356,73576,72780
20 ,Nagano,55_ 59,2005,Heisei,17,169279,84513,84766
20 ,Nagano,60_ 64,2005,Heisei,17,146555,71933,74622
20 ,Nagano,65_ 69,2005,Heisei,17,129084,61397,67687
20 ,Nagano,70_ 74,2005,Heisei,17,126401,57975,68426
20 ,Nagano,75_ 79,2005,Heisei,17,116157,50210,65947
20 ,Nagano,80_ 84,2005,Heisei,17,80922,30518,50404
20 ,Nagano,over_85,2005,Heisei,17,69420,20078,49342
20 ,Nagano,total,2010,Heisei,22,2152449,1046178,1106271
20 ,Nagano,0_ 4,2010,Heisei,22,89961,46094,43867
20 ,Nagano,5_ 9,2010,Heisei,22,99540,51041,48499
20 ,Nagano,10_ 14,2010,Heisei,22,106241,54786,51455
20 ,Nagano,15_ 19,2010,Heisei,22,98872,50500,48372
20 ,Nagano,20_ 24,2010,Heisei,22,84308,42651,41657
20 ,Nagano,25_ 29,2010,Heisei,22,104461,53632,50829
20 ,Nagano,30_ 34,2010,Heisei,22,129522,66161,63361
20 ,Nagano,35_ 39,2010,Heisei,22,153257,78397,74860
20 ,Nagano,40_ 44,2010,Heisei,22,139022,70401,68621
20 ,Nagano,45_ 49,2010,Heisei,22,131095,65906,65189
20 ,Nagano,50_ 54,2010,Heisei,22,128900,64464,64436
20 ,Nagano,55_ 59,2010,Heisei,22,144713,72160,72553
20 ,Nagano,60_ 64,2010,Heisei,22,167533,82953,84580
20 ,Nagano,65_ 69,2010,Heisei,22,142418,69114,73304
20 ,Nagano,70_ 74,2010,Heisei,22,122520,57024,65496
20 ,Nagano,75_ 79,2010,Heisei,22,114817,50547,64270
20 ,Nagano,80_ 84,2010,Heisei,22,97632,39182,58450
20 ,Nagano,over_85,2010,Heisei,22,91914,27475,64439
20 ,Nagano,total,2015,Heisei,27,2098804,1022129,1076675
20 ,Nagano,0_ 4,2015,Heisei,27,80123,40947,39176
20 ,Nagano,5_ 9,2015,Heisei,27,90234,46213,44021
20 ,Nagano,10_ 14,2015,Heisei,27,99395,50922,48473
20 ,Nagano,15_ 19,2015,Heisei,27,97491,50640,46851
20 ,Nagano,20_ 24,2015,Heisei,27,77986,40076,37910
20 ,Nagano,25_ 29,2015,Heisei,27,90486,46617,43869
20 ,Nagano,30_ 34,2015,Heisei,27,104266,53122,51144
20 ,Nagano,35_ 39,2015,Heisei,27,128581,65482,63099
20 ,Nagano,40_ 44,2015,Heisei,27,151928,77509,74419
20 ,Nagano,45_ 49,2015,Heisei,27,137073,69324,67749
20 ,Nagano,50_ 54,2015,Heisei,27,129068,64813,64255
20 ,Nagano,55_ 59,2015,Heisei,27,127175,63210,63965
20 ,Nagano,60_ 64,2015,Heisei,27,142811,70747,72064
20 ,Nagano,65_ 69,2015,Heisei,27,163385,80101,83284
20 ,Nagano,70_ 74,2015,Heisei,27,135393,64403,70990
20 ,Nagano,75_ 79,2015,Heisei,27,112479,50721,61758
20 ,Nagano,80_ 84,2015,Heisei,27,98119,40563,57556
20 ,Nagano,over_85,2015,Heisei,27,116709,37022,79687
21 ,Gifu,total,1920,Taisho,9,1070407,536334,534073
21 ,Gifu,0_ 4,1920,Taisho,9,148742,75059,73683
21 ,Gifu,5_ 9,1920,Taisho,9,137825,69798,68027
21 ,Gifu,10_ 14,1920,Taisho,9,114993,58209,56784
21 ,Gifu,15_ 19,1920,Taisho,9,94436,46961,47475
21 ,Gifu,20_ 24,1920,Taisho,9,76988,37499,39489
21 ,Gifu,25_ 29,1920,Taisho,9,69777,35154,34623
21 ,Gifu,30_ 34,1920,Taisho,9,66145,33456,32689
21 ,Gifu,35_ 39,1920,Taisho,9,65094,32502,32592
21 ,Gifu,40_ 44,1920,Taisho,9,64516,32636,31880
21 ,Gifu,45_ 49,1920,Taisho,9,51521,26214,25307
21 ,Gifu,50_ 54,1920,Taisho,9,42579,21717,20862
21 ,Gifu,55_ 59,1920,Taisho,9,36058,18253,17805
21 ,Gifu,60_ 64,1920,Taisho,9,35944,18164,17780
21 ,Gifu,65_ 69,1920,Taisho,9,29166,14203,14963
21 ,Gifu,70_ 74,1920,Taisho,9,20172,9594,10578
21 ,Gifu,75_ 79,1920,Taisho,9,10702,4714,5988
21 ,Gifu,over_80,1920,Taisho,9,5749,2201,3548
21 ,Gifu,total,1925,Taisho,14,1132557,567837,564720
21 ,Gifu,0_ 4,1925,Taisho,14,162524,82094,80430
21 ,Gifu,5_ 9,1925,Taisho,14,136589,69296,67293
21 ,Gifu,10_ 14,1925,Taisho,14,130291,65676,64615
21 ,Gifu,15_ 19,1925,Taisho,14,101062,48548,52514
21 ,Gifu,20_ 24,1925,Taisho,14,86750,42713,44037
21 ,Gifu,25_ 29,1925,Taisho,14,75592,38701,36891
21 ,Gifu,30_ 34,1925,Taisho,14,67005,34285,32720
21 ,Gifu,35_ 39,1925,Taisho,14,63682,32847,30835
21 ,Gifu,40_ 44,1925,Taisho,14,62248,31476,30772
21 ,Gifu,45_ 49,1925,Taisho,14,61135,31140,29995
21 ,Gifu,50_ 54,1925,Taisho,14,47820,24209,23611
21 ,Gifu,55_ 59,1925,Taisho,14,38421,19495,18926
21 ,Gifu,60_ 64,1925,Taisho,14,31198,15453,15745
21 ,Gifu,65_ 69,1925,Taisho,14,28731,14096,14635
21 ,Gifu,70_ 74,1925,Taisho,14,21041,9902,11139
21 ,Gifu,75_ 79,1925,Taisho,14,11982,5386,6596
21 ,Gifu,80_ 84,1925,Taisho,14,4854,1969,2885
21 ,Gifu,over_85,1925,Taisho,14,1632,551,1081
21 ,Gifu,total,1930,Showa,5,1178405,591049,587356
21 ,Gifu,0_ 4,1930,Showa,5,170773,86410,84363
21 ,Gifu,5_ 9,1930,Showa,5,148986,75364,73622
21 ,Gifu,10_ 14,1930,Showa,5,126448,64537,61911
21 ,Gifu,15_ 19,1930,Showa,5,107050,52189,54861
21 ,Gifu,20_ 24,1930,Showa,5,89291,43376,45915
21 ,Gifu,25_ 29,1930,Showa,5,81710,41317,40393
21 ,Gifu,30_ 34,1930,Showa,5,71009,36342,34667
21 ,Gifu,35_ 39,1930,Showa,5,63551,32692,30859
21 ,Gifu,40_ 44,1930,Showa,5,59889,30852,29037
21 ,Gifu,45_ 49,1930,Showa,5,58724,29639,29085
21 ,Gifu,50_ 54,1930,Showa,5,56887,28724,28163
21 ,Gifu,55_ 59,1930,Showa,5,43412,21854,21558
21 ,Gifu,60_ 64,1930,Showa,5,33597,16715,16882
21 ,Gifu,65_ 69,1930,Showa,5,25463,12327,13136
21 ,Gifu,70_ 74,1930,Showa,5,20975,9910,11065
21 ,Gifu,75_ 79,1930,Showa,5,12987,5738,7249
21 ,Gifu,over_80,1930,Showa,5,7653,3063,4590
21 ,Gifu,total,1935,Showa,10,1225799,612366,613433
21 ,Gifu,0_ 4,1935,Showa,10,171319,86376,84943
21 ,Gifu,5_ 9,1935,Showa,10,159293,80746,78547
21 ,Gifu,10_ 14,1935,Showa,10,139309,70638,68671
21 ,Gifu,15_ 19,1935,Showa,10,100119,48012,52107
21 ,Gifu,20_ 24,1935,Showa,10,94458,44625,49833
21 ,Gifu,25_ 29,1935,Showa,10,84979,42364,42615
21 ,Gifu,30_ 34,1935,Showa,10,78658,40043,38615
21 ,Gifu,35_ 39,1935,Showa,10,68304,35375,32929
21 ,Gifu,40_ 44,1935,Showa,10,60500,31340,29160
21 ,Gifu,45_ 49,1935,Showa,10,56903,29361,27542
21 ,Gifu,50_ 54,1935,Showa,10,54725,27574,27151
21 ,Gifu,55_ 59,1935,Showa,10,51831,26091,25740
21 ,Gifu,60_ 64,1935,Showa,10,38143,18974,19169
21 ,Gifu,65_ 69,1935,Showa,10,27152,13130,14022
21 ,Gifu,70_ 74,1935,Showa,10,18699,8673,10026
21 ,Gifu,75_ 79,1935,Showa,10,12758,5685,7073
21 ,Gifu,over_80,1935,Showa,10,8649,3359,5290
21 ,Gifu,total,1940,Showa,15,1264945,632766,632179
21 ,Gifu,0_ 4,1940,Showa,15,164228,83469,80759
21 ,Gifu,5_ 9,1940,Showa,15,159501,80615,78886
21 ,Gifu,10_ 14,1940,Showa,15,151387,76485,74902
21 ,Gifu,15_ 19,1940,Showa,15,110828,52875,57953
21 ,Gifu,20_ 24,1940,Showa,15,95667,48321,47346
21 ,Gifu,25_ 29,1940,Showa,15,89059,43905,45154
21 ,Gifu,30_ 34,1940,Showa,15,79302,39228,40074
21 ,Gifu,35_ 39,1940,Showa,15,74529,37807,36722
21 ,Gifu,40_ 44,1940,Showa,15,64833,33599,31234
21 ,Gifu,45_ 49,1940,Showa,15,56905,29480,27425
21 ,Gifu,50_ 54,1940,Showa,15,53011,27320,25691
21 ,Gifu,55_ 59,1940,Showa,15,49727,24887,24840
21 ,Gifu,60_ 64,1940,Showa,15,45443,22446,22997
21 ,Gifu,65_ 69,1940,Showa,15,31027,14952,16075
21 ,Gifu,70_ 74,1940,Showa,15,19786,9152,10634
21 ,Gifu,75_ 79,1940,Showa,15,11416,4959,6457
21 ,Gifu,80_ 84,1940,Showa,15,5817,2383,3434
21 ,Gifu,over_85,1940,Showa,15,2478,882,1596
21 ,Gifu,total,1945,Showa,20,1518649,715800,802849
21 ,Gifu,1_ 5,1945,Showa,20,201074,101849,99225
21 ,Gifu,6_ 10,1945,Showa,20,191097,96826,94271
21 ,Gifu,11_ 15,1945,Showa,20,184657,93191,91466
21 ,Gifu,16_ 20,1945,Showa,20,159280,77679,81601
21 ,Gifu,21_ 25,1945,Showa,20,107623,37243,70380
21 ,Gifu,26_ 30,1945,Showa,20,91277,32295,58982
21 ,Gifu,31_ 35,1945,Showa,20,92797,36794,56003
21 ,Gifu,36_ 40,1945,Showa,20,89330,41622,47708
21 ,Gifu,41_ 45,1945,Showa,20,82867,41574,41293
21 ,Gifu,46_ 50,1945,Showa,20,70626,36386,34240
21 ,Gifu,51_ 55,1945,Showa,20,60258,30923,29335
21 ,Gifu,56_ 60,1945,Showa,20,54457,27587,26870
21 ,Gifu,61_ 65,1945,Showa,20,47739,23078,24661
21 ,Gifu,66_ 70,1945,Showa,20,40687,19198,21489
21 ,Gifu,71_ 75,1945,Showa,20,24944,11391,13553
21 ,Gifu,76_ 80,1945,Showa,20,12355,5337,7018
21 ,Gifu,81_ 85,1945,Showa,20,5533,2127,3406
21 ,Gifu,86以上,1945,Showa,20,2048,700,1348
21 ,Gifu,total,1950,Showa,25,1544538,762295,782243
21 ,Gifu,0_ 4,1950,Showa,25,202918,103540,99378
21 ,Gifu,5_ 9,1950,Showa,25,177214,89738,87476
21 ,Gifu,10_ 14,1950,Showa,25,169159,85781,83378
21 ,Gifu,15_ 19,1950,Showa,25,154880,78134,76746
21 ,Gifu,20_ 24,1950,Showa,25,142604,71839,70765
21 ,Gifu,25_ 29,1950,Showa,25,109736,49989,59747
21 ,Gifu,30_ 34,1950,Showa,25,92831,42132,50699
21 ,Gifu,35_ 39,1950,Showa,25,90775,41866,48909
21 ,Gifu,40_ 44,1950,Showa,25,80708,39567,41141
21 ,Gifu,45_ 49,1950,Showa,25,73407,37121,36286
21 ,Gifu,50_ 54,1950,Showa,25,61313,31514,29799
21 ,Gifu,55_ 59,1950,Showa,25,53029,27034,25995
21 ,Gifu,60_ 64,1950,Showa,25,46038,23017,23021
21 ,Gifu,65_ 69,1950,Showa,25,38033,18168,19865
21 ,Gifu,70_ 74,1950,Showa,25,28750,13232,15518
21 ,Gifu,75_ 79,1950,Showa,25,14896,6509,8387
21 ,Gifu,over_80,1950,Showa,25,8202,3088,5114
21 ,Gifu,total,1955,Showa,30,1583605,774062,809543
21 ,Gifu,0_ 4,1955,Showa,30,157269,80332,76937
21 ,Gifu,5_ 9,1955,Showa,30,196016,100037,95979
21 ,Gifu,10_ 14,1955,Showa,30,172872,87478,85394
21 ,Gifu,15_ 19,1955,Showa,30,147293,70624,76669
21 ,Gifu,20_ 24,1955,Showa,30,142015,67343,74672
21 ,Gifu,25_ 29,1955,Showa,30,132878,66430,66448
21 ,Gifu,30_ 34,1955,Showa,30,105837,48113,57724
21 ,Gifu,35_ 39,1955,Showa,30,89190,40362,48828
21 ,Gifu,40_ 44,1955,Showa,30,87524,40380,47144
21 ,Gifu,45_ 49,1955,Showa,30,77291,37898,39393
21 ,Gifu,50_ 54,1955,Showa,30,69786,35300,34486
21 ,Gifu,55_ 59,1955,Showa,30,57607,29399,28208
21 ,Gifu,60_ 64,1955,Showa,30,47916,24276,23640
21 ,Gifu,65_ 69,1955,Showa,30,39392,19380,20012
21 ,Gifu,70_ 74,1955,Showa,30,29904,13851,16053
21 ,Gifu,75_ 79,1955,Showa,30,19685,8648,11037
21 ,Gifu,80_ 84,1955,Showa,30,8170,3250,4920
21 ,Gifu,over_85,1955,Showa,30,2958,961,1997
21 ,Gifu,total,1960,Showa,35,1638399,796825,841574
21 ,Gifu,0_ 4,1960,Showa,35,136152,69713,66439
21 ,Gifu,5_ 9,1960,Showa,35,156936,80181,76755
21 ,Gifu,10_ 14,1960,Showa,35,194926,99349,95577
21 ,Gifu,15_ 19,1960,Showa,35,160849,73807,87042
21 ,Gifu,20_ 24,1960,Showa,35,137639,63248,74391
21 ,Gifu,25_ 29,1960,Showa,35,139392,68858,70534
21 ,Gifu,30_ 34,1960,Showa,35,131853,66841,65012
21 ,Gifu,35_ 39,1960,Showa,35,104956,48023,56933
21 ,Gifu,40_ 44,1960,Showa,35,87898,40053,47845
21 ,Gifu,45_ 49,1960,Showa,35,85317,39509,45808
21 ,Gifu,50_ 54,1960,Showa,35,74346,36516,37830
21 ,Gifu,55_ 59,1960,Showa,35,66359,33434,32925
21 ,Gifu,60_ 64,1960,Showa,35,52944,26756,26188
21 ,Gifu,65_ 69,1960,Showa,35,41663,20687,20976
21 ,Gifu,70_ 74,1960,Showa,35,31918,15200,16718
21 ,Gifu,75_ 79,1960,Showa,35,20566,9003,11563
21 ,Gifu,80_ 84,1960,Showa,35,10764,4322,6442
21 ,Gifu,over_85,1960,Showa,35,3921,1325,2596
21 ,Gifu,total,1965,Showa,40,1700365,821444,878921
21 ,Gifu,0_ 4,1965,Showa,40,142911,72806,70105
21 ,Gifu,5_ 9,1965,Showa,40,136203,69317,66886
21 ,Gifu,10_ 14,1965,Showa,40,157322,79996,77326
21 ,Gifu,15_ 19,1965,Showa,40,192905,89321,103584
21 ,Gifu,20_ 24,1965,Showa,40,143256,64012,79244
21 ,Gifu,25_ 29,1965,Showa,40,135841,65582,70259
21 ,Gifu,30_ 34,1965,Showa,40,138149,69013,69136
21 ,Gifu,35_ 39,1965,Showa,40,130698,66159,64539
21 ,Gifu,40_ 44,1965,Showa,40,103249,47191,56058
21 ,Gifu,45_ 49,1965,Showa,40,85857,38942,46915
21 ,Gifu,50_ 54,1965,Showa,40,82396,38130,44266
21 ,Gifu,55_ 59,1965,Showa,40,70656,34541,36115
21 ,Gifu,60_ 64,1965,Showa,40,61135,30406,30729
21 ,Gifu,65_ 69,1965,Showa,40,46589,23056,23533
21 ,Gifu,70_ 74,1965,Showa,40,33904,16268,17636
21 ,Gifu,75_ 79,1965,Showa,40,22462,10232,12230
21 ,Gifu,80_ 84,1965,Showa,40,11517,4630,6887
21 ,Gifu,over_85,1965,Showa,40,5315,1842,3473
21 ,Gifu,total,1970,Showa,45,1758954,848786,910168
21 ,Gifu,0_ 4,1970,Showa,45,147138,75498,71640
21 ,Gifu,5_ 9,1970,Showa,45,143387,73269,70118
21 ,Gifu,10_ 14,1970,Showa,45,136335,69519,66816
21 ,Gifu,15_ 19,1970,Showa,45,157204,72486,84718
21 ,Gifu,20_ 24,1970,Showa,45,165947,75037,90910
21 ,Gifu,25_ 29,1970,Showa,45,140585,68151,72434
21 ,Gifu,30_ 34,1970,Showa,45,135123,66233,68890
21 ,Gifu,35_ 39,1970,Showa,45,136763,68288,68475
21 ,Gifu,40_ 44,1970,Showa,45,128303,64705,63598
21 ,Gifu,45_ 49,1970,Showa,45,101625,46199,55426
21 ,Gifu,50_ 54,1970,Showa,45,83712,37728,45984
21 ,Gifu,55_ 59,1970,Showa,45,78381,35917,42464
21 ,Gifu,60_ 64,1970,Showa,45,66152,31703,34449
21 ,Gifu,65_ 69,1970,Showa,45,54997,26638,28359
21 ,Gifu,70_ 74,1970,Showa,45,38916,18432,20484
21 ,Gifu,75_ 79,1970,Showa,45,24847,11282,13565
21 ,Gifu,80_ 84,1970,Showa,45,13217,5472,7745
21 ,Gifu,over_85,1970,Showa,45,6322,2229,4093
21 ,Gifu,total,1975,Showa,50,1867978,907382,960596
21 ,Gifu,0_ 4,1975,Showa,50,167163,85524,81639
21 ,Gifu,5_ 9,1975,Showa,50,150669,77239,73430
21 ,Gifu,10_ 14,1975,Showa,50,145149,74186,70963
21 ,Gifu,15_ 19,1975,Showa,50,137228,65399,71829
21 ,Gifu,20_ 24,1975,Showa,50,135518,61235,74283
21 ,Gifu,25_ 29,1975,Showa,50,167437,82565,84872
21 ,Gifu,30_ 34,1975,Showa,50,145270,71675,73595
21 ,Gifu,35_ 39,1975,Showa,50,137254,67761,69493
21 ,Gifu,40_ 44,1975,Showa,50,137284,68677,68607
21 ,Gifu,45_ 49,1975,Showa,50,128062,64524,63538
21 ,Gifu,50_ 54,1975,Showa,50,100047,45276,54771
21 ,Gifu,55_ 59,1975,Showa,50,81208,36315,44893
21 ,Gifu,60_ 64,1975,Showa,50,75335,34103,41232
21 ,Gifu,65_ 69,1975,Showa,50,61130,28592,32538
21 ,Gifu,70_ 74,1975,Showa,50,47044,22009,25035
21 ,Gifu,75_ 79,1975,Showa,50,29341,13122,16219
21 ,Gifu,80_ 84,1975,Showa,50,15126,6353,8773
21 ,Gifu,over_85,1975,Showa,50,7511,2716,4795
21 ,Gifu,total,1980,Showa,55,1960107,954018,1006089
21 ,Gifu,0_ 4,1980,Showa,55,142688,73315,69373
21 ,Gifu,5_ 9,1980,Showa,55,173595,88814,84781
21 ,Gifu,10_ 14,1980,Showa,55,154466,79107,75359
21 ,Gifu,15_ 19,1980,Showa,55,143397,70182,73215
21 ,Gifu,20_ 24,1980,Showa,55,117854,53738,64116
21 ,Gifu,25_ 29,1980,Showa,55,138411,66974,71437
21 ,Gifu,30_ 34,1980,Showa,55,172720,86139,86581
21 ,Gifu,35_ 39,1980,Showa,55,149564,74196,75368
21 ,Gifu,40_ 44,1980,Showa,55,138756,68679,70077
21 ,Gifu,45_ 49,1980,Showa,55,136376,67953,68423
21 ,Gifu,50_ 54,1980,Showa,55,126313,63107,63206
21 ,Gifu,55_ 59,1980,Showa,55,97784,43885,53899
21 ,Gifu,60_ 64,1980,Showa,55,78197,34574,43623
21 ,Gifu,65_ 69,1980,Showa,55,70223,31070,39153
21 ,Gifu,70_ 74,1980,Showa,55,53804,24243,29561
21 ,Gifu,75_ 79,1980,Showa,55,36929,16413,20516
21 ,Gifu,80_ 84,1980,Showa,55,19420,8060,11360
21 ,Gifu,over_85,1980,Showa,55,9519,3506,6013
21 ,Gifu,total,1985,Showa,60,2028536,986919,1041617
21 ,Gifu,0_ 4,1985,Showa,60,124269,63461,60808
21 ,Gifu,5_ 9,1985,Showa,60,147392,75705,71687
21 ,Gifu,10_ 14,1985,Showa,60,177032,90637,86395
21 ,Gifu,15_ 19,1985,Showa,60,153123,76516,76607
21 ,Gifu,20_ 24,1985,Showa,60,123985,56832,67153
21 ,Gifu,25_ 29,1985,Showa,60,119833,57878,61955
21 ,Gifu,30_ 34,1985,Showa,60,142334,69576,72758
21 ,Gifu,35_ 39,1985,Showa,60,177018,88695,88323
21 ,Gifu,40_ 44,1985,Showa,60,151276,75244,76032
21 ,Gifu,45_ 49,1985,Showa,60,138373,68480,69893
21 ,Gifu,50_ 54,1985,Showa,60,134793,66806,67987
21 ,Gifu,55_ 59,1985,Showa,60,123821,61385,62436
21 ,Gifu,60_ 64,1985,Showa,60,94778,42044,52734
21 ,Gifu,65_ 69,1985,Showa,60,73863,32100,41763
21 ,Gifu,70_ 74,1985,Showa,60,63340,27190,36150
21 ,Gifu,75_ 79,1985,Showa,60,44245,18918,25327
21 ,Gifu,80_ 84,1985,Showa,60,25543,10521,15022
21 ,Gifu,over_85,1985,Showa,60,13406,4861,8545
21 ,Gifu,total,1990,Heisei,2,2066569,1003933,1062636
21 ,Gifu,0_ 4,1990,Heisei,2,109613,56108,53505
21 ,Gifu,5_ 9,1990,Heisei,2,128070,65428,62642
21 ,Gifu,10_ 14,1990,Heisei,2,149982,77031,72951
21 ,Gifu,15_ 19,1990,Heisei,2,173119,86635,86484
21 ,Gifu,20_ 24,1990,Heisei,2,132376,62014,70362
21 ,Gifu,25_ 29,1990,Heisei,2,124688,60441,64247
21 ,Gifu,30_ 34,1990,Heisei,2,122048,59707,62341
21 ,Gifu,35_ 39,1990,Heisei,2,145331,71343,73988
21 ,Gifu,40_ 44,1990,Heisei,2,178639,89751,88888
21 ,Gifu,45_ 49,1990,Heisei,2,150600,75005,75595
21 ,Gifu,50_ 54,1990,Heisei,2,136596,67274,69322
21 ,Gifu,55_ 59,1990,Heisei,2,132054,64939,67115
21 ,Gifu,60_ 64,1990,Heisei,2,119882,58701,61181
21 ,Gifu,65_ 69,1990,Heisei,2,90114,39269,50845
21 ,Gifu,70_ 74,1990,Heisei,2,67536,28433,39103
21 ,Gifu,75_ 79,1990,Heisei,2,53610,21850,31760
21 ,Gifu,80_ 84,1990,Heisei,2,32220,12613,19607
21 ,Gifu,over_85,1990,Heisei,2,19114,6769,12345
21 ,Gifu,total,1995,Heisei,7,2100315,1019549,1080766
21 ,Gifu,0_ 4,1995,Heisei,7,102725,52501,50224
21 ,Gifu,5_ 9,1995,Heisei,7,114289,58554,55735
21 ,Gifu,10_ 14,1995,Heisei,7,130719,66756,63963
21 ,Gifu,15_ 19,1995,Heisei,7,147238,74306,72932
21 ,Gifu,20_ 24,1995,Heisei,7,155435,74758,80677
21 ,Gifu,25_ 29,1995,Heisei,7,134411,65917,68494
21 ,Gifu,30_ 34,1995,Heisei,7,128592,63316,65276
21 ,Gifu,35_ 39,1995,Heisei,7,126147,62059,64088
21 ,Gifu,40_ 44,1995,Heisei,7,147338,72569,74769
21 ,Gifu,45_ 49,1995,Heisei,7,178832,89889,88943
21 ,Gifu,50_ 54,1995,Heisei,7,149591,74171,75420
21 ,Gifu,55_ 59,1995,Heisei,7,134624,65885,68739
21 ,Gifu,60_ 64,1995,Heisei,7,128086,62168,65918
21 ,Gifu,65_ 69,1995,Heisei,7,113565,54411,59154
21 ,Gifu,70_ 74,1995,Heisei,7,83299,35110,48189
21 ,Gifu,75_ 79,1995,Heisei,7,58248,23195,35053
21 ,Gifu,80_ 84,1995,Heisei,7,40642,15116,25526
21 ,Gifu,over_85,1995,Heisei,7,26455,8810,17645
21 ,Gifu,total,2000,Heisei,12,2107700,1022186,1085514
21 ,Gifu,0_ 4,2000,Heisei,12,102388,52421,49967
21 ,Gifu,5_ 9,2000,Heisei,12,105062,53692,51370
21 ,Gifu,10_ 14,2000,Heisei,12,115319,59167,56152
21 ,Gifu,15_ 19,2000,Heisei,12,125873,63896,61977
21 ,Gifu,20_ 24,2000,Heisei,12,130042,63291,66751
21 ,Gifu,25_ 29,2000,Heisei,12,154424,76724,77700
21 ,Gifu,30_ 34,2000,Heisei,12,134556,66752,67804
21 ,Gifu,35_ 39,2000,Heisei,12,129510,63874,65636
21 ,Gifu,40_ 44,2000,Heisei,12,126573,62147,64426
21 ,Gifu,45_ 49,2000,Heisei,12,146117,71856,74261
21 ,Gifu,50_ 54,2000,Heisei,12,176176,88136,88040
21 ,Gifu,55_ 59,2000,Heisei,12,146644,72244,74400
21 ,Gifu,60_ 64,2000,Heisei,12,131149,63497,67652
21 ,Gifu,65_ 69,2000,Heisei,12,121430,57766,63664
21 ,Gifu,70_ 74,2000,Heisei,12,104518,48542,55976
21 ,Gifu,75_ 79,2000,Heisei,12,73121,29251,43870
21 ,Gifu,80_ 84,2000,Heisei,12,45903,16667,29236
21 ,Gifu,over_85,2000,Heisei,12,38196,11768,26428
21 ,Gifu,total,2005,Heisei,17,2107226,1020570,1086656
21 ,Gifu,0_ 4,2005,Heisei,17,95993,48964,47029
21 ,Gifu,5_ 9,2005,Heisei,17,104332,53406,50926
21 ,Gifu,10_ 14,2005,Heisei,17,105520,53972,51548
21 ,Gifu,15_ 19,2005,Heisei,17,111823,57170,54653
21 ,Gifu,20_ 24,2005,Heisei,17,113015,55383,57632
21 ,Gifu,25_ 29,2005,Heisei,17,129352,64560,64792
21 ,Gifu,30_ 34,2005,Heisei,17,152743,76818,75925
21 ,Gifu,35_ 39,2005,Heisei,17,134823,67141,67682
21 ,Gifu,40_ 44,2005,Heisei,17,129722,63975,65747
21 ,Gifu,45_ 49,2005,Heisei,17,125707,61714,63993
21 ,Gifu,50_ 54,2005,Heisei,17,144086,70518,73568
21 ,Gifu,55_ 59,2005,Heisei,17,172929,85911,87018
21 ,Gifu,60_ 64,2005,Heisei,17,143383,69970,73413
21 ,Gifu,65_ 69,2005,Heisei,17,125659,59942,65717
21 ,Gifu,70_ 74,2005,Heisei,17,113083,52298,60785
21 ,Gifu,75_ 79,2005,Heisei,17,92933,40986,51947
21 ,Gifu,80_ 84,2005,Heisei,17,60048,22091,37957
21 ,Gifu,over_85,2005,Heisei,17,50401,14657,35744
21 ,Gifu,total,2010,Heisei,22,2080773,1006247,1074526
21 ,Gifu,0_ 4,2010,Heisei,22,87713,44797,42916
21 ,Gifu,5_ 9,2010,Heisei,22,97465,49745,47720
21 ,Gifu,10_ 14,2010,Heisei,22,104570,53590,50980
21 ,Gifu,15_ 19,2010,Heisei,22,101669,51588,50081
21 ,Gifu,20_ 24,2010,Heisei,22,98504,48499,50005
21 ,Gifu,25_ 29,2010,Heisei,22,109332,54739,54593
21 ,Gifu,30_ 34,2010,Heisei,22,126322,63778,62544
21 ,Gifu,35_ 39,2010,Heisei,22,151474,76418,75056
21 ,Gifu,40_ 44,2010,Heisei,22,133807,66608,67199
21 ,Gifu,45_ 49,2010,Heisei,22,127886,62923,64963
21 ,Gifu,50_ 54,2010,Heisei,22,123549,60298,63251
21 ,Gifu,55_ 59,2010,Heisei,22,141274,68611,72663
21 ,Gifu,60_ 64,2010,Heisei,22,168983,83294,85689
21 ,Gifu,65_ 69,2010,Heisei,22,137783,66417,71366
21 ,Gifu,70_ 74,2010,Heisei,22,117770,54938,62832
21 ,Gifu,75_ 79,2010,Heisei,22,101215,44619,56596
21 ,Gifu,80_ 84,2010,Heisei,22,76592,31052,45540
21 ,Gifu,over_85,2010,Heisei,22,66039,19108,46931
21 ,Gifu,total,2015,Heisei,27,2031903,983850,1048053
21 ,Gifu,0_ 4,2015,Heisei,27,80139,41029,39110
21 ,Gifu,5_ 9,2015,Heisei,27,89353,45763,43590
21 ,Gifu,10_ 14,2015,Heisei,27,97506,49891,47615
21 ,Gifu,15_ 19,2015,Heisei,27,101629,51776,49853
21 ,Gifu,20_ 24,2015,Heisei,27,89684,44549,45135
21 ,Gifu,25_ 29,2015,Heisei,27,94759,48185,46574
21 ,Gifu,30_ 34,2015,Heisei,27,106169,53676,52493
21 ,Gifu,35_ 39,2015,Heisei,27,125051,63465,61586
21 ,Gifu,40_ 44,2015,Heisei,27,150626,75954,74672
21 ,Gifu,45_ 49,2015,Heisei,27,132202,65793,66409
21 ,Gifu,50_ 54,2015,Heisei,27,125737,61782,63955
21 ,Gifu,55_ 59,2015,Heisei,27,121455,59087,62368
21 ,Gifu,60_ 64,2015,Heisei,27,138119,66871,71248
21 ,Gifu,65_ 69,2015,Heisei,27,162641,79261,83380
21 ,Gifu,70_ 74,2015,Heisei,27,129387,61067,68320
21 ,Gifu,75_ 79,2015,Heisei,27,106404,47757,58647
21 ,Gifu,80_ 84,2015,Heisei,27,84375,34664,49711
21 ,Gifu,over_85,2015,Heisei,27,84764,26420,58344
22 ,Shizuoka,total,1920,Taisho,9,1550387,774169,776218
22 ,Shizuoka,0_ 4,1920,Taisho,9,223368,112557,110811
22 ,Shizuoka,5_ 9,1920,Taisho,9,199697,101120,98577
22 ,Shizuoka,10_ 14,1920,Taisho,9,172701,87407,85294
22 ,Shizuoka,15_ 19,1920,Taisho,9,143926,70802,73124
22 ,Shizuoka,20_ 24,1920,Taisho,9,119374,57562,61812
22 ,Shizuoka,25_ 29,1920,Taisho,9,105073,52448,52625
22 ,Shizuoka,30_ 34,1920,Taisho,9,102051,51207,50844
22 ,Shizuoka,35_ 39,1920,Taisho,9,91369,45426,45943
22 ,Shizuoka,40_ 44,1920,Taisho,9,83524,42500,41024
22 ,Shizuoka,45_ 49,1920,Taisho,9,68349,34624,33725
22 ,Shizuoka,50_ 54,1920,Taisho,9,55959,28733,27226
22 ,Shizuoka,55_ 59,1920,Taisho,9,50898,25921,24977
22 ,Shizuoka,60_ 64,1920,Taisho,9,46903,23332,23571
22 ,Shizuoka,65_ 69,1920,Taisho,9,38901,19005,19896
22 ,Shizuoka,70_ 74,1920,Taisho,9,25934,12314,13620
22 ,Shizuoka,75_ 79,1920,Taisho,9,14602,6302,8300
22 ,Shizuoka,over_80,1920,Taisho,9,7758,2909,4849
22 ,Shizuoka,total,1925,Taisho,14,1671217,835521,835696
22 ,Shizuoka,0_ 4,1925,Taisho,14,248961,125581,123380
22 ,Shizuoka,5_ 9,1925,Taisho,14,207437,104761,102676
22 ,Shizuoka,10_ 14,1925,Taisho,14,194301,98458,95843
22 ,Shizuoka,15_ 19,1925,Taisho,14,156948,76582,80366
22 ,Shizuoka,20_ 24,1925,Taisho,14,131951,65213,66738
22 ,Shizuoka,25_ 29,1925,Taisho,14,115665,58266,57399
22 ,Shizuoka,30_ 34,1925,Taisho,14,100355,50737,49618
22 ,Shizuoka,35_ 39,1925,Taisho,14,98520,49927,48593
22 ,Shizuoka,40_ 44,1925,Taisho,14,87162,43559,43603
22 ,Shizuoka,45_ 49,1925,Taisho,14,79393,40293,39100
22 ,Shizuoka,50_ 54,1925,Taisho,14,63935,32290,31645
22 ,Shizuoka,55_ 59,1925,Taisho,14,51082,25879,25203
22 ,Shizuoka,60_ 64,1925,Taisho,14,44691,22210,22481
22 ,Shizuoka,65_ 69,1925,Taisho,14,38223,18553,19670
22 ,Shizuoka,70_ 74,1925,Taisho,14,28142,12974,15168
22 ,Shizuoka,75_ 79,1925,Taisho,14,15722,6996,8726
22 ,Shizuoka,80_ 84,1925,Taisho,14,6647,2570,4077
22 ,Shizuoka,over_85,1925,Taisho,14,2082,672,1410
22 ,Shizuoka,total,1930,Showa,5,1797805,900640,897165
22 ,Shizuoka,0_ 4,1930,Showa,5,269203,135712,133491
22 ,Shizuoka,5_ 9,1930,Showa,5,232636,117340,115296
22 ,Shizuoka,10_ 14,1930,Showa,5,199589,101637,97952
22 ,Shizuoka,15_ 19,1930,Showa,5,173543,86329,87214
22 ,Shizuoka,20_ 24,1930,Showa,5,140627,69156,71471
22 ,Shizuoka,25_ 29,1930,Showa,5,124585,62623,61962
22 ,Shizuoka,30_ 34,1930,Showa,5,111667,57052,54615
22 ,Shizuoka,35_ 39,1930,Showa,5,97858,49873,47985
22 ,Shizuoka,40_ 44,1930,Showa,5,94517,48147,46370
22 ,Shizuoka,45_ 49,1930,Showa,5,82969,41420,41549
22 ,Shizuoka,50_ 54,1930,Showa,5,74187,37519,36668
22 ,Shizuoka,55_ 59,1930,Showa,5,58445,29150,29295
22 ,Shizuoka,60_ 64,1930,Showa,5,44923,22235,22688
22 ,Shizuoka,65_ 69,1930,Showa,5,36840,17687,19153
22 ,Shizuoka,70_ 74,1930,Showa,5,28194,13069,15125
22 ,Shizuoka,75_ 79,1930,Showa,5,17568,7624,9944
22 ,Shizuoka,over_80,1930,Showa,5,10454,4067,6387
22 ,Shizuoka,total,1935,Showa,10,1939860,966250,973610
22 ,Shizuoka,0_ 4,1935,Showa,10,274446,138836,135610
22 ,Shizuoka,5_ 9,1935,Showa,10,255960,128844,127116
22 ,Shizuoka,10_ 14,1935,Showa,10,229016,115271,113745
22 ,Shizuoka,15_ 19,1935,Showa,10,181258,87994,93264
22 ,Shizuoka,20_ 24,1935,Showa,10,155933,74209,81724
22 ,Shizuoka,25_ 29,1935,Showa,10,135095,67940,67155
22 ,Shizuoka,30_ 34,1935,Showa,10,122169,62061,60108
22 ,Shizuoka,35_ 39,1935,Showa,10,109142,56176,52966
22 ,Shizuoka,40_ 44,1935,Showa,10,94191,48324,45867
22 ,Shizuoka,45_ 49,1935,Showa,10,90494,46142,44352
22 ,Shizuoka,50_ 54,1935,Showa,10,77894,38699,39195
22 ,Shizuoka,55_ 59,1935,Showa,10,68409,34199,34210
22 ,Shizuoka,60_ 64,1935,Showa,10,51877,25427,26450
22 ,Shizuoka,65_ 69,1935,Showa,10,36879,17538,19341
22 ,Shizuoka,70_ 74,1935,Showa,10,27550,12485,15065
22 ,Shizuoka,75_ 79,1935,Showa,10,17666,7510,10156
22 ,Shizuoka,over_80,1935,Showa,10,11881,4595,7286
22 ,Shizuoka,total,1940,Showa,15,2017442,996528,1020914
22 ,Shizuoka,0_ 4,1940,Showa,15,261584,132518,129066
22 ,Shizuoka,5_ 9,1940,Showa,15,259368,131146,128222
22 ,Shizuoka,10_ 14,1940,Showa,15,248803,124113,124690
22 ,Shizuoka,15_ 19,1940,Showa,15,196914,91430,105484
22 ,Shizuoka,20_ 24,1940,Showa,15,161262,79123,82139
22 ,Shizuoka,25_ 29,1940,Showa,15,142141,69041,73100
22 ,Shizuoka,30_ 34,1940,Showa,15,126138,62771,63367
22 ,Shizuoka,35_ 39,1940,Showa,15,116063,58528,57535
22 ,Shizuoka,40_ 44,1940,Showa,15,103180,52792,50388
22 ,Shizuoka,45_ 49,1940,Showa,15,89071,45292,43779
22 ,Shizuoka,50_ 54,1940,Showa,15,84062,42528,41534
22 ,Shizuoka,55_ 59,1940,Showa,15,71077,34783,36294
22 ,Shizuoka,60_ 64,1940,Showa,15,59723,29068,30655
22 ,Shizuoka,65_ 69,1940,Showa,15,42311,19936,22375
22 ,Shizuoka,70_ 74,1940,Showa,15,27166,12025,15141
22 ,Shizuoka,75_ 79,1940,Showa,15,16914,7111,9803
22 ,Shizuoka,80_ 84,1940,Showa,15,8199,3129,5070
22 ,Shizuoka,over_85,1940,Showa,15,3462,1192,2270
22 ,Shizuoka,total,1945,Showa,20,2220358,1039175,1181183
22 ,Shizuoka,1_ 5,1945,Showa,20,296158,149814,146344
22 ,Shizuoka,6_ 10,1945,Showa,20,276785,140020,136765
22 ,Shizuoka,11_ 15,1945,Showa,20,275472,138722,136750
22 ,Shizuoka,16_ 20,1945,Showa,20,244468,118358,126110
22 ,Shizuoka,21_ 25,1945,Showa,20,167216,59132,108084
22 ,Shizuoka,26_ 30,1945,Showa,20,132011,45801,86210
22 ,Shizuoka,31_ 35,1945,Showa,20,130197,50391,79806
22 ,Shizuoka,36_ 40,1945,Showa,20,128204,60176,68028
22 ,Shizuoka,41_ 45,1945,Showa,20,119433,59252,60181
22 ,Shizuoka,46_ 50,1945,Showa,20,104608,52853,51755
22 ,Shizuoka,51_ 55,1945,Showa,20,88555,44840,43715
22 ,Shizuoka,56_ 60,1945,Showa,20,81363,40385,40978
22 ,Shizuoka,61_ 65,1945,Showa,20,64770,30660,34110
22 ,Shizuoka,66_ 70,1945,Showa,20,50780,23399,27381
22 ,Shizuoka,71_ 75,1945,Showa,20,32630,14475,18155
22 ,Shizuoka,76_ 80,1945,Showa,20,16505,6728,9777
22 ,Shizuoka,81_ 85,1945,Showa,20,8219,3124,5095
22 ,Shizuoka,86以上,1945,Showa,20,2984,1045,1939
22 ,Shizuoka,total,1950,Showa,25,2471472,1206651,1264821
22 ,Shizuoka,0_ 4,1950,Showa,25,335479,171156,164323
22 ,Shizuoka,5_ 9,1950,Showa,25,292352,147987,144365
22 ,Shizuoka,10_ 14,1950,Showa,25,269519,136457,133062
22 ,Shizuoka,15_ 19,1950,Showa,25,259801,129404,130397
22 ,Shizuoka,20_ 24,1950,Showa,25,228691,110940,117751
22 ,Shizuoka,25_ 29,1950,Showa,25,178607,80051,98556
22 ,Shizuoka,30_ 34,1950,Showa,25,148799,66236,82563
22 ,Shizuoka,35_ 39,1950,Showa,25,143315,66173,77142
22 ,Shizuoka,40_ 44,1950,Showa,25,127723,62852,64871
22 ,Shizuoka,45_ 49,1950,Showa,25,113318,56858,56460
22 ,Shizuoka,50_ 54,1950,Showa,25,97525,49349,48176
22 ,Shizuoka,55_ 59,1950,Showa,25,81589,40709,40880
22 ,Shizuoka,60_ 64,1950,Showa,25,71900,35040,36860
22 ,Shizuoka,65_ 69,1950,Showa,25,53038,24299,28739
22 ,Shizuoka,70_ 74,1950,Showa,25,37448,16467,20981
22 ,Shizuoka,75_ 79,1950,Showa,25,20402,8376,12026
22 ,Shizuoka,over_80,1950,Showa,25,11694,4161,7533
22 ,Shizuoka,total,1955,Showa,30,2650435,1301198,1349237
22 ,Shizuoka,0_ 4,1955,Showa,30,283115,144356,138759
22 ,Shizuoka,5_ 9,1955,Showa,30,329493,168203,161290
22 ,Shizuoka,10_ 14,1955,Showa,30,288654,145842,142812
22 ,Shizuoka,15_ 19,1955,Showa,30,259361,127484,131877
22 ,Shizuoka,20_ 24,1955,Showa,30,250634,123217,127417
22 ,Shizuoka,25_ 29,1955,Showa,30,228132,115254,112878
22 ,Shizuoka,30_ 34,1955,Showa,30,178968,82332,96636
22 ,Shizuoka,35_ 39,1955,Showa,30,147093,66505,80588
22 ,Shizuoka,40_ 44,1955,Showa,30,140877,65671,75206
22 ,Shizuoka,45_ 49,1955,Showa,30,124313,61478,62835
22 ,Shizuoka,50_ 54,1955,Showa,30,108764,54592,54172
22 ,Shizuoka,55_ 59,1955,Showa,30,92374,46423,45951
22 ,Shizuoka,60_ 64,1955,Showa,30,74080,36367,37713
22 ,Shizuoka,65_ 69,1955,Showa,30,61552,29201,32351
22 ,Shizuoka,70_ 74,1955,Showa,30,41882,18331,23551
22 ,Shizuoka,75_ 79,1955,Showa,30,25678,10434,15244
22 ,Shizuoka,80_ 84,1955,Showa,30,11245,4169,7076
22 ,Shizuoka,over_85,1955,Showa,30,4217,1336,2881
22 ,Shizuoka,total,1960,Showa,35,2756271,1353122,1403149
22 ,Shizuoka,0_ 4,1960,Showa,35,245048,125553,119495
22 ,Shizuoka,5_ 9,1960,Showa,35,280333,142732,137601
22 ,Shizuoka,10_ 14,1960,Showa,35,326572,166511,160061
22 ,Shizuoka,15_ 19,1960,Showa,35,273117,133691,139426
22 ,Shizuoka,20_ 24,1960,Showa,35,243201,118100,125101
22 ,Shizuoka,25_ 29,1960,Showa,35,241076,121786,119290
22 ,Shizuoka,30_ 34,1960,Showa,35,222435,112984,109451
22 ,Shizuoka,35_ 39,1960,Showa,35,175168,80519,94649
22 ,Shizuoka,40_ 44,1960,Showa,35,143625,64664,78961
22 ,Shizuoka,45_ 49,1960,Showa,35,136495,63465,73030
22 ,Shizuoka,50_ 54,1960,Showa,35,118974,58454,60520
22 ,Shizuoka,55_ 59,1960,Showa,35,102560,50994,51566
22 ,Shizuoka,60_ 64,1960,Showa,35,84859,41786,43073
22 ,Shizuoka,65_ 69,1960,Showa,35,64593,30729,33864
22 ,Shizuoka,70_ 74,1960,Showa,35,49261,22362,26899
22 ,Shizuoka,75_ 79,1960,Showa,35,28859,11657,17202
22 ,Shizuoka,80_ 84,1960,Showa,35,14396,5338,9058
22 ,Shizuoka,over_85,1960,Showa,35,5699,1797,3902
22 ,Shizuoka,total,1965,Showa,40,2912521,1428930,1483591
22 ,Shizuoka,0_ 4,1965,Showa,40,248151,127835,120316
22 ,Shizuoka,5_ 9,1965,Showa,40,246546,125978,120568
22 ,Shizuoka,10_ 14,1965,Showa,40,281622,143080,138542
22 ,Shizuoka,15_ 19,1965,Showa,40,322666,159651,163015
22 ,Shizuoka,20_ 24,1965,Showa,40,260810,125057,135753
22 ,Shizuoka,25_ 29,1965,Showa,40,245592,122857,122735
22 ,Shizuoka,30_ 34,1965,Showa,40,242812,123293,119519
22 ,Shizuoka,35_ 39,1965,Showa,40,222693,113209,109484
22 ,Shizuoka,40_ 44,1965,Showa,40,173684,79799,93885
22 ,Shizuoka,45_ 49,1965,Showa,40,141210,63272,77938
22 ,Shizuoka,50_ 54,1965,Showa,40,132260,61089,71171
22 ,Shizuoka,55_ 59,1965,Showa,40,113727,55398,58329
22 ,Shizuoka,60_ 64,1965,Showa,40,94844,46189,48655
22 ,Shizuoka,65_ 69,1965,Showa,40,74701,35618,39083
22 ,Shizuoka,70_ 74,1965,Showa,40,52976,23979,28997
22 ,Shizuoka,75_ 79,1965,Showa,40,34684,14504,20180
22 ,Shizuoka,80_ 84,1965,Showa,40,16285,5858,10427
22 ,Shizuoka,over_85,1965,Showa,40,7258,2264,4994
22 ,Shizuoka,total,1970,Showa,45,3089895,1516642,1573253
22 ,Shizuoka,0_ 4,1970,Showa,45,264893,135876,129017
22 ,Shizuoka,5_ 9,1970,Showa,45,251611,129455,122156
22 ,Shizuoka,10_ 14,1970,Showa,45,248729,127038,121691
22 ,Shizuoka,15_ 19,1970,Showa,45,276307,135266,141041
22 ,Shizuoka,20_ 24,1970,Showa,45,300658,145439,155219
22 ,Shizuoka,25_ 29,1970,Showa,45,270248,135184,135064
22 ,Shizuoka,30_ 34,1970,Showa,45,250244,126532,123712
22 ,Shizuoka,35_ 39,1970,Showa,45,244438,124230,120208
22 ,Shizuoka,40_ 44,1970,Showa,45,220284,111978,108306
22 ,Shizuoka,45_ 49,1970,Showa,45,172265,78999,93266
22 ,Shizuoka,50_ 54,1970,Showa,45,138482,61584,76898
22 ,Shizuoka,55_ 59,1970,Showa,45,126941,58043,68898
22 ,Shizuoka,60_ 64,1970,Showa,45,106604,51002,55602
22 ,Shizuoka,65_ 69,1970,Showa,45,85609,40339,45270
22 ,Shizuoka,70_ 74,1970,Showa,45,62881,28327,34554
22 ,Shizuoka,75_ 79,1970,Showa,45,39436,16552,22884
22 ,Shizuoka,80_ 84,1970,Showa,45,21132,8010,13122
22 ,Shizuoka,over_85,1970,Showa,45,9133,2788,6345
22 ,Shizuoka,total,1975,Showa,50,3308799,1627797,1681002
22 ,Shizuoka,0_ 4,1975,Showa,50,303310,155147,148163
22 ,Shizuoka,5_ 9,1975,Showa,50,268597,137830,130767
22 ,Shizuoka,10_ 14,1975,Showa,50,253517,130395,123122
22 ,Shizuoka,15_ 19,1975,Showa,50,236588,117284,119304
22 ,Shizuoka,20_ 24,1975,Showa,50,250197,120808,129389
22 ,Shizuoka,25_ 29,1975,Showa,50,315256,158123,157133
22 ,Shizuoka,30_ 34,1975,Showa,50,277057,139793,137264
22 ,Shizuoka,35_ 39,1975,Showa,50,252117,127777,124340
22 ,Shizuoka,40_ 44,1975,Showa,50,244359,124081,120278
22 ,Shizuoka,45_ 49,1975,Showa,50,219657,111048,108609
22 ,Shizuoka,50_ 54,1975,Showa,50,168965,76695,92270
22 ,Shizuoka,55_ 59,1975,Showa,50,135202,59451,75751
22 ,Shizuoka,60_ 64,1975,Showa,50,123120,55394,67726
22 ,Shizuoka,65_ 69,1975,Showa,50,99179,46059,53120
22 ,Shizuoka,70_ 74,1975,Showa,50,74534,33380,41154
22 ,Shizuoka,75_ 79,1975,Showa,50,48818,20545,28273
22 ,Shizuoka,80_ 84,1975,Showa,50,25551,9789,15762
22 ,Shizuoka,over_85,1975,Showa,50,12544,4057,8487
22 ,Shizuoka,total,1980,Showa,55,3446804,1695778,1751026
22 ,Shizuoka,0_ 4,1980,Showa,55,259599,133130,126469
22 ,Shizuoka,5_ 9,1980,Showa,55,304565,155755,148810
22 ,Shizuoka,10_ 14,1980,Showa,55,268652,138109,130543
22 ,Shizuoka,15_ 19,1980,Showa,55,236196,119079,117117
22 ,Shizuoka,20_ 24,1980,Showa,55,207158,99084,108074
22 ,Shizuoka,25_ 29,1980,Showa,55,265447,133048,132399
22 ,Shizuoka,30_ 34,1980,Showa,55,317461,160281,157180
22 ,Shizuoka,35_ 39,1980,Showa,55,276332,139275,137057
22 ,Shizuoka,40_ 44,1980,Showa,55,249427,126277,123150
22 ,Shizuoka,45_ 49,1980,Showa,55,239613,121072,118541
22 ,Shizuoka,50_ 54,1980,Showa,55,214842,107688,107154
22 ,Shizuoka,55_ 59,1980,Showa,55,164788,73874,90914
22 ,Shizuoka,60_ 64,1980,Showa,55,129942,56178,73764
22 ,Shizuoka,65_ 69,1980,Showa,55,114623,50102,64521
22 ,Shizuoka,70_ 74,1980,Showa,55,88035,39337,48698
22 ,Shizuoka,75_ 79,1980,Showa,55,59737,25068,34669
22 ,Shizuoka,80_ 84,1980,Showa,55,33138,12662,20476
22 ,Shizuoka,over_85,1980,Showa,55,16994,5584,11410
22 ,Shizuoka,total,1985,Showa,60,3574692,1759455,1815237
22 ,Shizuoka,0_ 4,1985,Showa,60,228290,116703,111587
22 ,Shizuoka,5_ 9,1985,Showa,60,261698,134157,127541
22 ,Shizuoka,10_ 14,1985,Showa,60,305430,156146,149284
22 ,Shizuoka,15_ 19,1985,Showa,60,254607,129208,125399
22 ,Shizuoka,20_ 24,1985,Showa,60,210906,102284,108622
22 ,Shizuoka,25_ 29,1985,Showa,60,230044,115944,114100
22 ,Shizuoka,30_ 34,1985,Showa,60,270176,136460,133716
22 ,Shizuoka,35_ 39,1985,Showa,60,318846,161254,157592
22 ,Shizuoka,40_ 44,1985,Showa,60,275682,139099,136583
22 ,Shizuoka,45_ 49,1985,Showa,60,246803,124804,121999
22 ,Shizuoka,50_ 54,1985,Showa,60,235028,117731,117297
22 ,Shizuoka,55_ 59,1985,Showa,60,209899,104057,105842
22 ,Shizuoka,60_ 64,1985,Showa,60,159762,70742,89020
22 ,Shizuoka,65_ 69,1985,Showa,60,122897,51916,70981
22 ,Shizuoka,70_ 74,1985,Showa,60,103969,43765,60204
22 ,Shizuoka,75_ 79,1985,Showa,60,73091,30646,42445
22 ,Shizuoka,80_ 84,1985,Showa,60,42640,16356,26284
22 ,Shizuoka,over_85,1985,Showa,60,24539,7897,16642
22 ,Shizuoka,total,1990,Heisei,2,3670840,1808951,1861889
22 ,Shizuoka,0_ 4,1990,Heisei,2,201290,102925,98365
22 ,Shizuoka,5_ 9,1990,Heisei,2,230858,117924,112934
22 ,Shizuoka,10_ 14,1990,Heisei,2,262410,134526,127884
22 ,Shizuoka,15_ 19,1990,Heisei,2,285049,144297,140752
22 ,Shizuoka,20_ 24,1990,Heisei,2,228930,112648,116282
22 ,Shizuoka,25_ 29,1990,Heisei,2,234766,119640,115126
22 ,Shizuoka,30_ 34,1990,Heisei,2,235164,119538,115626
22 ,Shizuoka,35_ 39,1990,Heisei,2,272573,138366,134207
22 ,Shizuoka,40_ 44,1990,Heisei,2,319518,161927,157591
22 ,Shizuoka,45_ 49,1990,Heisei,2,274018,138519,135499
22 ,Shizuoka,50_ 54,1990,Heisei,2,244547,123286,121261
22 ,Shizuoka,55_ 59,1990,Heisei,2,231147,114699,116448
22 ,Shizuoka,60_ 64,1990,Heisei,2,204545,99936,104609
22 ,Shizuoka,65_ 69,1990,Heisei,2,152273,66082,86191
22 ,Shizuoka,70_ 74,1990,Heisei,2,113682,46380,67302
22 ,Shizuoka,75_ 79,1990,Heisei,2,89675,35596,54079
22 ,Shizuoka,80_ 84,1990,Heisei,2,54532,20825,33707
22 ,Shizuoka,over_85,1990,Heisei,2,34737,11046,23691
22 ,Shizuoka,total,1995,Heisei,7,3737689,1841947,1895742
22 ,Shizuoka,0_ 4,1995,Heisei,7,183199,94121,89078
22 ,Shizuoka,5_ 9,1995,Heisei,7,204087,104394,99693
22 ,Shizuoka,10_ 14,1995,Heisei,7,232159,118574,113585
22 ,Shizuoka,15_ 19,1995,Heisei,7,243552,124413,119139
22 ,Shizuoka,20_ 24,1995,Heisei,7,260020,129509,130511
22 ,Shizuoka,25_ 29,1995,Heisei,7,253621,129955,123666
22 ,Shizuoka,30_ 34,1995,Heisei,7,241176,123397,117779
22 ,Shizuoka,35_ 39,1995,Heisei,7,238691,121545,117146
22 ,Shizuoka,40_ 44,1995,Heisei,7,273850,139003,134847
22 ,Shizuoka,45_ 49,1995,Heisei,7,318344,161481,156863
22 ,Shizuoka,50_ 54,1995,Heisei,7,271411,136341,135070
22 ,Shizuoka,55_ 59,1995,Heisei,7,240271,119858,120413
22 ,Shizuoka,60_ 64,1995,Heisei,7,223449,108906,114543
22 ,Shizuoka,65_ 69,1995,Heisei,7,194451,92785,101666
22 ,Shizuoka,70_ 74,1995,Heisei,7,141355,59090,82265
22 ,Shizuoka,75_ 79,1995,Heisei,7,99355,38196,61159
22 ,Shizuoka,80_ 84,1995,Heisei,7,69654,25049,44605
22 ,Shizuoka,over_85,1995,Heisei,7,48715,15089,33626
22 ,Shizuoka,total,2000,Heisei,12,3767393,1857031,1910362
22 ,Shizuoka,0_ 4,2000,Heisei,12,180473,92442,88031
22 ,Shizuoka,5_ 9,2000,Heisei,12,183991,94583,89408
22 ,Shizuoka,10_ 14,2000,Heisei,12,204522,104677,99845
22 ,Shizuoka,15_ 19,2000,Heisei,12,213229,109017,104212
22 ,Shizuoka,20_ 24,2000,Heisei,12,213774,107932,105842
22 ,Shizuoka,25_ 29,2000,Heisei,12,282459,145022,137437
22 ,Shizuoka,30_ 34,2000,Heisei,12,256919,132167,124752
22 ,Shizuoka,35_ 39,2000,Heisei,12,241436,123646,117790
22 ,Shizuoka,40_ 44,2000,Heisei,12,238499,121299,117200
22 ,Shizuoka,45_ 49,2000,Heisei,12,271559,137812,133747
22 ,Shizuoka,50_ 54,2000,Heisei,12,314097,158664,155433
22 ,Shizuoka,55_ 59,2000,Heisei,12,266263,132426,133837
22 ,Shizuoka,60_ 64,2000,Heisei,12,234021,115146,118875
22 ,Shizuoka,65_ 69,2000,Heisei,12,212464,101043,111421
22 ,Shizuoka,70_ 74,2000,Heisei,12,180208,83207,97001
22 ,Shizuoka,75_ 79,2000,Heisei,12,125532,49728,75804
22 ,Shizuoka,80_ 84,2000,Heisei,12,79360,27838,51522
22 ,Shizuoka,over_85,2000,Heisei,12,68010,19970,48040
22 ,Shizuoka,total,2005,Heisei,17,3792377,1868458,1923919
22 ,Shizuoka,0_ 4,2005,Heisei,17,172668,88930,83738
22 ,Shizuoka,5_ 9,2005,Heisei,17,180786,92657,88129
22 ,Shizuoka,10_ 14,2005,Heisei,17,183345,94164,89181
22 ,Shizuoka,15_ 19,2005,Heisei,17,188808,96712,92096
22 ,Shizuoka,20_ 24,2005,Heisei,17,188815,95899,92916
22 ,Shizuoka,25_ 29,2005,Heisei,17,236947,122482,114465
22 ,Shizuoka,30_ 34,2005,Heisei,17,285539,147224,138315
22 ,Shizuoka,35_ 39,2005,Heisei,17,256703,132178,124525
22 ,Shizuoka,40_ 44,2005,Heisei,17,240671,123029,117642
22 ,Shizuoka,45_ 49,2005,Heisei,17,236315,119953,116362
22 ,Shizuoka,50_ 54,2005,Heisei,17,267669,135114,132555
22 ,Shizuoka,55_ 59,2005,Heisei,17,309000,154775,154225
22 ,Shizuoka,60_ 64,2005,Heisei,17,260868,128358,132510
22 ,Shizuoka,65_ 69,2005,Heisei,17,224933,108830,116103
22 ,Shizuoka,70_ 74,2005,Heisei,17,198765,91564,107201
22 ,Shizuoka,75_ 79,2005,Heisei,17,161202,70564,90638
22 ,Shizuoka,80_ 84,2005,Heisei,17,104348,38018,66330
22 ,Shizuoka,over_85,2005,Heisei,17,89945,25142,64803
22 ,Shizuoka,total,2010,Heisei,22,3765007,1853952,1911055
22 ,Shizuoka,0_ 4,2010,Heisei,22,161778,82680,79098
22 ,Shizuoka,5_ 9,2010,Heisei,22,170903,88106,82797
22 ,Shizuoka,10_ 14,2010,Heisei,22,178894,91849,87045
22 ,Shizuoka,15_ 19,2010,Heisei,22,169029,86793,82236
22 ,Shizuoka,20_ 24,2010,Heisei,22,163839,83153,80686
22 ,Shizuoka,25_ 29,2010,Heisei,22,205013,106744,98269
22 ,Shizuoka,30_ 34,2010,Heisei,22,236178,121859,114319
22 ,Shizuoka,35_ 39,2010,Heisei,22,281320,144785,136535
22 ,Shizuoka,40_ 44,2010,Heisei,22,253097,129875,123222
22 ,Shizuoka,45_ 49,2010,Heisei,22,236301,120400,115901
22 ,Shizuoka,50_ 54,2010,Heisei,22,231343,116754,114589
22 ,Shizuoka,55_ 59,2010,Heisei,22,262212,131196,131016
22 ,Shizuoka,60_ 64,2010,Heisei,22,301583,149444,152139
22 ,Shizuoka,65_ 69,2010,Heisei,22,251035,121548,129487
22 ,Shizuoka,70_ 74,2010,Heisei,22,211363,99625,111738
22 ,Shizuoka,75_ 79,2010,Heisei,22,178530,78520,100010
22 ,Shizuoka,80_ 84,2010,Heisei,22,133731,53536,80195
22 ,Shizuoka,over_85,2010,Heisei,22,117148,33147,84001
22 ,Shizuoka,total,2015,Heisei,27,3700305,1820993,1879312
22 ,Shizuoka,0_ 4,2015,Heisei,27,147123,75386,71737
22 ,Shizuoka,5_ 9,2015,Heisei,27,160657,82234,78423
22 ,Shizuoka,10_ 14,2015,Heisei,27,170304,87744,82560
22 ,Shizuoka,15_ 19,2015,Heisei,27,167947,86515,81432
22 ,Shizuoka,20_ 24,2015,Heisei,27,147307,75540,71767
22 ,Shizuoka,25_ 29,2015,Heisei,27,179016,93742,85274
22 ,Shizuoka,30_ 34,2015,Heisei,27,204494,105757,98737
22 ,Shizuoka,35_ 39,2015,Heisei,27,233980,120504,113476
22 ,Shizuoka,40_ 44,2015,Heisei,27,278421,142995,135426
22 ,Shizuoka,45_ 49,2015,Heisei,27,249105,127583,121522
22 ,Shizuoka,50_ 54,2015,Heisei,27,231670,117500,114170
22 ,Shizuoka,55_ 59,2015,Heisei,27,226809,113901,112908
22 ,Shizuoka,60_ 64,2015,Heisei,27,256255,127008,129247
22 ,Shizuoka,65_ 69,2015,Heisei,27,290853,142079,148774
22 ,Shizuoka,70_ 74,2015,Heisei,27,236690,112053,124637
22 ,Shizuoka,75_ 79,2015,Heisei,27,191702,86824,104878
22 ,Shizuoka,80_ 84,2015,Heisei,27,150380,61187,89193
22 ,Shizuoka,over_85,2015,Heisei,27,151658,46580,105078
23 ,Aichi,total,1920,Taisho,9,2089762,1033860,1055902
23 ,Aichi,0_ 4,1920,Taisho,9,273349,137826,135523
23 ,Aichi,5_ 9,1920,Taisho,9,259779,131454,128325
23 ,Aichi,10_ 14,1920,Taisho,9,232542,114753,117789
23 ,Aichi,15_ 19,1920,Taisho,9,207255,99322,107933
23 ,Aichi,20_ 24,1920,Taisho,9,170084,84687,85397
23 ,Aichi,25_ 29,1920,Taisho,9,144332,72496,71836
23 ,Aichi,30_ 34,1920,Taisho,9,134806,67948,66858
23 ,Aichi,35_ 39,1920,Taisho,9,133995,66666,67329
23 ,Aichi,40_ 44,1920,Taisho,9,120464,60605,59859
23 ,Aichi,45_ 49,1920,Taisho,9,92061,46311,45750
23 ,Aichi,50_ 54,1920,Taisho,9,77740,39003,38737
23 ,Aichi,55_ 59,1920,Taisho,9,66790,33176,33614
23 ,Aichi,60_ 64,1920,Taisho,9,63829,30803,33026
23 ,Aichi,65_ 69,1920,Taisho,9,50693,23531,27162
23 ,Aichi,70_ 74,1920,Taisho,9,33483,14744,18739
23 ,Aichi,75_ 79,1920,Taisho,9,18662,7280,11382
23 ,Aichi,over_80,1920,Taisho,9,9898,3255,6643
23 ,Aichi,total,1925,Taisho,14,2319494,1150325,1169169
23 ,Aichi,0_ 4,1925,Taisho,14,308972,155324,153648
23 ,Aichi,5_ 9,1925,Taisho,14,255675,129495,126180
23 ,Aichi,10_ 14,1925,Taisho,14,275033,132956,142077
23 ,Aichi,15_ 19,1925,Taisho,14,248793,118470,130323
23 ,Aichi,20_ 24,1925,Taisho,14,201230,100400,100830
23 ,Aichi,25_ 29,1925,Taisho,14,168515,86806,81709
23 ,Aichi,30_ 34,1925,Taisho,14,144476,74809,69667
23 ,Aichi,35_ 39,1925,Taisho,14,133865,68760,65105
23 ,Aichi,40_ 44,1925,Taisho,14,130905,66093,64812
23 ,Aichi,45_ 49,1925,Taisho,14,116794,58824,57970
23 ,Aichi,50_ 54,1925,Taisho,14,87382,43703,43679
23 ,Aichi,55_ 59,1925,Taisho,14,70776,34986,35790
23 ,Aichi,60_ 64,1925,Taisho,14,58105,28212,29893
23 ,Aichi,65_ 69,1925,Taisho,14,51569,23936,27633
23 ,Aichi,70_ 74,1925,Taisho,14,36549,16013,20536
23 ,Aichi,75_ 79,1925,Taisho,14,20091,8006,12085
23 ,Aichi,80_ 84,1925,Taisho,14,8224,2816,5408
23 ,Aichi,over_85,1925,Taisho,14,2540,716,1824
23 ,Aichi,total,1930,Showa,5,2567413,1277720,1289693
23 ,Aichi,0_ 4,1930,Showa,5,349588,176837,172751
23 ,Aichi,5_ 9,1930,Showa,5,290360,146362,143998
23 ,Aichi,10_ 14,1930,Showa,5,269580,131663,137917
23 ,Aichi,15_ 19,1930,Showa,5,292180,139035,153145
23 ,Aichi,20_ 24,1930,Showa,5,229774,114219,115555
23 ,Aichi,25_ 29,1930,Showa,5,197221,101540,95681
23 ,Aichi,30_ 34,1930,Showa,5,166875,87275,79600
23 ,Aichi,35_ 39,1930,Showa,5,142376,74137,68239
23 ,Aichi,40_ 44,1930,Showa,5,130025,67229,62796
23 ,Aichi,45_ 49,1930,Showa,5,125505,63120,62385
23 ,Aichi,50_ 54,1930,Showa,5,109817,54903,54914
23 ,Aichi,55_ 59,1930,Showa,5,80151,39437,40714
23 ,Aichi,60_ 64,1930,Showa,5,62372,29777,32595
23 ,Aichi,65_ 69,1930,Showa,5,47664,22156,25508
23 ,Aichi,70_ 74,1930,Showa,5,38178,16618,21560
23 ,Aichi,75_ 79,1930,Showa,5,22808,9107,13701
23 ,Aichi,over_80,1930,Showa,5,12939,4305,8634
23 ,Aichi,total,1935,Showa,10,2862701,1418218,1444483
23 ,Aichi,0_ 4,1935,Showa,10,381229,192508,188721
23 ,Aichi,5_ 9,1935,Showa,10,334120,169378,164742
23 ,Aichi,10_ 14,1935,Showa,10,313238,151555,161683
23 ,Aichi,15_ 19,1935,Showa,10,305128,143526,161602
23 ,Aichi,20_ 24,1935,Showa,10,268649,128361,140288
23 ,Aichi,25_ 29,1935,Showa,10,224401,114767,109634
23 ,Aichi,30_ 34,1935,Showa,10,193199,100016,93183
23 ,Aichi,35_ 39,1935,Showa,10,162909,85374,77535
23 ,Aichi,40_ 44,1935,Showa,10,137368,71654,65714
23 ,Aichi,45_ 49,1935,Showa,10,124996,64382,60614
23 ,Aichi,50_ 54,1935,Showa,10,118285,59000,59285
23 ,Aichi,55_ 59,1935,Showa,10,101302,49721,51581
23 ,Aichi,60_ 64,1935,Showa,10,71327,33976,37351
23 ,Aichi,65_ 69,1935,Showa,10,51348,23543,27805
23 ,Aichi,70_ 74,1935,Showa,10,35782,15597,20185
23 ,Aichi,75_ 79,1935,Showa,10,24047,9649,14398
23 ,Aichi,over_80,1935,Showa,10,15373,5211,10162
23 ,Aichi,total,1940,Showa,15,3165891,1582086,1583805
23 ,Aichi,0_ 4,1940,Showa,15,400589,203003,197586
23 ,Aichi,5_ 9,1940,Showa,15,364747,184462,180285
23 ,Aichi,10_ 14,1940,Showa,15,350078,174254,175824
23 ,Aichi,15_ 19,1940,Showa,15,352270,172426,179844
23 ,Aichi,20_ 24,1940,Showa,15,280423,135580,144843
23 ,Aichi,25_ 29,1940,Showa,15,268755,136705,132050
23 ,Aichi,30_ 34,1940,Showa,15,220998,114400,106598
23 ,Aichi,35_ 39,1940,Showa,15,188609,97974,90635
23 ,Aichi,40_ 44,1940,Showa,15,157064,82303,74761
23 ,Aichi,45_ 49,1940,Showa,15,130938,67735,63203
23 ,Aichi,50_ 54,1940,Showa,15,117706,60007,57699
23 ,Aichi,55_ 59,1940,Showa,15,108716,53183,55533
23 ,Aichi,60_ 64,1940,Showa,15,89842,42597,47245
23 ,Aichi,65_ 69,1940,Showa,15,59183,26969,32214
23 ,Aichi,70_ 74,1940,Showa,15,37964,16291,21673
23 ,Aichi,75_ 79,1940,Showa,15,22167,8850,13317
23 ,Aichi,80_ 84,1940,Showa,15,11207,3976,7231
23 ,Aichi,over_85,1940,Showa,15,4557,1336,3221
23 ,Aichi,total,1945,Showa,20,2857851,1357054,1500797
23 ,Aichi,1_ 5,1945,Showa,20,374378,189722,184656
23 ,Aichi,6_ 10,1945,Showa,20,334870,169666,165204
23 ,Aichi,11_ 15,1945,Showa,20,328561,166147,162414
23 ,Aichi,16_ 20,1945,Showa,20,305747,151901,153846
23 ,Aichi,21_ 25,1945,Showa,20,209392,75592,133800
23 ,Aichi,26_ 30,1945,Showa,20,177707,64702,113005
23 ,Aichi,31_ 35,1945,Showa,20,188273,78087,110186
23 ,Aichi,36_ 40,1945,Showa,20,179900,86749,93151
23 ,Aichi,41_ 45,1945,Showa,20,165666,84406,81260
23 ,Aichi,46_ 50,1945,Showa,20,141089,73397,67692
23 ,Aichi,51_ 55,1945,Showa,20,117080,60503,56577
23 ,Aichi,56_ 60,1945,Showa,20,102885,51840,51045
23 ,Aichi,61_ 65,1945,Showa,20,88456,42423,46033
23 ,Aichi,66_ 70,1945,Showa,20,68241,30995,37246
23 ,Aichi,71_ 75,1945,Showa,20,41559,18012,23547
23 ,Aichi,76_ 80,1945,Showa,20,20680,8253,12427
23 ,Aichi,81_ 85,1945,Showa,20,9748,3561,6187
23 ,Aichi,86以上,1945,Showa,20,3619,1098,2521
23 ,Aichi,total,1950,Showa,25,3390585,1649189,1741396
23 ,Aichi,0_ 4,1950,Showa,25,452118,231061,221057
23 ,Aichi,5_ 9,1950,Showa,25,393124,199426,193698
23 ,Aichi,10_ 14,1950,Showa,25,347500,176151,171349
23 ,Aichi,15_ 19,1950,Showa,25,362500,174251,188249
23 ,Aichi,20_ 24,1950,Showa,25,315087,152043,163044
23 ,Aichi,25_ 29,1950,Showa,25,246973,109593,137380
23 ,Aichi,30_ 34,1950,Showa,25,212442,94488,117954
23 ,Aichi,35_ 39,1950,Showa,25,212979,99500,113479
23 ,Aichi,40_ 44,1950,Showa,25,183957,91068,92889
23 ,Aichi,45_ 49,1950,Showa,25,161264,81726,79538
23 ,Aichi,50_ 54,1950,Showa,25,132631,67879,64752
23 ,Aichi,55_ 59,1950,Showa,25,109652,55117,54535
23 ,Aichi,60_ 64,1950,Showa,25,92241,44871,47370
23 ,Aichi,65_ 69,1950,Showa,25,75383,34472,40911
23 ,Aichi,70_ 74,1950,Showa,25,51680,22044,29636
23 ,Aichi,75_ 79,1950,Showa,25,26542,10655,15887
23 ,Aichi,over_80,1950,Showa,25,14451,4824,9627
23 ,Aichi,total,1955,Showa,30,3769209,1829729,1939480
23 ,Aichi,0_ 4,1955,Showa,30,347501,177201,170300
23 ,Aichi,5_ 9,1955,Showa,30,451785,230912,220873
23 ,Aichi,10_ 14,1955,Showa,30,397848,201730,196118
23 ,Aichi,15_ 19,1955,Showa,30,423978,196836,227142
23 ,Aichi,20_ 24,1955,Showa,30,384080,184928,199152
23 ,Aichi,25_ 29,1955,Showa,30,324493,161161,163332
23 ,Aichi,30_ 34,1955,Showa,30,251812,113165,138647
23 ,Aichi,35_ 39,1955,Showa,30,213677,95692,117985
23 ,Aichi,40_ 44,1955,Showa,30,212188,99362,112826
23 ,Aichi,45_ 49,1955,Showa,30,182226,90266,91960
23 ,Aichi,50_ 54,1955,Showa,30,157330,79525,77805
23 ,Aichi,55_ 59,1955,Showa,30,126869,64478,62391
23 ,Aichi,60_ 64,1955,Showa,30,100435,49742,50693
23 ,Aichi,65_ 69,1955,Showa,30,79820,37851,41969
23 ,Aichi,70_ 74,1955,Showa,30,59656,25915,33741
23 ,Aichi,75_ 79,1955,Showa,30,35637,14046,21591
23 ,Aichi,80_ 84,1955,Showa,30,14695,5356,9339
23 ,Aichi,over_85,1955,Showa,30,5163,1555,3608
23 ,Aichi,total,1960,Showa,35,4206313,2064726,2141587
23 ,Aichi,0_ 4,1960,Showa,35,334541,171069,163472
23 ,Aichi,5_ 9,1960,Showa,35,353738,180501,173237
23 ,Aichi,10_ 14,1960,Showa,35,458285,234301,223984
23 ,Aichi,15_ 19,1960,Showa,35,535604,254209,281395
23 ,Aichi,20_ 24,1960,Showa,35,445284,219379,225905
23 ,Aichi,25_ 29,1960,Showa,35,393221,200395,192826
23 ,Aichi,30_ 34,1960,Showa,35,334218,169853,164365
23 ,Aichi,35_ 39,1960,Showa,35,257024,117331,139693
23 ,Aichi,40_ 44,1960,Showa,35,215613,97507,118106
23 ,Aichi,45_ 49,1960,Showa,35,211883,100151,111732
23 ,Aichi,50_ 54,1960,Showa,35,178906,88693,90213
23 ,Aichi,55_ 59,1960,Showa,35,151274,76088,75186
23 ,Aichi,60_ 64,1960,Showa,35,117650,58661,58989
23 ,Aichi,65_ 69,1960,Showa,35,87872,42366,45506
23 ,Aichi,70_ 74,1960,Showa,35,63821,28846,34975
23 ,Aichi,75_ 79,1960,Showa,35,41164,16431,24733
23 ,Aichi,80_ 84,1960,Showa,35,19269,6808,12461
23 ,Aichi,over_85,1960,Showa,35,6946,2137,4809
23 ,Aichi,total,1965,Showa,40,4798653,2382085,2416568
23 ,Aichi,0_ 4,1965,Showa,40,429058,218423,210635
23 ,Aichi,5_ 9,1965,Showa,40,351436,178796,172640
23 ,Aichi,10_ 14,1965,Showa,40,369480,187760,181720
23 ,Aichi,15_ 19,1965,Showa,40,618939,300705,318234
23 ,Aichi,20_ 24,1965,Showa,40,541842,276706,265136
23 ,Aichi,25_ 29,1965,Showa,40,465895,241049,224846
23 ,Aichi,30_ 34,1965,Showa,40,414914,213703,201211
23 ,Aichi,35_ 39,1965,Showa,40,347976,177563,170413
23 ,Aichi,40_ 44,1965,Showa,40,263159,120846,142313
23 ,Aichi,45_ 49,1965,Showa,40,217916,98871,119045
23 ,Aichi,50_ 54,1965,Showa,40,209533,98617,110916
23 ,Aichi,55_ 59,1965,Showa,40,173509,85614,87895
23 ,Aichi,60_ 64,1965,Showa,40,141250,69788,71462
23 ,Aichi,65_ 69,1965,Showa,40,104274,50576,53698
23 ,Aichi,70_ 74,1965,Showa,40,71967,33165,38802
23 ,Aichi,75_ 79,1965,Showa,40,45204,18887,26317
23 ,Aichi,80_ 84,1965,Showa,40,22723,8174,14549
23 ,Aichi,over_85,1965,Showa,40,9578,2842,6736
23 ,Aichi,total,1970,Showa,45,5386163,2694991,2691172
23 ,Aichi,0_ 4,1970,Showa,45,511666,262523,249143
23 ,Aichi,5_ 9,1970,Showa,45,437017,223386,213631
23 ,Aichi,10_ 14,1970,Showa,45,360959,184161,176798
23 ,Aichi,15_ 19,1970,Showa,45,485898,237593,248305
23 ,Aichi,20_ 24,1970,Showa,45,632986,325326,307660
23 ,Aichi,25_ 29,1970,Showa,45,549801,283402,266399
23 ,Aichi,30_ 34,1970,Showa,45,475438,246421,229017
23 ,Aichi,35_ 39,1970,Showa,45,422841,218535,204306
23 ,Aichi,40_ 44,1970,Showa,45,351404,180477,170927
23 ,Aichi,45_ 49,1970,Showa,45,265595,122640,142955
23 ,Aichi,50_ 54,1970,Showa,45,217236,98210,119026
23 ,Aichi,55_ 59,1970,Showa,45,203399,94874,108525
23 ,Aichi,60_ 64,1970,Showa,45,164281,79300,84981
23 ,Aichi,65_ 69,1970,Showa,45,127560,61002,66558
23 ,Aichi,70_ 74,1970,Showa,45,87812,40499,47313
23 ,Aichi,75_ 79,1970,Showa,45,52941,22766,30175
23 ,Aichi,80_ 84,1970,Showa,45,26901,10095,16806
23 ,Aichi,over_85,1970,Showa,45,12428,3781,8647
23 ,Aichi,total,1975,Showa,50,5923569,2966388,2957181
23 ,Aichi,0_ 4,1975,Showa,50,593693,304612,289081
23 ,Aichi,5_ 9,1975,Showa,50,506359,259908,246451
23 ,Aichi,10_ 14,1975,Showa,50,436904,223368,213536
23 ,Aichi,15_ 19,1975,Showa,50,431098,215895,215203
23 ,Aichi,20_ 24,1975,Showa,50,504180,257498,246682
23 ,Aichi,25_ 29,1975,Showa,50,624815,318048,306767
23 ,Aichi,30_ 34,1975,Showa,50,547009,280752,266257
23 ,Aichi,35_ 39,1975,Showa,50,469970,243069,226901
23 ,Aichi,40_ 44,1975,Showa,50,419326,216162,203164
23 ,Aichi,45_ 49,1975,Showa,50,348889,178323,170566
23 ,Aichi,50_ 54,1975,Showa,50,260242,118841,141401
23 ,Aichi,55_ 59,1975,Showa,50,209702,93279,116423
23 ,Aichi,60_ 64,1975,Showa,50,195026,88897,106129
23 ,Aichi,65_ 69,1975,Showa,50,150833,70404,80429
23 ,Aichi,70_ 74,1975,Showa,50,109503,49997,59506
23 ,Aichi,75_ 79,1975,Showa,50,66967,28989,37978
23 ,Aichi,80_ 84,1975,Showa,50,32864,12949,19915
23 ,Aichi,over_85,1975,Showa,50,15472,4896,10576
23 ,Aichi,total,1980,Showa,55,6221638,3112306,3109332
23 ,Aichi,0_ 4,1980,Showa,55,476917,244535,232382
23 ,Aichi,5_ 9,1980,Showa,55,579665,297397,282268
23 ,Aichi,10_ 14,1980,Showa,55,498777,256183,242594
23 ,Aichi,15_ 19,1980,Showa,55,470750,238410,232340
23 ,Aichi,20_ 24,1980,Showa,55,442129,226100,216029
23 ,Aichi,25_ 29,1980,Showa,55,483281,245128,238153
23 ,Aichi,30_ 34,1980,Showa,55,609904,308494,301410
23 ,Aichi,35_ 39,1980,Showa,55,535224,273938,261286
23 ,Aichi,40_ 44,1980,Showa,55,460016,237312,222704
23 ,Aichi,45_ 49,1980,Showa,55,410770,210753,200017
23 ,Aichi,50_ 54,1980,Showa,55,339571,172426,167145
23 ,Aichi,55_ 59,1980,Showa,55,251150,113497,137653
23 ,Aichi,60_ 64,1980,Showa,55,199510,87032,112478
23 ,Aichi,65_ 69,1980,Showa,55,180102,80043,100059
23 ,Aichi,70_ 74,1980,Showa,55,132030,58935,73095
23 ,Aichi,75_ 79,1980,Showa,55,85623,36730,48893
23 ,Aichi,80_ 84,1980,Showa,55,43751,17282,26469
23 ,Aichi,over_85,1980,Showa,55,20707,6872,13835
23 ,Aichi,total,1985,Showa,60,6455172,3228724,3226448
23 ,Aichi,0_ 4,1985,Showa,60,409877,210054,199823
23 ,Aichi,5_ 9,1985,Showa,60,465891,238798,227093
23 ,Aichi,10_ 14,1985,Showa,60,570961,292832,278129
23 ,Aichi,15_ 19,1985,Showa,60,524878,269930,254948
23 ,Aichi,20_ 24,1985,Showa,60,485335,249186,236149
23 ,Aichi,25_ 29,1985,Showa,60,426396,219022,207374
23 ,Aichi,30_ 34,1985,Showa,60,474489,239504,234985
23 ,Aichi,35_ 39,1985,Showa,60,598124,301641,296483
23 ,Aichi,40_ 44,1985,Showa,60,526331,268592,257739
23 ,Aichi,45_ 49,1985,Showa,60,452395,232886,219509
23 ,Aichi,50_ 54,1985,Showa,60,401274,204901,196373
23 ,Aichi,55_ 59,1985,Showa,60,328498,165088,163410
23 ,Aichi,60_ 64,1985,Showa,60,240447,106631,133816
23 ,Aichi,65_ 69,1985,Showa,60,186910,79443,107467
23 ,Aichi,70_ 74,1985,Showa,60,161603,68956,92647
23 ,Aichi,75_ 79,1985,Showa,60,108433,45554,62879
23 ,Aichi,80_ 84,1985,Showa,60,59503,23244,36259
23 ,Aichi,over_85,1985,Showa,60,30774,10388,20386
23 ,Aichi,total,1990,Heisei,2,6690603,3354827,3335776
23 ,Aichi,0_ 4,1990,Heisei,2,369451,188992,180459
23 ,Aichi,5_ 9,1990,Heisei,2,404924,207438,197486
23 ,Aichi,10_ 14,1990,Heisei,2,462408,236865,225543
23 ,Aichi,15_ 19,1990,Heisei,2,595693,306426,289267
23 ,Aichi,20_ 24,1990,Heisei,2,542860,281201,261659
23 ,Aichi,25_ 29,1990,Heisei,2,480905,249779,231126
23 ,Aichi,30_ 34,1990,Heisei,2,425221,218489,206732
23 ,Aichi,35_ 39,1990,Heisei,2,471205,238198,233007
23 ,Aichi,40_ 44,1990,Heisei,2,595095,300715,294380
23 ,Aichi,45_ 49,1990,Heisei,2,521867,267111,254756
23 ,Aichi,50_ 54,1990,Heisei,2,445977,229365,216612
23 ,Aichi,55_ 59,1990,Heisei,2,390637,197936,192701
23 ,Aichi,60_ 64,1990,Heisei,2,315361,156008,159353
23 ,Aichi,65_ 69,1990,Heisei,2,226592,98139,128453
23 ,Aichi,70_ 74,1990,Heisei,2,170319,69588,100731
23 ,Aichi,75_ 79,1990,Heisei,2,136156,54636,81520
23 ,Aichi,80_ 84,1990,Heisei,2,78853,30133,48720
23 ,Aichi,over_85,1990,Heisei,2,44363,14580,29783
23 ,Aichi,total,1995,Heisei,7,6868336,3439180,3429156
23 ,Aichi,0_ 4,1995,Heisei,7,354155,181283,172872
23 ,Aichi,5_ 9,1995,Heisei,7,365582,187162,178420
23 ,Aichi,10_ 14,1995,Heisei,7,401255,205466,195789
23 ,Aichi,15_ 19,1995,Heisei,7,479885,246212,233673
23 ,Aichi,20_ 24,1995,Heisei,7,612559,314824,297735
23 ,Aichi,25_ 29,1995,Heisei,7,542034,282388,259646
23 ,Aichi,30_ 34,1995,Heisei,7,479631,248525,231106
23 ,Aichi,35_ 39,1995,Heisei,7,422160,216522,205638
23 ,Aichi,40_ 44,1995,Heisei,7,468398,236560,231838
23 ,Aichi,45_ 49,1995,Heisei,7,590335,298496,291839
23 ,Aichi,50_ 54,1995,Heisei,7,514148,262050,252098
23 ,Aichi,55_ 59,1995,Heisei,7,435570,222324,213246
23 ,Aichi,60_ 64,1995,Heisei,7,374375,186490,187885
23 ,Aichi,65_ 69,1995,Heisei,7,297406,143848,153558
23 ,Aichi,70_ 74,1995,Heisei,7,207971,86746,121225
23 ,Aichi,75_ 79,1995,Heisei,7,146105,55884,90221
23 ,Aichi,80_ 84,1995,Heisei,7,102926,37588,65338
23 ,Aichi,over_85,1995,Heisei,7,64618,20290,44328
23 ,Aichi,total,2000,Heisei,12,7043300,3525698,3517602
23 ,Aichi,0_ 4,2000,Heisei,12,367153,187957,179196
23 ,Aichi,5_ 9,2000,Heisei,12,350785,179607,171178
23 ,Aichi,10_ 14,2000,Heisei,12,363342,185955,177387
23 ,Aichi,15_ 19,2000,Heisei,12,416223,214596,201627
23 ,Aichi,20_ 24,2000,Heisei,12,493538,254353,239185
23 ,Aichi,25_ 29,2000,Heisei,12,609071,314594,294477
23 ,Aichi,30_ 34,2000,Heisei,12,537981,279168,258813
23 ,Aichi,35_ 39,2000,Heisei,12,475855,245687,230168
23 ,Aichi,40_ 44,2000,Heisei,12,419261,214649,204612
23 ,Aichi,45_ 49,2000,Heisei,12,462881,233245,229636
23 ,Aichi,50_ 54,2000,Heisei,12,579282,291592,287690
23 ,Aichi,55_ 59,2000,Heisei,12,500762,253252,247510
23 ,Aichi,60_ 64,2000,Heisei,12,420003,211303,208700
23 ,Aichi,65_ 69,2000,Heisei,12,353491,172125,181366
23 ,Aichi,70_ 74,2000,Heisei,12,272967,127381,145586
23 ,Aichi,75_ 79,2000,Heisei,12,182589,72220,110369
23 ,Aichi,80_ 84,2000,Heisei,12,115176,40393,74783
23 ,Aichi,over_85,2000,Heisei,12,95776,28517,67259
23 ,Aichi,total,2005,Heisei,17,7254704,3638994,3615710
23 ,Aichi,0_ 4,2005,Heisei,17,354230,181973,172257
23 ,Aichi,5_ 9,2005,Heisei,17,366192,187492,178700
23 ,Aichi,10_ 14,2005,Heisei,17,349076,178565,170511
23 ,Aichi,15_ 19,2005,Heisei,17,378383,195973,182410
23 ,Aichi,20_ 24,2005,Heisei,17,443293,232108,211185
23 ,Aichi,25_ 29,2005,Heisei,17,511016,266940,244076
23 ,Aichi,30_ 34,2005,Heisei,17,618067,320321,297746
23 ,Aichi,35_ 39,2005,Heisei,17,540752,281462,259290
23 ,Aichi,40_ 44,2005,Heisei,17,477796,247399,230397
23 ,Aichi,45_ 49,2005,Heisei,17,418325,214334,203991
23 ,Aichi,50_ 54,2005,Heisei,17,458803,230547,228256
23 ,Aichi,55_ 59,2005,Heisei,17,568332,284526,283806
23 ,Aichi,60_ 64,2005,Heisei,17,486305,242955,243350
23 ,Aichi,65_ 69,2005,Heisei,17,401613,198950,202663
23 ,Aichi,70_ 74,2005,Heisei,17,328949,155461,173488
23 ,Aichi,75_ 79,2005,Heisei,17,242178,107539,134639
23 ,Aichi,80_ 84,2005,Heisei,17,149470,54231,95239
23 ,Aichi,over_85,2005,Heisei,17,126352,35241,91111
23 ,Aichi,total,2010,Heisei,22,7410719,3704220,3706499
23 ,Aichi,0_ 4,2010,Heisei,22,346338,177425,168913
23 ,Aichi,5_ 9,2010,Heisei,22,353251,181173,172078
23 ,Aichi,10_ 14,2010,Heisei,22,365665,187169,178496
23 ,Aichi,15_ 19,2010,Heisei,22,361670,185766,175904
23 ,Aichi,20_ 24,2010,Heisei,22,403988,209871,194117
23 ,Aichi,25_ 29,2010,Heisei,22,462251,243198,219053
23 ,Aichi,30_ 34,2010,Heisei,22,518107,268660,249447
23 ,Aichi,35_ 39,2010,Heisei,22,618763,319697,299066
23 ,Aichi,40_ 44,2010,Heisei,22,539881,280543,259338
23 ,Aichi,45_ 49,2010,Heisei,22,472604,242768,229836
23 ,Aichi,50_ 54,2010,Heisei,22,413484,210174,203310
23 ,Aichi,55_ 59,2010,Heisei,22,449460,224481,224979
23 ,Aichi,60_ 64,2010,Heisei,22,551237,272179,279058
23 ,Aichi,65_ 69,2010,Heisei,22,464480,227743,236737
23 ,Aichi,70_ 74,2010,Heisei,22,374676,180206,194470
23 ,Aichi,75_ 79,2010,Heisei,22,292728,131473,161255
23 ,Aichi,80_ 84,2010,Heisei,22,197726,79887,117839
23 ,Aichi,over_85,2010,Heisei,22,162475,45441,117034
23 ,Aichi,total,2015,Heisei,27,7483128,3740844,3742284
23 ,Aichi,0_ 4,2015,Heisei,27,328910,168753,160157
23 ,Aichi,5_ 9,2015,Heisei,27,341550,175086,166464
23 ,Aichi,10_ 14,2015,Heisei,27,352072,180692,171380
23 ,Aichi,15_ 19,2015,Heisei,27,377041,194524,182517
23 ,Aichi,20_ 24,2015,Heisei,27,383655,199772,183883
23 ,Aichi,25_ 29,2015,Heisei,27,419995,222068,197927
23 ,Aichi,30_ 34,2015,Heisei,27,464583,243016,221567
23 ,Aichi,35_ 39,2015,Heisei,27,516027,267502,248525
23 ,Aichi,40_ 44,2015,Heisei,27,615858,318209,297649
23 ,Aichi,45_ 49,2015,Heisei,27,533935,276418,257517
23 ,Aichi,50_ 54,2015,Heisei,27,466894,239195,227699
23 ,Aichi,55_ 59,2015,Heisei,27,404834,205250,199584
23 ,Aichi,60_ 64,2015,Heisei,27,435835,215024,220811
23 ,Aichi,65_ 69,2015,Heisei,27,527710,256537,271173
23 ,Aichi,70_ 74,2015,Heisei,27,435133,207781,227352
23 ,Aichi,75_ 79,2015,Heisei,27,337617,155994,181623
23 ,Aichi,80_ 84,2015,Heisei,27,243981,101394,142587
23 ,Aichi,over_85,2015,Heisei,27,216322,67204,149118
24 ,Mie,total,1920,Taisho,9,1069270,525957,543313
24 ,Mie,0_ 4,1920,Taisho,9,137934,69537,68397
24 ,Mie,5_ 9,1920,Taisho,9,133971,68108,65863
24 ,Mie,10_ 14,1920,Taisho,9,118361,59470,58891
24 ,Mie,15_ 19,1920,Taisho,9,96463,46427,50036
24 ,Mie,20_ 24,1920,Taisho,9,76858,35886,40972
24 ,Mie,25_ 29,1920,Taisho,9,68814,34169,34645
24 ,Mie,30_ 34,1920,Taisho,9,65108,32232,32876
24 ,Mie,35_ 39,1920,Taisho,9,66985,32649,34336
24 ,Mie,40_ 44,1920,Taisho,9,64810,32364,32446
24 ,Mie,45_ 49,1920,Taisho,9,54279,27042,27237
24 ,Mie,50_ 54,1920,Taisho,9,44383,22103,22280
24 ,Mie,55_ 59,1920,Taisho,9,38975,19455,19520
24 ,Mie,60_ 64,1920,Taisho,9,37667,18219,19448
24 ,Mie,65_ 69,1920,Taisho,9,29273,13654,15619
24 ,Mie,70_ 74,1920,Taisho,9,19571,8634,10937
24 ,Mie,75_ 79,1920,Taisho,9,10404,4145,6259
24 ,Mie,over_80,1920,Taisho,9,5414,1863,3551
24 ,Mie,total,1925,Taisho,14,1107692,544752,562940
24 ,Mie,0_ 4,1925,Taisho,14,148584,74579,74005
24 ,Mie,5_ 9,1925,Taisho,14,126991,64272,62719
24 ,Mie,10_ 14,1925,Taisho,14,127855,64245,63610
24 ,Mie,15_ 19,1925,Taisho,14,102091,48031,54060
24 ,Mie,20_ 24,1925,Taisho,14,84874,40882,43992
24 ,Mie,25_ 29,1925,Taisho,14,73982,36823,37159
24 ,Mie,30_ 34,1925,Taisho,14,64945,32704,32241
24 ,Mie,35_ 39,1925,Taisho,14,62245,31045,31200
24 ,Mie,40_ 44,1925,Taisho,14,63383,31141,32242
24 ,Mie,45_ 49,1925,Taisho,14,61055,30469,30586
24 ,Mie,50_ 54,1925,Taisho,14,50366,24958,25408
24 ,Mie,55_ 59,1925,Taisho,14,39850,19601,20249
24 ,Mie,60_ 64,1925,Taisho,14,33480,16408,17072
24 ,Mie,65_ 69,1925,Taisho,14,29787,13923,15864
24 ,Mie,70_ 74,1925,Taisho,14,20640,9037,11603
24 ,Mie,75_ 79,1925,Taisho,14,11450,4567,6883
24 ,Mie,80_ 84,1925,Taisho,14,4653,1618,3035
24 ,Mie,over_85,1925,Taisho,14,1461,449,1012
24 ,Mie,total,1930,Showa,5,1157407,571000,586407
24 ,Mie,0_ 4,1930,Showa,5,159227,80320,78907
24 ,Mie,5_ 9,1930,Showa,5,139000,69925,69075
24 ,Mie,10_ 14,1930,Showa,5,121383,60917,60466
24 ,Mie,15_ 19,1930,Showa,5,107703,51990,55713
24 ,Mie,20_ 24,1930,Showa,5,88324,41945,46379
24 ,Mie,25_ 29,1930,Showa,5,81878,41144,40734
24 ,Mie,30_ 34,1930,Showa,5,71845,36380,35465
24 ,Mie,35_ 39,1930,Showa,5,62970,31906,31064
24 ,Mie,40_ 44,1930,Showa,5,59587,29931,29656
24 ,Mie,45_ 49,1930,Showa,5,60038,29504,30534
24 ,Mie,50_ 54,1930,Showa,5,56843,28272,28571
24 ,Mie,55_ 59,1930,Showa,5,45696,22397,23299
24 ,Mie,60_ 64,1930,Showa,5,34493,16562,17931
24 ,Mie,65_ 69,1930,Showa,5,27060,12825,14235
24 ,Mie,70_ 74,1930,Showa,5,21461,9506,11955
24 ,Mie,75_ 79,1930,Showa,5,12612,5030,7582
24 ,Mie,over_80,1930,Showa,5,7287,2446,4841
24 ,Mie,total,1935,Showa,10,1174595,572356,602239
24 ,Mie,0_ 4,1935,Showa,10,153958,77811,76147
24 ,Mie,5_ 9,1935,Showa,10,148748,75121,73627
24 ,Mie,10_ 14,1935,Showa,10,132974,65699,67275
24 ,Mie,15_ 19,1935,Showa,10,97233,44234,52999
24 ,Mie,20_ 24,1935,Showa,10,87596,40005,47591
24 ,Mie,25_ 29,1935,Showa,10,81394,39518,41876
24 ,Mie,30_ 34,1935,Showa,10,75620,37654,37966
24 ,Mie,35_ 39,1935,Showa,10,67114,33661,33453
24 ,Mie,40_ 44,1935,Showa,10,58846,29616,29230
24 ,Mie,45_ 49,1935,Showa,10,55623,27733,27890
24 ,Mie,50_ 54,1935,Showa,10,55573,27188,28385
24 ,Mie,55_ 59,1935,Showa,10,51588,25260,26328
24 ,Mie,60_ 64,1935,Showa,10,39690,19061,20629
24 ,Mie,65_ 69,1935,Showa,10,27835,12867,14968
24 ,Mie,70_ 74,1935,Showa,10,19685,8902,10783
24 ,Mie,75_ 79,1935,Showa,10,13020,5291,7729
24 ,Mie,over_80,1935,Showa,10,8098,2735,5363
24 ,Mie,total,1940,Showa,15,1198614,585335,613279
24 ,Mie,0_ 4,1940,Showa,15,144738,73048,71690
24 ,Mie,5_ 9,1940,Showa,15,145832,73693,72139
24 ,Mie,10_ 14,1940,Showa,15,142806,70760,72046
24 ,Mie,15_ 19,1940,Showa,15,105051,46651,58400
24 ,Mie,20_ 24,1940,Showa,15,88277,44014,44263
24 ,Mie,25_ 29,1940,Showa,15,82816,40041,42775
24 ,Mie,30_ 34,1940,Showa,15,76835,37548,39287
24 ,Mie,35_ 39,1940,Showa,15,72910,36357,36553
24 ,Mie,40_ 44,1940,Showa,15,64154,32239,31915
24 ,Mie,45_ 49,1940,Showa,15,55383,27871,27512
24 ,Mie,50_ 54,1940,Showa,15,51861,25799,26062
24 ,Mie,55_ 59,1940,Showa,15,50586,24429,26157
24 ,Mie,60_ 64,1940,Showa,15,45134,21592,23542
24 ,Mie,65_ 69,1940,Showa,15,32157,14878,17279
24 ,Mie,70_ 74,1940,Showa,15,20253,8739,11514
24 ,Mie,75_ 79,1940,Showa,15,11698,4868,6830
24 ,Mie,80_ 84,1940,Showa,15,5795,2119,3676
24 ,Mie,over_85,1940,Showa,15,2326,689,1637
24 ,Mie,total,1945,Showa,20,1394286,646954,747332
24 ,Mie,1_ 5,1945,Showa,20,175001,88547,86454
24 ,Mie,6_ 10,1945,Showa,20,166672,84207,82465
24 ,Mie,11_ 15,1945,Showa,20,166104,84030,82074
24 ,Mie,16_ 20,1945,Showa,20,147589,71470,76119
24 ,Mie,21_ 25,1945,Showa,20,99911,34360,65551
24 ,Mie,26_ 30,1945,Showa,20,82268,28533,53735
24 ,Mie,31_ 35,1945,Showa,20,84430,31985,52445
24 ,Mie,36_ 40,1945,Showa,20,83473,37682,45791
24 ,Mie,41_ 45,1945,Showa,20,79599,38937,40662
24 ,Mie,46_ 50,1945,Showa,20,69028,34727,34301
24 ,Mie,51_ 55,1945,Showa,20,57737,29038,28699
24 ,Mie,56_ 60,1945,Showa,20,52400,25667,26733
24 ,Mie,61_ 65,1945,Showa,20,47337,22089,25248
24 ,Mie,66_ 70,1945,Showa,20,39123,17829,21294
24 ,Mie,71_ 75,1945,Showa,20,24657,10630,14027
24 ,Mie,76_ 80,1945,Showa,20,11873,4721,7152
24 ,Mie,81_ 85,1945,Showa,20,5230,1917,3313
24 ,Mie,86以上,1945,Showa,20,1854,585,1269
24 ,Mie,total,1950,Showa,25,1461197,704805,756392
24 ,Mie,0_ 4,1950,Showa,25,181865,92998,88867
24 ,Mie,5_ 9,1950,Showa,25,165079,83667,81412
24 ,Mie,10_ 14,1950,Showa,25,155942,78848,77094
24 ,Mie,15_ 19,1950,Showa,25,150922,74034,76888
24 ,Mie,20_ 24,1950,Showa,25,132272,64664,67608
24 ,Mie,25_ 29,1950,Showa,25,98755,41945,56810
24 ,Mie,30_ 34,1950,Showa,25,85409,37094,48315
24 ,Mie,35_ 39,1950,Showa,25,87513,39371,48142
24 ,Mie,40_ 44,1950,Showa,25,80623,38474,42149
24 ,Mie,45_ 49,1950,Showa,25,73838,36551,37287
24 ,Mie,50_ 54,1950,Showa,25,62503,31239,31264
24 ,Mie,55_ 59,1950,Showa,25,52421,25946,26475
24 ,Mie,60_ 64,1950,Showa,25,45218,21711,23507
24 ,Mie,65_ 69,1950,Showa,25,38119,17313,20806
24 ,Mie,70_ 74,1950,Showa,25,28020,12234,15786
24 ,Mie,75_ 79,1950,Showa,25,14931,5994,8937
24 ,Mie,over_80,1950,Showa,25,7740,2708,5032
24 ,Mie,total,1955,Showa,30,1485582,717819,767763
24 ,Mie,0_ 4,1955,Showa,30,138833,70874,67959
24 ,Mie,5_ 9,1955,Showa,30,175459,89652,85807
24 ,Mie,10_ 14,1955,Showa,30,160495,81237,79258
24 ,Mie,15_ 19,1955,Showa,30,139130,67475,71655
24 ,Mie,20_ 24,1955,Showa,30,135481,65347,70134
24 ,Mie,25_ 29,1955,Showa,30,124347,62341,62006
24 ,Mie,30_ 34,1955,Showa,30,94482,40832,53650
24 ,Mie,35_ 39,1955,Showa,30,81916,35764,46152
24 ,Mie,40_ 44,1955,Showa,30,83847,37794,46053
24 ,Mie,45_ 49,1955,Showa,30,76916,36646,40270
24 ,Mie,50_ 54,1955,Showa,30,69936,34609,35327
24 ,Mie,55_ 59,1955,Showa,30,58558,29044,29514
24 ,Mie,60_ 64,1955,Showa,30,47161,23066,24095
24 ,Mie,65_ 69,1955,Showa,30,38875,18377,20498
24 ,Mie,70_ 74,1955,Showa,30,29952,13037,16915
24 ,Mie,75_ 79,1955,Showa,30,19235,7846,11389
24 ,Mie,80_ 84,1955,Showa,30,8202,2991,5211
24 ,Mie,over_85,1955,Showa,30,2753,885,1868
24 ,Mie,total,1960,Showa,35,1485054,716715,768339
24 ,Mie,0_ 4,1960,Showa,35,117495,60084,57411
24 ,Mie,5_ 9,1960,Showa,35,137124,70030,67094
24 ,Mie,10_ 14,1960,Showa,35,172913,88232,84681
24 ,Mie,15_ 19,1960,Showa,35,138653,65617,73036
24 ,Mie,20_ 24,1960,Showa,35,120615,56592,64023
24 ,Mie,25_ 29,1960,Showa,35,124616,62279,62337
24 ,Mie,30_ 34,1960,Showa,35,120577,61205,59372
24 ,Mie,35_ 39,1960,Showa,35,92513,40191,52322
24 ,Mie,40_ 44,1960,Showa,35,79533,34907,44626
24 ,Mie,45_ 49,1960,Showa,35,80980,36541,44439
24 ,Mie,50_ 54,1960,Showa,35,73596,35127,38469
24 ,Mie,55_ 59,1960,Showa,35,65841,32380,33461
24 ,Mie,60_ 64,1960,Showa,35,53607,26145,27462
24 ,Mie,65_ 69,1960,Showa,35,40975,19692,21283
24 ,Mie,70_ 74,1960,Showa,35,31078,14117,16961
24 ,Mie,75_ 79,1960,Showa,35,20679,8439,12240
24 ,Mie,80_ 84,1960,Showa,35,10455,3907,6548
24 ,Mie,over_85,1960,Showa,35,3804,1230,2574
24 ,Mie,total,1965,Showa,40,1514467,727802,786665
24 ,Mie,0_ 4,1965,Showa,40,121331,61950,59381
24 ,Mie,5_ 9,1965,Showa,40,117742,59801,57941
24 ,Mie,10_ 14,1965,Showa,40,136144,69008,67136
24 ,Mie,15_ 19,1965,Showa,40,161874,76109,85765
24 ,Mie,20_ 24,1965,Showa,40,123360,57581,65779
24 ,Mie,25_ 29,1965,Showa,40,117242,57101,60141
24 ,Mie,30_ 34,1965,Showa,40,122633,61619,61014
24 ,Mie,35_ 39,1965,Showa,40,119258,60503,58755
24 ,Mie,40_ 44,1965,Showa,40,90536,39268,51268
24 ,Mie,45_ 49,1965,Showa,40,77384,33947,43437
24 ,Mie,50_ 54,1965,Showa,40,77580,35027,42553
24 ,Mie,55_ 59,1965,Showa,40,69468,32998,36470
24 ,Mie,60_ 64,1965,Showa,40,60659,29437,31222
24 ,Mie,65_ 69,1965,Showa,40,47000,22516,24484
24 ,Mie,70_ 74,1965,Showa,40,33613,15534,18079
24 ,Mie,75_ 79,1965,Showa,40,22008,9447,12561
24 ,Mie,80_ 84,1965,Showa,40,11271,4225,7046
24 ,Mie,over_85,1965,Showa,40,5364,1731,3633
24 ,Mie,total,1970,Showa,45,1543083,742461,800622
24 ,Mie,0_ 4,1970,Showa,45,121507,62332,59175
24 ,Mie,5_ 9,1970,Showa,45,121605,62173,59432
24 ,Mie,10_ 14,1970,Showa,45,117334,59805,57529
24 ,Mie,15_ 19,1970,Showa,45,129943,61813,68130
24 ,Mie,20_ 24,1970,Showa,45,136929,63900,73029
24 ,Mie,25_ 29,1970,Showa,45,121165,59225,61940
24 ,Mie,30_ 34,1970,Showa,45,116577,57414,59163
24 ,Mie,35_ 39,1970,Showa,45,121425,61199,60226
24 ,Mie,40_ 44,1970,Showa,45,115878,58786,57092
24 ,Mie,45_ 49,1970,Showa,45,88705,38390,50315
24 ,Mie,50_ 54,1970,Showa,45,75182,32685,42497
24 ,Mie,55_ 59,1970,Showa,45,73624,32888,40736
24 ,Mie,60_ 64,1970,Showa,45,65023,30348,34675
24 ,Mie,65_ 69,1970,Showa,45,54532,25642,28890
24 ,Mie,70_ 74,1970,Showa,45,39604,18108,21496
24 ,Mie,75_ 79,1970,Showa,45,24563,10558,14005
24 ,Mie,80_ 84,1970,Showa,45,13171,5174,7997
24 ,Mie,over_85,1970,Showa,45,6316,2021,4295
24 ,Mie,total,1975,Showa,50,1626002,787280,838722
24 ,Mie,0_ 4,1975,Showa,50,137873,70489,67384
24 ,Mie,5_ 9,1975,Showa,50,124956,64221,60735
24 ,Mie,10_ 14,1975,Showa,50,122786,62834,59952
24 ,Mie,15_ 19,1975,Showa,50,115006,56365,58641
24 ,Mie,20_ 24,1975,Showa,50,111729,52820,58909
24 ,Mie,25_ 29,1975,Showa,50,140492,69713,70779
24 ,Mie,30_ 34,1975,Showa,50,125435,62267,63168
24 ,Mie,35_ 39,1975,Showa,50,118393,58728,59665
24 ,Mie,40_ 44,1975,Showa,50,121813,61455,60358
24 ,Mie,45_ 49,1975,Showa,50,115888,58656,57232
24 ,Mie,50_ 54,1975,Showa,50,87058,37345,49713
24 ,Mie,55_ 59,1975,Showa,50,73003,31455,41548
24 ,Mie,60_ 64,1975,Showa,50,71298,31280,40018
24 ,Mie,65_ 69,1975,Showa,50,60071,27253,32818
24 ,Mie,70_ 74,1975,Showa,50,47124,21134,25990
24 ,Mie,75_ 79,1975,Showa,50,30148,12837,17311
24 ,Mie,80_ 84,1975,Showa,50,15154,5889,9265
24 ,Mie,over_85,1975,Showa,50,7669,2473,5196
24 ,Mie,total,1980,Showa,55,1686936,817578,869358
24 ,Mie,0_ 4,1980,Showa,55,116918,60041,56877
24 ,Mie,5_ 9,1980,Showa,55,141922,72652,69270
24 ,Mie,10_ 14,1980,Showa,55,127129,65216,61913
24 ,Mie,15_ 19,1980,Showa,55,119567,60222,59345
24 ,Mie,20_ 24,1980,Showa,55,96918,45673,51245
24 ,Mie,25_ 29,1980,Showa,55,116286,57076,59210
24 ,Mie,30_ 34,1980,Showa,55,144042,71680,72362
24 ,Mie,35_ 39,1980,Showa,55,127986,63643,64343
24 ,Mie,40_ 44,1980,Showa,55,118755,58959,59796
24 ,Mie,45_ 49,1980,Showa,55,120571,60468,60103
24 ,Mie,50_ 54,1980,Showa,55,114205,57368,56837
24 ,Mie,55_ 59,1980,Showa,55,85291,36231,49060
24 ,Mie,60_ 64,1980,Showa,55,70191,29756,40435
24 ,Mie,65_ 69,1980,Showa,55,66614,28507,38107
24 ,Mie,70_ 74,1980,Showa,55,53088,23154,29934
24 ,Mie,75_ 79,1980,Showa,55,37463,15806,21657
24 ,Mie,80_ 84,1980,Showa,55,20036,7799,12237
24 ,Mie,over_85,1980,Showa,55,9818,3236,6582
24 ,Mie,total,1985,Showa,60,1747311,847420,899891
24 ,Mie,0_ 4,1985,Showa,60,104193,53153,51040
24 ,Mie,5_ 9,1985,Showa,60,121818,62592,59226
24 ,Mie,10_ 14,1985,Showa,60,145882,74798,71084
24 ,Mie,15_ 19,1985,Showa,60,124988,63561,61427
24 ,Mie,20_ 24,1985,Showa,60,104465,50415,54050
24 ,Mie,25_ 29,1985,Showa,60,103091,50686,52405
24 ,Mie,30_ 34,1985,Showa,60,120119,58938,61181
24 ,Mie,35_ 39,1985,Showa,60,148786,74180,74606
24 ,Mie,40_ 44,1985,Showa,60,129803,64912,64891
24 ,Mie,45_ 49,1985,Showa,60,118501,58784,59717
24 ,Mie,50_ 54,1985,Showa,60,119411,59467,59944
24 ,Mie,55_ 59,1985,Showa,60,112242,55843,56399
24 ,Mie,60_ 64,1985,Showa,60,83102,34872,48230
24 ,Mie,65_ 69,1985,Showa,60,66735,27591,39144
24 ,Mie,70_ 74,1985,Showa,60,60294,24927,35367
24 ,Mie,75_ 79,1985,Showa,60,43806,17883,25923
24 ,Mie,80_ 84,1985,Showa,60,26011,10080,15931
24 ,Mie,over_85,1985,Showa,60,13969,4660,9309
24 ,Mie,total,1990,Heisei,2,1792514,869515,922999
24 ,Mie,0_ 4,1990,Heisei,2,95825,49394,46431
24 ,Mie,5_ 9,1990,Heisei,2,109572,55910,53662
24 ,Mie,10_ 14,1990,Heisei,2,124854,64148,60706
24 ,Mie,15_ 19,1990,Heisei,2,141817,72478,69339
24 ,Mie,20_ 24,1990,Heisei,2,109475,53164,56311
24 ,Mie,25_ 29,1990,Heisei,2,109916,54246,55670
24 ,Mie,30_ 34,1990,Heisei,2,107218,52777,54441
24 ,Mie,35_ 39,1990,Heisei,2,124599,61487,63112
24 ,Mie,40_ 44,1990,Heisei,2,151017,75492,75525
24 ,Mie,45_ 49,1990,Heisei,2,129544,64789,64755
24 ,Mie,50_ 54,1990,Heisei,2,117725,58143,59582
24 ,Mie,55_ 59,1990,Heisei,2,117705,58058,59647
24 ,Mie,60_ 64,1990,Heisei,2,109352,53706,55646
24 ,Mie,65_ 69,1990,Heisei,2,79418,32689,46729
24 ,Mie,70_ 74,1990,Heisei,2,61300,24534,36766
24 ,Mie,75_ 79,1990,Heisei,2,51143,19847,31296
24 ,Mie,80_ 84,1990,Heisei,2,31908,11931,19977
24 ,Mie,over_85,1990,Heisei,2,19589,6355,13234
24 ,Mie,total,1995,Heisei,7,1841358,893982,947376
24 ,Mie,0_ 4,1995,Heisei,7,90004,46171,43833
24 ,Mie,5_ 9,1995,Heisei,7,100951,52074,48877
24 ,Mie,10_ 14,1995,Heisei,7,112690,57560,55130
24 ,Mie,15_ 19,1995,Heisei,7,121766,62477,59289
24 ,Mie,20_ 24,1995,Heisei,7,129576,63832,65744
24 ,Mie,25_ 29,1995,Heisei,7,117265,58512,58753
24 ,Mie,30_ 34,1995,Heisei,7,115847,57532,58315
24 ,Mie,35_ 39,1995,Heisei,7,112351,55704,56647
24 ,Mie,40_ 44,1995,Heisei,7,128222,63651,64571
24 ,Mie,45_ 49,1995,Heisei,7,152593,76463,76130
24 ,Mie,50_ 54,1995,Heisei,7,129867,64694,65173
24 ,Mie,55_ 59,1995,Heisei,7,117363,57603,59760
24 ,Mie,60_ 64,1995,Heisei,7,115578,56238,59340
24 ,Mie,65_ 69,1995,Heisei,7,104708,50349,54359
24 ,Mie,70_ 74,1995,Heisei,7,74040,29445,44595
24 ,Mie,75_ 79,1995,Heisei,7,53146,19930,33216
24 ,Mie,80_ 84,1995,Heisei,7,38825,13530,25295
24 ,Mie,over_85,1995,Heisei,7,26410,8111,18299
24 ,Mie,total,2000,Heisei,12,1857339,901380,955959
24 ,Mie,0_ 4,2000,Heisei,12,88788,45404,43384
24 ,Mie,5_ 9,2000,Heisei,12,92200,47367,44833
24 ,Mie,10_ 14,2000,Heisei,12,102093,52694,49399
24 ,Mie,15_ 19,2000,Heisei,12,107084,54598,52486
24 ,Mie,20_ 24,2000,Heisei,12,106832,53062,53770
24 ,Mie,25_ 29,2000,Heisei,12,134179,67263,66916
24 ,Mie,30_ 34,2000,Heisei,12,120045,60120,59925
24 ,Mie,35_ 39,2000,Heisei,12,118050,58708,59342
24 ,Mie,40_ 44,2000,Heisei,12,113333,56289,57044
24 ,Mie,45_ 49,2000,Heisei,12,127646,63449,64197
24 ,Mie,50_ 54,2000,Heisei,12,151077,75286,75791
24 ,Mie,55_ 59,2000,Heisei,12,128712,63611,65101
24 ,Mie,60_ 64,2000,Heisei,12,115636,56102,59534
24 ,Mie,65_ 69,2000,Heisei,12,110317,52584,57733
24 ,Mie,70_ 74,2000,Heisei,12,96777,45103,51674
24 ,Mie,75_ 79,2000,Heisei,12,65417,24614,40803
24 ,Mie,80_ 84,2000,Heisei,12,42051,14278,27773
24 ,Mie,over_85,2000,Heisei,12,36397,10380,26017
24 ,Mie,total,2005,Heisei,17,1866963,907214,959749
24 ,Mie,0_ 4,2005,Heisei,17,83997,42922,41075
24 ,Mie,5_ 9,2005,Heisei,17,90524,46412,44112
24 ,Mie,10_ 14,2005,Heisei,17,92220,47474,44746
24 ,Mie,15_ 19,2005,Heisei,17,97011,50125,46886
24 ,Mie,20_ 24,2005,Heisei,17,94969,47152,47817
24 ,Mie,25_ 29,2005,Heisei,17,112958,57310,55648
24 ,Mie,30_ 34,2005,Heisei,17,137200,69680,67520
24 ,Mie,35_ 39,2005,Heisei,17,122049,61472,60577
24 ,Mie,40_ 44,2005,Heisei,17,118687,59318,59369
24 ,Mie,45_ 49,2005,Heisei,17,112541,55768,56773
24 ,Mie,50_ 54,2005,Heisei,17,126160,62391,63769
24 ,Mie,55_ 59,2005,Heisei,17,149085,73751,75334
24 ,Mie,60_ 64,2005,Heisei,17,126595,61942,64653
24 ,Mie,65_ 69,2005,Heisei,17,111411,53344,58067
24 ,Mie,70_ 74,2005,Heisei,17,103221,47776,55445
24 ,Mie,75_ 79,2005,Heisei,17,86107,38161,47946
24 ,Mie,80_ 84,2005,Heisei,17,53558,18419,35139
24 ,Mie,over_85,2005,Heisei,17,46350,12261,34089
24 ,Mie,total,2010,Heisei,22,1854724,903398,951326
24 ,Mie,0_ 4,2010,Heisei,22,78290,39794,38496
24 ,Mie,5_ 9,2010,Heisei,22,84690,43382,41308
24 ,Mie,10_ 14,2010,Heisei,22,90194,46315,43879
24 ,Mie,15_ 19,2010,Heisei,22,88478,45356,43122
24 ,Mie,20_ 24,2010,Heisei,22,86035,43265,42770
24 ,Mie,25_ 29,2010,Heisei,22,97935,50351,47584
24 ,Mie,30_ 34,2010,Heisei,22,113414,58075,55339
24 ,Mie,35_ 39,2010,Heisei,22,137309,69993,67316
24 ,Mie,40_ 44,2010,Heisei,22,121443,61258,60185
24 ,Mie,45_ 49,2010,Heisei,22,117235,58550,58685
24 ,Mie,50_ 54,2010,Heisei,22,110638,54542,56096
24 ,Mie,55_ 59,2010,Heisei,22,124119,60970,63149
24 ,Mie,60_ 64,2010,Heisei,22,145669,71281,74388
24 ,Mie,65_ 69,2010,Heisei,22,121826,58618,63208
24 ,Mie,70_ 74,2010,Heisei,22,104277,48712,55565
24 ,Mie,75_ 79,2010,Heisei,22,92041,40649,51392
24 ,Mie,80_ 84,2010,Heisei,22,70224,28525,41699
24 ,Mie,over_85,2010,Heisei,22,58735,15682,43053
24 ,Mie,total,2015,Heisei,27,1815865,883516,932349
24 ,Mie,0_ 4,2015,Heisei,27,70966,36252,34714
24 ,Mie,5_ 9,2015,Heisei,27,78388,40000,38388
24 ,Mie,10_ 14,2015,Heisei,27,84171,43219,40952
24 ,Mie,15_ 19,2015,Heisei,27,87245,44715,42530
24 ,Mie,20_ 24,2015,Heisei,27,78170,39543,38627
24 ,Mie,25_ 29,2015,Heisei,27,86562,44572,41990
24 ,Mie,30_ 34,2015,Heisei,27,96738,49641,47097
24 ,Mie,35_ 39,2015,Heisei,27,112180,57102,55078
24 ,Mie,40_ 44,2015,Heisei,27,136315,69198,67117
24 ,Mie,45_ 49,2015,Heisei,27,119997,60361,59636
24 ,Mie,50_ 54,2015,Heisei,27,115031,57154,57877
24 ,Mie,55_ 59,2015,Heisei,27,108390,53230,55160
24 ,Mie,60_ 64,2015,Heisei,27,120949,58749,62200
24 ,Mie,65_ 69,2015,Heisei,27,140129,67717,72412
24 ,Mie,70_ 74,2015,Heisei,27,114506,53877,60629
24 ,Mie,75_ 79,2015,Heisei,27,93828,42110,51718
24 ,Mie,80_ 84,2015,Heisei,27,76242,31229,45013
24 ,Mie,over_85,2015,Heisei,27,76341,23455,52886
25 ,Shiga,total,1920,Taisho,9,651050,313737,337313
25 ,Shiga,0_ 4,1920,Taisho,9,82749,41648,41101
25 ,Shiga,5_ 9,1920,Taisho,9,82218,42099,40119
25 ,Shiga,10_ 14,1920,Taisho,9,69072,33978,35094
25 ,Shiga,15_ 19,1920,Taisho,9,53547,24793,28754
25 ,Shiga,20_ 24,1920,Taisho,9,43175,20112,23063
25 ,Shiga,25_ 29,1920,Taisho,9,40272,19700,20572
25 ,Shiga,30_ 34,1920,Taisho,9,39538,19120,20418
25 ,Shiga,35_ 39,1920,Taisho,9,41325,19796,21529
25 ,Shiga,40_ 44,1920,Taisho,9,42669,20573,22096
25 ,Shiga,45_ 49,1920,Taisho,9,34426,16558,17868
25 ,Shiga,50_ 54,1920,Taisho,9,30392,14642,15750
25 ,Shiga,55_ 59,1920,Taisho,9,25440,12217,13223
25 ,Shiga,60_ 64,1920,Taisho,9,23776,11038,12738
25 ,Shiga,65_ 69,1920,Taisho,9,19424,8709,10715
25 ,Shiga,70_ 74,1920,Taisho,9,12868,5307,7561
25 ,Shiga,75_ 79,1920,Taisho,9,6816,2420,4396
25 ,Shiga,over_80,1920,Taisho,9,3343,1027,2316
25 ,Shiga,total,1925,Taisho,14,662412,321071,341341
25 ,Shiga,0_ 4,1925,Taisho,14,84890,42918,41972
25 ,Shiga,5_ 9,1925,Taisho,14,76734,38732,38002
25 ,Shiga,10_ 14,1925,Taisho,14,75859,37820,38039
25 ,Shiga,15_ 19,1925,Taisho,14,55399,25664,29735
25 ,Shiga,20_ 24,1925,Taisho,14,47615,22881,24734
25 ,Shiga,25_ 29,1925,Taisho,14,42413,21172,21241
25 ,Shiga,30_ 34,1925,Taisho,14,38269,19026,19243
25 ,Shiga,35_ 39,1925,Taisho,14,38094,18717,19377
25 ,Shiga,40_ 44,1925,Taisho,14,39242,18967,20275
25 ,Shiga,45_ 49,1925,Taisho,14,40355,19545,20810
25 ,Shiga,50_ 54,1925,Taisho,14,31830,15357,16473
25 ,Shiga,55_ 59,1925,Taisho,14,27096,12901,14195
25 ,Shiga,60_ 64,1925,Taisho,14,21508,10024,11484
25 ,Shiga,65_ 69,1925,Taisho,14,18452,8149,10303
25 ,Shiga,70_ 74,1925,Taisho,14,13465,5454,8011
25 ,Shiga,75_ 79,1925,Taisho,14,7346,2645,4701
25 ,Shiga,80_ 84,1925,Taisho,14,2970,893,2077
25 ,Shiga,over_85,1925,Taisho,14,875,206,669
25 ,Shiga,total,1930,Showa,5,691631,337016,354615
25 ,Shiga,0_ 4,1930,Showa,5,89147,45070,44077
25 ,Shiga,5_ 9,1930,Showa,5,80848,41035,39813
25 ,Shiga,10_ 14,1930,Showa,5,72753,35751,37002
25 ,Shiga,15_ 19,1930,Showa,5,63765,29761,34004
25 ,Shiga,20_ 24,1930,Showa,5,51644,25002,26642
25 ,Shiga,25_ 29,1930,Showa,5,47267,23877,23390
25 ,Shiga,30_ 34,1930,Showa,5,41909,21304,20605
25 ,Shiga,35_ 39,1930,Showa,5,37624,18942,18682
25 ,Shiga,40_ 44,1930,Showa,5,36682,18213,18469
25 ,Shiga,45_ 49,1930,Showa,5,37532,18146,19386
25 ,Shiga,50_ 54,1930,Showa,5,37786,18282,19504
25 ,Shiga,55_ 59,1930,Showa,5,28944,13812,15132
25 ,Shiga,60_ 64,1930,Showa,5,23410,10864,12546
25 ,Shiga,65_ 69,1930,Showa,5,17007,7508,9499
25 ,Shiga,70_ 74,1930,Showa,5,13003,5278,7725
25 ,Shiga,75_ 79,1930,Showa,5,7879,2852,5027
25 ,Shiga,over_80,1930,Showa,5,4431,1319,3112
25 ,Shiga,total,1935,Showa,10,711436,345185,366251
25 ,Shiga,0_ 4,1935,Showa,10,88263,44989,43274
25 ,Shiga,5_ 9,1935,Showa,10,85604,43370,42234
25 ,Shiga,10_ 14,1935,Showa,10,78234,38302,39932
25 ,Shiga,15_ 19,1935,Showa,10,61296,26664,34632
25 ,Shiga,20_ 24,1935,Showa,10,54923,26345,28578
25 ,Shiga,25_ 29,1935,Showa,10,49599,24609,24990
25 ,Shiga,30_ 34,1935,Showa,10,45456,22975,22481
25 ,Shiga,35_ 39,1935,Showa,10,40402,20622,19780
25 ,Shiga,40_ 44,1935,Showa,10,35890,18167,17723
25 ,Shiga,45_ 49,1935,Showa,10,34984,17337,17647
25 ,Shiga,50_ 54,1935,Showa,10,35021,16876,18145
25 ,Shiga,55_ 59,1935,Showa,10,34347,16435,17912
25 ,Shiga,60_ 64,1935,Showa,10,24952,11557,13395
25 ,Shiga,65_ 69,1935,Showa,10,18421,8067,10354
25 ,Shiga,70_ 74,1935,Showa,10,11888,4860,7028
25 ,Shiga,75_ 79,1935,Showa,10,7379,2633,4746
25 ,Shiga,over_80,1935,Showa,10,4777,1377,3400
25 ,Shiga,total,1940,Showa,15,703530,341536,361994
25 ,Shiga,0_ 4,1940,Showa,15,80730,41011,39719
25 ,Shiga,5_ 9,1940,Showa,15,83074,42394,40680
25 ,Shiga,10_ 14,1940,Showa,15,81603,40170,41433
25 ,Shiga,15_ 19,1940,Showa,15,61770,27474,34296
25 ,Shiga,20_ 24,1940,Showa,15,51434,25902,25532
25 ,Shiga,25_ 29,1940,Showa,15,49301,23877,25424
25 ,Shiga,30_ 34,1940,Showa,15,44755,21682,23073
25 ,Shiga,35_ 39,1940,Showa,15,42084,20824,21260
25 ,Shiga,40_ 44,1940,Showa,15,37800,19154,18646
25 ,Shiga,45_ 49,1940,Showa,15,33400,16731,16669
25 ,Shiga,50_ 54,1940,Showa,15,32263,15893,16370
25 ,Shiga,55_ 59,1940,Showa,15,31647,15006,16641
25 ,Shiga,60_ 64,1940,Showa,15,29517,13764,15753
25 ,Shiga,65_ 69,1940,Showa,15,19931,8786,11145
25 ,Shiga,70_ 74,1940,Showa,15,12998,5221,7777
25 ,Shiga,75_ 79,1940,Showa,15,6863,2436,4427
25 ,Shiga,80_ 84,1940,Showa,15,3127,940,2187
25 ,Shiga,over_85,1940,Showa,15,1232,270,962
25 ,Shiga,total,1945,Showa,20,860911,394802,466109
25 ,Shiga,1_ 5,1945,Showa,20,104942,53039,51903
25 ,Shiga,6_ 10,1945,Showa,20,100882,51229,49653
25 ,Shiga,11_ 15,1945,Showa,20,101062,51071,49991
25 ,Shiga,16_ 20,1945,Showa,20,88420,42217,46203
25 ,Shiga,21_ 25,1945,Showa,20,61312,21490,39822
25 ,Shiga,26_ 30,1945,Showa,20,51111,17023,34088
25 ,Shiga,31_ 35,1945,Showa,20,53087,19463,33624
25 ,Shiga,36_ 40,1945,Showa,20,52664,23586,29078
25 ,Shiga,41_ 45,1945,Showa,20,49537,23995,25542
25 ,Shiga,46_ 50,1945,Showa,20,43654,21906,21748
25 ,Shiga,51_ 55,1945,Showa,20,37234,18556,18678
25 ,Shiga,56_ 60,1945,Showa,20,33926,16288,17638
25 ,Shiga,61_ 65,1945,Showa,20,30583,13889,16694
25 ,Shiga,66_ 70,1945,Showa,20,25838,11182,14656
25 ,Shiga,71_ 75,1945,Showa,20,15251,6153,9098
25 ,Shiga,76_ 80,1945,Showa,20,7588,2671,4917
25 ,Shiga,81_ 85,1945,Showa,20,2949,849,2100
25 ,Shiga,86以上,1945,Showa,20,871,195,676
25 ,Shiga,total,1950,Showa,25,861180,413110,448070
25 ,Shiga,0_ 4,1950,Showa,25,103740,53026,50714
25 ,Shiga,5_ 9,1950,Showa,25,92760,47043,45717
25 ,Shiga,10_ 14,1950,Showa,25,89542,45512,44030
25 ,Shiga,15_ 19,1950,Showa,25,89740,43207,46533
25 ,Shiga,20_ 24,1950,Showa,25,78285,38418,39867
25 ,Shiga,25_ 29,1950,Showa,25,58046,25104,32942
25 ,Shiga,30_ 34,1950,Showa,25,51151,22019,29132
25 ,Shiga,35_ 39,1950,Showa,25,52410,23441,28969
25 ,Shiga,40_ 44,1950,Showa,25,48562,23180,25382
25 ,Shiga,45_ 49,1950,Showa,25,44207,21801,22406
25 ,Shiga,50_ 54,1950,Showa,25,38141,19138,19003
25 ,Shiga,55_ 59,1950,Showa,25,32278,15923,16355
25 ,Shiga,60_ 64,1950,Showa,25,28273,13395,14878
25 ,Shiga,65_ 69,1950,Showa,25,23569,10362,13207
25 ,Shiga,70_ 74,1950,Showa,25,17499,7144,10355
25 ,Shiga,75_ 79,1950,Showa,25,8522,3144,5378
25 ,Shiga,over_80,1950,Showa,25,4437,1245,3192
25 ,Shiga,total,1955,Showa,30,853734,409813,443921
25 ,Shiga,0_ 4,1955,Showa,30,80152,41294,38858
25 ,Shiga,5_ 9,1955,Showa,30,98829,50496,48333
25 ,Shiga,10_ 14,1955,Showa,30,88814,45093,43721
25 ,Shiga,15_ 19,1955,Showa,30,78494,36411,42083
25 ,Shiga,20_ 24,1955,Showa,30,74886,36227,38659
25 ,Shiga,25_ 29,1955,Showa,30,69853,35304,34549
25 ,Shiga,30_ 34,1955,Showa,30,54322,23810,30512
25 ,Shiga,35_ 39,1955,Showa,30,48260,20816,27444
25 ,Shiga,40_ 44,1955,Showa,30,49509,22121,27388
25 ,Shiga,45_ 49,1955,Showa,30,45744,21767,23977
25 ,Shiga,50_ 54,1955,Showa,30,41217,20249,20968
25 ,Shiga,55_ 59,1955,Showa,30,35210,17544,17666
25 ,Shiga,60_ 64,1955,Showa,30,28608,13898,14710
25 ,Shiga,65_ 69,1955,Showa,30,23885,11053,12832
25 ,Shiga,70_ 74,1955,Showa,30,18169,7532,10637
25 ,Shiga,75_ 79,1955,Showa,30,11632,4307,7325
25 ,Shiga,80_ 84,1955,Showa,30,4561,1496,3065
25 ,Shiga,over_85,1955,Showa,30,1587,394,1193
25 ,Shiga,total,1960,Showa,35,842695,403281,439414
25 ,Shiga,0_ 4,1960,Showa,35,66674,34096,32578
25 ,Shiga,5_ 9,1960,Showa,35,78728,40597,38131
25 ,Shiga,10_ 14,1960,Showa,35,96925,49530,47395
25 ,Shiga,15_ 19,1960,Showa,35,78487,35736,42751
25 ,Shiga,20_ 24,1960,Showa,35,65551,30195,35356
25 ,Shiga,25_ 29,1960,Showa,35,67106,33576,33530
25 ,Shiga,30_ 34,1960,Showa,35,66150,33745,32405
25 ,Shiga,35_ 39,1960,Showa,35,52164,22707,29457
25 ,Shiga,40_ 44,1960,Showa,35,46391,20030,26361
25 ,Shiga,45_ 49,1960,Showa,35,47269,21083,26186
25 ,Shiga,50_ 54,1960,Showa,35,43206,20556,22650
25 ,Shiga,55_ 59,1960,Showa,35,38541,18747,19794
25 ,Shiga,60_ 64,1960,Showa,35,31848,15673,16175
25 ,Shiga,65_ 69,1960,Showa,35,24527,11672,12855
25 ,Shiga,70_ 74,1960,Showa,35,18675,8126,10549
25 ,Shiga,75_ 79,1960,Showa,35,12024,4575,7449
25 ,Shiga,80_ 84,1960,Showa,35,6281,2059,4222
25 ,Shiga,over_85,1960,Showa,35,2148,578,1570
25 ,Shiga,total,1965,Showa,40,853385,409502,443883
25 ,Shiga,0_ 4,1965,Showa,40,66313,33833,32480
25 ,Shiga,5_ 9,1965,Showa,40,66684,33986,32698
25 ,Shiga,10_ 14,1965,Showa,40,78321,40341,37980
25 ,Shiga,15_ 19,1965,Showa,40,93944,44354,49590
25 ,Shiga,20_ 24,1965,Showa,40,68403,31856,36547
25 ,Shiga,25_ 29,1965,Showa,40,61453,30183,31270
25 ,Shiga,30_ 34,1965,Showa,40,65854,33244,32610
25 ,Shiga,35_ 39,1965,Showa,40,65318,33284,32034
25 ,Shiga,40_ 44,1965,Showa,40,51239,22384,28855
25 ,Shiga,45_ 49,1965,Showa,40,45275,19512,25763
25 ,Shiga,50_ 54,1965,Showa,40,45368,20172,25196
25 ,Shiga,55_ 59,1965,Showa,40,40759,19278,21481
25 ,Shiga,60_ 64,1965,Showa,40,35203,16910,18293
25 ,Shiga,65_ 69,1965,Showa,40,27598,13256,14342
25 ,Shiga,70_ 74,1965,Showa,40,19461,8816,10645
25 ,Shiga,75_ 79,1965,Showa,40,12809,5150,7659
25 ,Shiga,80_ 84,1965,Showa,40,6444,2155,4289
25 ,Shiga,over_85,1965,Showa,40,2939,788,2151
25 ,Shiga,total,1970,Showa,45,889768,429885,459883
25 ,Shiga,0_ 4,1970,Showa,45,70483,35865,34618
25 ,Shiga,5_ 9,1970,Showa,45,67769,34611,33158
25 ,Shiga,10_ 14,1970,Showa,45,67188,34246,32942
25 ,Shiga,15_ 19,1970,Showa,45,80354,38746,41608
25 ,Shiga,20_ 24,1970,Showa,45,85732,41435,44297
25 ,Shiga,25_ 29,1970,Showa,45,68138,33921,34217
25 ,Shiga,30_ 34,1970,Showa,45,63062,31504,31558
25 ,Shiga,35_ 39,1970,Showa,45,66797,33706,33091
25 ,Shiga,40_ 44,1970,Showa,45,64466,32988,31478
25 ,Shiga,45_ 49,1970,Showa,45,51147,22413,28734
25 ,Shiga,50_ 54,1970,Showa,45,44273,19080,25193
25 ,Shiga,55_ 59,1970,Showa,45,43049,19092,23957
25 ,Shiga,60_ 64,1970,Showa,45,38045,17763,20282
25 ,Shiga,65_ 69,1970,Showa,45,31380,14560,16820
25 ,Shiga,70_ 74,1970,Showa,45,22939,10431,12508
25 ,Shiga,75_ 79,1970,Showa,45,14057,5895,8162
25 ,Shiga,80_ 84,1970,Showa,45,7466,2702,4764
25 ,Shiga,over_85,1970,Showa,45,3423,927,2496
25 ,Shiga,total,1975,Showa,50,985621,481733,503888
25 ,Shiga,0_ 4,1975,Showa,50,90818,46637,44181
25 ,Shiga,5_ 9,1975,Showa,50,76606,39218,37388
25 ,Shiga,10_ 14,1975,Showa,50,70891,36273,34618
25 ,Shiga,15_ 19,1975,Showa,50,70687,34470,36217
25 ,Shiga,20_ 24,1975,Showa,50,76121,37774,38347
25 ,Shiga,25_ 29,1975,Showa,50,91205,45850,45355
25 ,Shiga,30_ 34,1975,Showa,50,76619,38980,37639
25 ,Shiga,35_ 39,1975,Showa,50,68015,34432,33583
25 ,Shiga,40_ 44,1975,Showa,50,69332,35167,34165
25 ,Shiga,45_ 49,1975,Showa,50,66243,33836,32407
25 ,Shiga,50_ 54,1975,Showa,50,51053,22314,28739
25 ,Shiga,55_ 59,1975,Showa,50,43618,18743,24875
25 ,Shiga,60_ 64,1975,Showa,50,42266,18499,23767
25 ,Shiga,65_ 69,1975,Showa,50,35221,15962,19259
25 ,Shiga,70_ 74,1975,Showa,50,26827,11826,15001
25 ,Shiga,75_ 79,1975,Showa,50,17116,7196,9920
25 ,Shiga,80_ 84,1975,Showa,50,8529,3186,5343
25 ,Shiga,over_85,1975,Showa,50,4244,1243,3001
25 ,Shiga,total,1980,Showa,55,1079898,529208,550690
25 ,Shiga,0_ 4,1980,Showa,55,86794,44580,42214
25 ,Shiga,5_ 9,1980,Showa,55,97866,50197,47669
25 ,Shiga,10_ 14,1980,Showa,55,81077,41429,39648
25 ,Shiga,15_ 19,1980,Showa,55,73074,36500,36574
25 ,Shiga,20_ 24,1980,Showa,55,67245,32774,34471
25 ,Shiga,25_ 29,1980,Showa,55,80928,40350,40578
25 ,Shiga,30_ 34,1980,Showa,55,98907,49787,49120
25 ,Shiga,35_ 39,1980,Showa,55,82742,42266,40476
25 ,Shiga,40_ 44,1980,Showa,55,71351,36267,35084
25 ,Shiga,45_ 49,1980,Showa,55,70785,35985,34800
25 ,Shiga,50_ 54,1980,Showa,55,66932,33951,32981
25 ,Shiga,55_ 59,1980,Showa,55,51231,22183,29048
25 ,Shiga,60_ 64,1980,Showa,55,42620,17980,24640
25 ,Shiga,65_ 69,1980,Showa,55,39834,16982,22852
25 ,Shiga,70_ 74,1980,Showa,55,31058,13484,17574
25 ,Shiga,75_ 79,1980,Showa,55,20979,8600,12379
25 ,Shiga,80_ 84,1980,Showa,55,11039,4163,6876
25 ,Shiga,over_85,1980,Showa,55,5335,1666,3669
25 ,Shiga,total,1985,Showa,60,1155844,568735,587109
25 ,Shiga,0_ 4,1985,Showa,60,78441,40456,37985
25 ,Shiga,5_ 9,1985,Showa,60,90601,46432,44169
25 ,Shiga,10_ 14,1985,Showa,60,101288,51960,49328
25 ,Shiga,15_ 19,1985,Showa,60,82972,42036,40936
25 ,Shiga,20_ 24,1985,Showa,60,71271,35204,36067
25 ,Shiga,25_ 29,1985,Showa,60,72004,35848,36156
25 ,Shiga,30_ 34,1985,Showa,60,85094,42646,42448
25 ,Shiga,35_ 39,1985,Showa,60,103321,52152,51169
25 ,Shiga,40_ 44,1985,Showa,60,85393,43888,41505
25 ,Shiga,45_ 49,1985,Showa,60,72365,36976,35389
25 ,Shiga,50_ 54,1985,Showa,60,70990,35921,35069
25 ,Shiga,55_ 59,1985,Showa,60,66829,33635,33194
25 ,Shiga,60_ 64,1985,Showa,60,50456,21596,28860
25 ,Shiga,65_ 69,1985,Showa,60,40715,16773,23942
25 ,Shiga,70_ 74,1985,Showa,60,36267,14890,21377
25 ,Shiga,75_ 79,1985,Showa,60,25697,10523,15174
25 ,Shiga,80_ 84,1985,Showa,60,14460,5323,9137
25 ,Shiga,over_85,1985,Showa,60,7518,2369,5149
25 ,Shiga,total,1990,Heisei,2,1222411,601082,621329
25 ,Shiga,0_ 4,1990,Heisei,2,72997,37446,35551
25 ,Shiga,5_ 9,1990,Heisei,2,82828,42748,40080
25 ,Shiga,10_ 14,1990,Heisei,2,93433,47828,45605
25 ,Shiga,15_ 19,1990,Heisei,2,100615,50943,49672
25 ,Shiga,20_ 24,1990,Heisei,2,78929,39124,39805
25 ,Shiga,25_ 29,1990,Heisei,2,76656,38162,38494
25 ,Shiga,30_ 34,1990,Heisei,2,76990,38126,38864
25 ,Shiga,35_ 39,1990,Heisei,2,89518,44964,44554
25 ,Shiga,40_ 44,1990,Heisei,2,106224,53844,52380
25 ,Shiga,45_ 49,1990,Heisei,2,86103,44266,41837
25 ,Shiga,50_ 54,1990,Heisei,2,72577,36789,35788
25 ,Shiga,55_ 59,1990,Heisei,2,70759,35422,35337
25 ,Shiga,60_ 64,1990,Heisei,2,65861,32753,33108
25 ,Shiga,65_ 69,1990,Heisei,2,48602,20373,28229
25 ,Shiga,70_ 74,1990,Heisei,2,37771,14911,22860
25 ,Shiga,75_ 79,1990,Heisei,2,31140,11974,19166
25 ,Shiga,80_ 84,1990,Heisei,2,18797,6954,11843
25 ,Shiga,over_85,1990,Heisei,2,10834,3289,7545
25 ,Shiga,total,1995,Heisei,7,1287005,634648,652357
25 ,Shiga,0_ 4,1995,Heisei,7,68686,35049,33637
25 ,Shiga,5_ 9,1995,Heisei,7,76976,39532,37444
25 ,Shiga,10_ 14,1995,Heisei,7,85360,44048,41312
25 ,Shiga,15_ 19,1995,Heisei,7,93178,47428,45750
25 ,Shiga,20_ 24,1995,Heisei,7,100766,51260,49506
25 ,Shiga,25_ 29,1995,Heisei,7,86504,43913,42591
25 ,Shiga,30_ 34,1995,Heisei,7,82486,41116,41370
25 ,Shiga,35_ 39,1995,Heisei,7,81596,40606,40990
25 ,Shiga,40_ 44,1995,Heisei,7,92644,46792,45852
25 ,Shiga,45_ 49,1995,Heisei,7,108092,54973,53119
25 ,Shiga,50_ 54,1995,Heisei,7,86797,44523,42274
25 ,Shiga,55_ 59,1995,Heisei,7,72705,36666,36039
25 ,Shiga,60_ 64,1995,Heisei,7,69687,34381,35306
25 ,Shiga,65_ 69,1995,Heisei,7,63354,30776,32578
25 ,Shiga,70_ 74,1995,Heisei,7,45739,18449,27290
25 ,Shiga,75_ 79,1995,Heisei,7,33103,12176,20927
25 ,Shiga,80_ 84,1995,Heisei,7,23718,8207,15511
25 ,Shiga,over_85,1995,Heisei,7,15462,4648,10814
25 ,Shiga,total,2000,Heisei,12,1342832,663432,679400
25 ,Shiga,0_ 4,2000,Heisei,12,70788,36370,34418
25 ,Shiga,5_ 9,2000,Heisei,12,70881,36252,34629
25 ,Shiga,10_ 14,2000,Heisei,12,78403,40316,38087
25 ,Shiga,15_ 19,2000,Heisei,12,85772,44113,41659
25 ,Shiga,20_ 24,2000,Heisei,12,95637,49610,46027
25 ,Shiga,25_ 29,2000,Heisei,12,105107,53874,51233
25 ,Shiga,30_ 34,2000,Heisei,12,90800,45918,44882
25 ,Shiga,35_ 39,2000,Heisei,12,86184,43088,43096
25 ,Shiga,40_ 44,2000,Heisei,12,83646,41719,41927
25 ,Shiga,45_ 49,2000,Heisei,12,93389,47162,46227
25 ,Shiga,50_ 54,2000,Heisei,12,107765,54532,53233
25 ,Shiga,55_ 59,2000,Heisei,12,86419,43823,42596
25 ,Shiga,60_ 64,2000,Heisei,12,71910,35823,36087
25 ,Shiga,65_ 69,2000,Heisei,12,67144,32394,34750
25 ,Shiga,70_ 74,2000,Heisei,12,58834,27570,31264
25 ,Shiga,75_ 79,2000,Heisei,12,40827,15527,25300
25 ,Shiga,80_ 84,2000,Heisei,12,26427,8723,17704
25 ,Shiga,over_85,2000,Heisei,12,22320,6214,16106
25 ,Shiga,total,2005,Heisei,17,1380361,681474,698887
25 ,Shiga,0_ 4,2005,Heisei,17,69443,35808,33635
25 ,Shiga,5_ 9,2005,Heisei,17,72297,37134,35163
25 ,Shiga,10_ 14,2005,Heisei,17,71407,36522,34885
25 ,Shiga,15_ 19,2005,Heisei,17,79346,41242,38104
25 ,Shiga,20_ 24,2005,Heisei,17,87432,46138,41294
25 ,Shiga,25_ 29,2005,Heisei,17,93516,47593,45923
25 ,Shiga,30_ 34,2005,Heisei,17,108391,55312,53079
25 ,Shiga,35_ 39,2005,Heisei,17,92922,46927,45995
25 ,Shiga,40_ 44,2005,Heisei,17,87211,43663,43548
25 ,Shiga,45_ 49,2005,Heisei,17,83122,41229,41893
25 ,Shiga,50_ 54,2005,Heisei,17,92614,46479,46135
25 ,Shiga,55_ 59,2005,Heisei,17,106688,53549,53139
25 ,Shiga,60_ 64,2005,Heisei,17,85330,42732,42598
25 ,Shiga,65_ 69,2005,Heisei,17,69422,33958,35464
25 ,Shiga,70_ 74,2005,Heisei,17,63308,29620,33688
25 ,Shiga,75_ 79,2005,Heisei,17,52868,23461,29407
25 ,Shiga,80_ 84,2005,Heisei,17,33865,11622,22243
25 ,Shiga,over_85,2005,Heisei,17,29955,7662,22293
25 ,Shiga,total,2010,Heisei,22,1410777,696769,714008
25 ,Shiga,0_ 4,2010,Heisei,22,67249,34582,32667
25 ,Shiga,5_ 9,2010,Heisei,22,70864,36506,34358
25 ,Shiga,10_ 14,2010,Heisei,22,72640,37408,35232
25 ,Shiga,15_ 19,2010,Heisei,22,72773,37684,35089
25 ,Shiga,20_ 24,2010,Heisei,22,79444,42151,37293
25 ,Shiga,25_ 29,2010,Heisei,22,81558,41615,39943
25 ,Shiga,30_ 34,2010,Heisei,22,94775,47724,47051
25 ,Shiga,35_ 39,2010,Heisei,22,110127,55963,54164
25 ,Shiga,40_ 44,2010,Heisei,22,93607,47134,46473
25 ,Shiga,45_ 49,2010,Heisei,22,86676,43229,43447
25 ,Shiga,50_ 54,2010,Heisei,22,82261,40604,41657
25 ,Shiga,55_ 59,2010,Heisei,22,91395,45597,45798
25 ,Shiga,60_ 64,2010,Heisei,22,104967,52164,52803
25 ,Shiga,65_ 69,2010,Heisei,22,82658,40685,41973
25 ,Shiga,70_ 74,2010,Heisei,22,65841,31336,34505
25 ,Shiga,75_ 79,2010,Heisei,22,57447,25639,31808
25 ,Shiga,80_ 84,2010,Heisei,22,43990,17882,26108
25 ,Shiga,over_85,2010,Heisei,22,38852,10140,28712
25 ,Shiga,total,2015,Heisei,27,1412916,696941,715975
25 ,Shiga,0_ 4,2015,Heisei,27,64090,32824,31266
25 ,Shiga,5_ 9,2015,Heisei,27,68179,35101,33078
25 ,Shiga,10_ 14,2015,Heisei,27,71181,36663,34518
25 ,Shiga,15_ 19,2015,Heisei,27,74153,38307,35846
25 ,Shiga,20_ 24,2015,Heisei,27,71473,37554,33919
25 ,Shiga,25_ 29,2015,Heisei,27,74245,38641,35604
25 ,Shiga,30_ 34,2015,Heisei,27,82397,42007,40390
25 ,Shiga,35_ 39,2015,Heisei,27,95821,48127,47694
25 ,Shiga,40_ 44,2015,Heisei,27,110373,55957,54416
25 ,Shiga,45_ 49,2015,Heisei,27,93054,46688,46366
25 ,Shiga,50_ 54,2015,Heisei,27,85639,42589,43050
25 ,Shiga,55_ 59,2015,Heisei,27,81004,39932,41072
25 ,Shiga,60_ 64,2015,Heisei,27,89561,44277,45284
25 ,Shiga,65_ 69,2015,Heisei,27,101609,49829,51780
25 ,Shiga,70_ 74,2015,Heisei,27,77928,37605,40323
25 ,Shiga,75_ 79,2015,Heisei,27,59906,27497,32409
25 ,Shiga,80_ 84,2015,Heisei,27,48389,20071,28318
25 ,Shiga,over_85,2015,Heisei,27,50045,15118,34927
26 ,Kyoto,total,1920,Taisho,9,1287147,650780,636367
26 ,Kyoto,0_ 4,1920,Taisho,9,145308,73266,72042
26 ,Kyoto,5_ 9,1920,Taisho,9,140127,70980,69147
26 ,Kyoto,10_ 14,1920,Taisho,9,139909,71088,68821
26 ,Kyoto,15_ 19,1920,Taisho,9,139217,71469,67748
26 ,Kyoto,20_ 24,1920,Taisho,9,118540,62402,56138
26 ,Kyoto,25_ 29,1920,Taisho,9,96906,51080,45826
26 ,Kyoto,30_ 34,1920,Taisho,9,84641,43858,40783
26 ,Kyoto,35_ 39,1920,Taisho,9,82039,41889,40150
26 ,Kyoto,40_ 44,1920,Taisho,9,79937,41239,38698
26 ,Kyoto,45_ 49,1920,Taisho,9,63373,32497,30876
26 ,Kyoto,50_ 54,1920,Taisho,9,52583,26591,25992
26 ,Kyoto,55_ 59,1920,Taisho,9,41987,20600,21387
26 ,Kyoto,60_ 64,1920,Taisho,9,37720,17691,20029
26 ,Kyoto,65_ 69,1920,Taisho,9,29799,13268,16531
26 ,Kyoto,70_ 74,1920,Taisho,9,19407,7715,11692
26 ,Kyoto,75_ 79,1920,Taisho,9,10311,3587,6724
26 ,Kyoto,over_80,1920,Taisho,9,5343,1560,3783
26 ,Kyoto,total,1925,Taisho,14,1406382,717464,688918
26 ,Kyoto,0_ 4,1925,Taisho,14,164958,83312,81646
26 ,Kyoto,5_ 9,1925,Taisho,14,135581,68627,66954
26 ,Kyoto,10_ 14,1925,Taisho,14,149409,76182,73227
26 ,Kyoto,15_ 19,1925,Taisho,14,166951,87410,79541
26 ,Kyoto,20_ 24,1925,Taisho,14,141511,75389,66122
26 ,Kyoto,25_ 29,1925,Taisho,14,113161,60447,52714
26 ,Kyoto,30_ 34,1925,Taisho,14,91648,48517,43131
26 ,Kyoto,35_ 39,1925,Taisho,14,81387,42587,38800
26 ,Kyoto,40_ 44,1925,Taisho,14,77916,39914,38002
26 ,Kyoto,45_ 49,1925,Taisho,14,75761,38786,36975
26 ,Kyoto,50_ 54,1925,Taisho,14,58528,29546,28982
26 ,Kyoto,55_ 59,1925,Taisho,14,46974,23124,23850
26 ,Kyoto,60_ 64,1925,Taisho,14,35591,16697,18894
26 ,Kyoto,65_ 69,1925,Taisho,14,29003,12776,16227
26 ,Kyoto,70_ 74,1925,Taisho,14,20752,8536,12216
26 ,Kyoto,75_ 79,1925,Taisho,14,11149,3861,7288
26 ,Kyoto,80_ 84,1925,Taisho,14,4614,1343,3271
26 ,Kyoto,over_85,1925,Taisho,14,1488,410,1078
26 ,Kyoto,total,1930,Showa,5,1552832,792420,760412
26 ,Kyoto,0_ 4,1930,Showa,5,186616,94080,92536
26 ,Kyoto,5_ 9,1930,Showa,5,155658,78792,76866
26 ,Kyoto,10_ 14,1930,Showa,5,144762,74219,70543
26 ,Kyoto,15_ 19,1930,Showa,5,185751,95575,90176
26 ,Kyoto,20_ 24,1930,Showa,5,165385,87514,77871
26 ,Kyoto,25_ 29,1930,Showa,5,132384,70592,61792
26 ,Kyoto,30_ 34,1930,Showa,5,108782,58251,50531
26 ,Kyoto,35_ 39,1930,Showa,5,89009,47384,41625
26 ,Kyoto,40_ 44,1930,Showa,5,78350,40804,37546
26 ,Kyoto,45_ 49,1930,Showa,5,73925,37426,36499
26 ,Kyoto,50_ 54,1930,Showa,5,70574,35499,35075
26 ,Kyoto,55_ 59,1930,Showa,5,53340,26180,27160
26 ,Kyoto,60_ 64,1930,Showa,5,40611,19226,21385
26 ,Kyoto,65_ 69,1930,Showa,5,28213,12349,15864
26 ,Kyoto,70_ 74,1930,Showa,5,20466,8200,12266
26 ,Kyoto,75_ 79,1930,Showa,5,12036,4397,7639
26 ,Kyoto,over_80,1930,Showa,5,6970,1932,5038
26 ,Kyoto,total,1935,Showa,10,1702508,862998,839510
26 ,Kyoto,0_ 4,1935,Showa,10,199605,101261,98344
26 ,Kyoto,5_ 9,1935,Showa,10,177336,89551,87785
26 ,Kyoto,10_ 14,1935,Showa,10,167935,84929,83006
26 ,Kyoto,15_ 19,1935,Showa,10,190477,96657,93820
26 ,Kyoto,20_ 24,1935,Showa,10,180859,92235,88624
26 ,Kyoto,25_ 29,1935,Showa,10,150762,79644,71118
26 ,Kyoto,30_ 34,1935,Showa,10,123277,65320,57957
26 ,Kyoto,35_ 39,1935,Showa,10,102861,54859,48002
26 ,Kyoto,40_ 44,1935,Showa,10,84102,44466,39636
26 ,Kyoto,45_ 49,1935,Showa,10,74032,38071,35961
26 ,Kyoto,50_ 54,1935,Showa,10,68723,34229,34494
26 ,Kyoto,55_ 59,1935,Showa,10,64093,31190,32903
26 ,Kyoto,60_ 64,1935,Showa,10,46114,21638,24476
26 ,Kyoto,65_ 69,1935,Showa,10,32382,14435,17947
26 ,Kyoto,70_ 74,1935,Showa,10,20159,8107,12052
26 ,Kyoto,75_ 79,1935,Showa,10,12156,4249,7907
26 ,Kyoto,over_80,1935,Showa,10,7635,2157,5478
26 ,Kyoto,total,1940,Showa,15,1729356,863055,866301
26 ,Kyoto,0_ 4,1940,Showa,15,193632,98269,95363
26 ,Kyoto,5_ 9,1940,Showa,15,185653,94086,91567
26 ,Kyoto,10_ 14,1940,Showa,15,178212,89828,88384
26 ,Kyoto,15_ 19,1940,Showa,15,185441,91799,93642
26 ,Kyoto,20_ 24,1940,Showa,15,155732,76151,79581
26 ,Kyoto,25_ 29,1940,Showa,15,148472,73591,74881
26 ,Kyoto,30_ 34,1940,Showa,15,132631,68322,64309
26 ,Kyoto,35_ 39,1940,Showa,15,113224,58844,54380
26 ,Kyoto,40_ 44,1940,Showa,15,95031,50053,44978
26 ,Kyoto,45_ 49,1940,Showa,15,77826,40502,37324
26 ,Kyoto,50_ 54,1940,Showa,15,68194,34534,33660
26 ,Kyoto,55_ 59,1940,Showa,15,61545,29841,31704
26 ,Kyoto,60_ 64,1940,Showa,15,54597,25394,29203
26 ,Kyoto,65_ 69,1940,Showa,15,36631,16135,20496
26 ,Kyoto,70_ 74,1940,Showa,15,23121,9431,13690
26 ,Kyoto,75_ 79,1940,Showa,15,11811,4158,7653
26 ,Kyoto,80_ 84,1940,Showa,15,5396,1600,3796
26 ,Kyoto,over_85,1940,Showa,15,2203,514,1689
26 ,Kyoto,total,1945,Showa,20,1603796,752494,851302
26 ,Kyoto,1_ 5,1945,Showa,20,188303,95359,92944
26 ,Kyoto,6_ 10,1945,Showa,20,170187,85966,84221
26 ,Kyoto,11_ 15,1945,Showa,20,177166,89899,87267
26 ,Kyoto,16_ 20,1945,Showa,20,167126,82388,84738
26 ,Kyoto,21_ 25,1945,Showa,20,123716,48096,75620
26 ,Kyoto,26_ 30,1945,Showa,20,100618,36009,64609
26 ,Kyoto,31_ 35,1945,Showa,20,107902,42984,64918
26 ,Kyoto,36_ 40,1945,Showa,20,110433,51133,59300
26 ,Kyoto,41_ 45,1945,Showa,20,102678,51476,51202
26 ,Kyoto,46_ 50,1945,Showa,20,89428,46233,43195
26 ,Kyoto,51_ 55,1945,Showa,20,72223,37023,35200
26 ,Kyoto,56_ 60,1945,Showa,20,61465,30189,31276
26 ,Kyoto,61_ 65,1945,Showa,20,50276,23169,27107
26 ,Kyoto,66_ 70,1945,Showa,20,40548,17341,23207
26 ,Kyoto,71_ 75,1945,Showa,20,24329,9576,14753
26 ,Kyoto,76_ 80,1945,Showa,20,11532,4009,7523
26 ,Kyoto,81_ 85,1945,Showa,20,4382,1293,3089
26 ,Kyoto,86以上,1945,Showa,20,1484,351,1133
26 ,Kyoto,total,1950,Showa,25,1832934,891616,941318
26 ,Kyoto,0_ 4,1950,Showa,25,225053,115223,109830
26 ,Kyoto,5_ 9,1950,Showa,25,195789,99224,96565
26 ,Kyoto,10_ 14,1950,Showa,25,172640,87451,85189
26 ,Kyoto,15_ 19,1950,Showa,25,184431,93251,91180
26 ,Kyoto,20_ 24,1950,Showa,25,176614,90543,86071
26 ,Kyoto,25_ 29,1950,Showa,25,134811,59488,75323
26 ,Kyoto,30_ 34,1950,Showa,25,115739,50101,65638
26 ,Kyoto,35_ 39,1950,Showa,25,120717,54805,65912
26 ,Kyoto,40_ 44,1950,Showa,25,112621,54935,57686
26 ,Kyoto,45_ 49,1950,Showa,25,99075,49612,49463
26 ,Kyoto,50_ 54,1950,Showa,25,82078,41516,40562
26 ,Kyoto,55_ 59,1950,Showa,25,66036,32850,33186
26 ,Kyoto,60_ 64,1950,Showa,25,53416,25107,28309
26 ,Kyoto,65_ 69,1950,Showa,25,41190,17931,23259
26 ,Kyoto,70_ 74,1950,Showa,25,30042,11982,18060
26 ,Kyoto,75_ 79,1950,Showa,25,15198,5411,9787
26 ,Kyoto,over_80,1950,Showa,25,7399,2145,5254
26 ,Kyoto,total,1955,Showa,30,1935161,944278,990883
26 ,Kyoto,0_ 4,1955,Showa,30,156577,80169,76408
26 ,Kyoto,5_ 9,1955,Showa,30,220655,112946,107709
26 ,Kyoto,10_ 14,1955,Showa,30,194678,98613,96065
26 ,Kyoto,15_ 19,1955,Showa,30,190919,97379,93540
26 ,Kyoto,20_ 24,1955,Showa,30,197113,102251,94862
26 ,Kyoto,25_ 29,1955,Showa,30,164911,82091,82820
26 ,Kyoto,30_ 34,1955,Showa,30,129325,56788,72537
26 ,Kyoto,35_ 39,1955,Showa,30,111469,47735,63734
26 ,Kyoto,40_ 44,1955,Showa,30,117270,52946,64324
26 ,Kyoto,45_ 49,1955,Showa,30,109192,53115,56077
26 ,Kyoto,50_ 54,1955,Showa,30,94733,47051,47682
26 ,Kyoto,55_ 59,1955,Showa,30,77523,38798,38725
26 ,Kyoto,60_ 64,1955,Showa,30,59750,29160,30590
26 ,Kyoto,65_ 69,1955,Showa,30,45673,20810,24863
26 ,Kyoto,70_ 74,1955,Showa,30,32840,13382,19458
26 ,Kyoto,75_ 79,1955,Showa,30,21052,7674,13378
26 ,Kyoto,80_ 84,1955,Showa,30,8572,2649,5923
26 ,Kyoto,over_85,1955,Showa,30,2880,709,2171
26 ,Kyoto,total,1960,Showa,35,1993403,973040,1020363
26 ,Kyoto,0_ 4,1960,Showa,35,138647,71326,67321
26 ,Kyoto,5_ 9,1960,Showa,35,153604,78630,74974
26 ,Kyoto,10_ 14,1960,Showa,35,218270,111700,106570
26 ,Kyoto,15_ 19,1960,Showa,35,216927,109208,107719
26 ,Kyoto,20_ 24,1960,Showa,35,197002,102600,94402
26 ,Kyoto,25_ 29,1960,Showa,35,176174,88757,87417
26 ,Kyoto,30_ 34,1960,Showa,35,156008,77330,78678
26 ,Kyoto,35_ 39,1960,Showa,35,124222,54068,70154
26 ,Kyoto,40_ 44,1960,Showa,35,107825,45796,62029
26 ,Kyoto,45_ 49,1960,Showa,35,113554,51011,62543
26 ,Kyoto,50_ 54,1960,Showa,35,104800,50654,54146
26 ,Kyoto,55_ 59,1960,Showa,35,89106,43735,45371
26 ,Kyoto,60_ 64,1960,Showa,35,70823,34888,35935
26 ,Kyoto,65_ 69,1960,Showa,35,51611,24452,27159
26 ,Kyoto,70_ 74,1960,Showa,35,36542,15730,20812
26 ,Kyoto,75_ 79,1960,Showa,35,22532,8403,14129
26 ,Kyoto,80_ 84,1960,Showa,35,11637,3695,7942
26 ,Kyoto,over_85,1960,Showa,35,4119,1057,3062
26 ,Kyoto,total,1965,Showa,40,2102808,1028073,1074735
26 ,Kyoto,0_ 4,1965,Showa,40,159729,81481,78248
26 ,Kyoto,5_ 9,1965,Showa,40,137842,70572,67270
26 ,Kyoto,10_ 14,1965,Showa,40,153614,78222,75392
26 ,Kyoto,15_ 19,1965,Showa,40,249196,126406,122790
26 ,Kyoto,20_ 24,1965,Showa,40,229301,119007,110294
26 ,Kyoto,25_ 29,1965,Showa,40,180049,90768,89281
26 ,Kyoto,30_ 34,1965,Showa,40,172047,86567,85480
26 ,Kyoto,35_ 39,1965,Showa,40,153506,75939,77567
26 ,Kyoto,40_ 44,1965,Showa,40,121989,53023,68966
26 ,Kyoto,45_ 49,1965,Showa,40,105668,44673,60995
26 ,Kyoto,50_ 54,1965,Showa,40,109841,49083,60758
26 ,Kyoto,55_ 59,1965,Showa,40,99902,48042,51860
26 ,Kyoto,60_ 64,1965,Showa,40,82216,39807,42409
26 ,Kyoto,65_ 69,1965,Showa,40,62132,29771,32361
26 ,Kyoto,70_ 74,1965,Showa,40,41679,18775,22904
26 ,Kyoto,75_ 79,1965,Showa,40,25794,10305,15489
26 ,Kyoto,80_ 84,1965,Showa,40,12408,4089,8319
26 ,Kyoto,over_85,1965,Showa,40,5895,1543,4352
26 ,Kyoto,total,1970,Showa,45,2250087,1102011,1148076
26 ,Kyoto,0_ 4,1970,Showa,45,185300,94743,90557
26 ,Kyoto,5_ 9,1970,Showa,45,159933,81619,78314
26 ,Kyoto,10_ 14,1970,Showa,45,138791,71186,67605
26 ,Kyoto,15_ 19,1970,Showa,45,184688,94071,90617
26 ,Kyoto,20_ 24,1970,Showa,45,277827,145146,132681
26 ,Kyoto,25_ 29,1970,Showa,45,205589,102550,103039
26 ,Kyoto,30_ 34,1970,Showa,45,176095,88105,87990
26 ,Kyoto,35_ 39,1970,Showa,45,170099,85283,84816
26 ,Kyoto,40_ 44,1970,Showa,45,150867,74522,76345
26 ,Kyoto,45_ 49,1970,Showa,45,120586,52211,68375
26 ,Kyoto,50_ 54,1970,Showa,45,104051,43646,60405
26 ,Kyoto,55_ 59,1970,Showa,45,104982,46476,58506
26 ,Kyoto,60_ 64,1970,Showa,45,93292,44031,49261
26 ,Kyoto,65_ 69,1970,Showa,45,73448,34621,38827
26 ,Kyoto,70_ 74,1970,Showa,45,51863,23637,28226
26 ,Kyoto,75_ 79,1970,Showa,45,30413,12766,17647
26 ,Kyoto,80_ 84,1970,Showa,45,15197,5438,9759
26 ,Kyoto,over_85,1970,Showa,45,7066,1960,5106
26 ,Kyoto,total,1975,Showa,50,2424856,1190854,1234002
26 ,Kyoto,0_ 4,1975,Showa,50,214857,110172,104685
26 ,Kyoto,5_ 9,1975,Showa,50,184897,94720,90177
26 ,Kyoto,10_ 14,1975,Showa,50,160180,81795,78385
26 ,Kyoto,15_ 19,1975,Showa,50,165324,85582,79742
26 ,Kyoto,20_ 24,1975,Showa,50,221023,118614,102409
26 ,Kyoto,25_ 29,1975,Showa,50,245090,122138,122952
26 ,Kyoto,30_ 34,1975,Showa,50,202655,100610,102045
26 ,Kyoto,35_ 39,1975,Showa,50,174555,87238,87317
26 ,Kyoto,40_ 44,1975,Showa,50,168497,84416,84081
26 ,Kyoto,45_ 49,1975,Showa,50,149748,73707,76041
26 ,Kyoto,50_ 54,1975,Showa,50,118307,50762,67545
26 ,Kyoto,55_ 59,1975,Showa,50,100566,41827,58739
26 ,Kyoto,60_ 64,1975,Showa,50,100906,43918,56988
26 ,Kyoto,65_ 69,1975,Showa,50,85998,39358,46640
26 ,Kyoto,70_ 74,1975,Showa,50,63300,28413,34887
26 ,Kyoto,75_ 79,1975,Showa,50,39708,16910,22798
26 ,Kyoto,80_ 84,1975,Showa,50,19122,7265,11857
26 ,Kyoto,over_85,1975,Showa,50,9009,2704,6305
26 ,Kyoto,total,1980,Showa,55,2527330,1238365,1288965
26 ,Kyoto,0_ 4,1980,Showa,55,178281,91674,86607
26 ,Kyoto,5_ 9,1980,Showa,55,213378,109284,104094
26 ,Kyoto,10_ 14,1980,Showa,55,184289,94497,89792
26 ,Kyoto,15_ 19,1980,Showa,55,182015,93806,88209
26 ,Kyoto,20_ 24,1980,Showa,55,194837,105123,89714
26 ,Kyoto,25_ 29,1980,Showa,55,183051,91075,91976
26 ,Kyoto,30_ 34,1980,Showa,55,239001,118389,120612
26 ,Kyoto,35_ 39,1980,Showa,55,199812,98825,100987
26 ,Kyoto,40_ 44,1980,Showa,55,171856,85557,86299
26 ,Kyoto,45_ 49,1980,Showa,55,165596,82560,83036
26 ,Kyoto,50_ 54,1980,Showa,55,146431,71478,74953
26 ,Kyoto,55_ 59,1980,Showa,55,114584,48654,65930
26 ,Kyoto,60_ 64,1980,Showa,55,96000,39165,56835
26 ,Kyoto,65_ 69,1980,Showa,55,93096,39499,53597
26 ,Kyoto,70_ 74,1980,Showa,55,75573,33180,42393
26 ,Kyoto,75_ 79,1980,Showa,55,50098,20972,29126
26 ,Kyoto,80_ 84,1980,Showa,55,26768,10468,16300
26 ,Kyoto,over_85,1980,Showa,55,12301,3905,8396
26 ,Kyoto,total,1985,Showa,60,2586574,1264035,1322539
26 ,Kyoto,0_ 4,1985,Showa,60,151182,78003,73179
26 ,Kyoto,5_ 9,1985,Showa,60,175954,90433,85521
26 ,Kyoto,10_ 14,1985,Showa,60,211492,108176,103316
26 ,Kyoto,15_ 19,1985,Showa,60,200596,103145,97451
26 ,Kyoto,20_ 24,1985,Showa,60,206539,110240,96299
26 ,Kyoto,25_ 29,1985,Showa,60,157195,78497,78698
26 ,Kyoto,30_ 34,1985,Showa,60,177689,87585,90104
26 ,Kyoto,35_ 39,1985,Showa,60,234636,115800,118836
26 ,Kyoto,40_ 44,1985,Showa,60,197094,97253,99841
26 ,Kyoto,45_ 49,1985,Showa,60,169284,83890,85394
26 ,Kyoto,50_ 54,1985,Showa,60,162308,80392,81916
26 ,Kyoto,55_ 59,1985,Showa,60,142312,68800,73512
26 ,Kyoto,60_ 64,1985,Showa,60,109864,46037,63827
26 ,Kyoto,65_ 69,1985,Showa,60,89986,35929,54057
26 ,Kyoto,70_ 74,1985,Showa,60,83364,33974,49390
26 ,Kyoto,75_ 79,1985,Showa,60,62219,25753,36466
26 ,Kyoto,80_ 84,1985,Showa,60,35171,13415,21756
26 ,Kyoto,over_85,1985,Showa,60,18889,6221,12668
26 ,Kyoto,total,1990,Heisei,2,2602460,1267620,1334840
26 ,Kyoto,0_ 4,1990,Heisei,2,128611,66059,62552
26 ,Kyoto,5_ 9,1990,Heisei,2,147448,75995,71453
26 ,Kyoto,10_ 14,1990,Heisei,2,172841,88803,84038
26 ,Kyoto,15_ 19,1990,Heisei,2,227490,116839,110651
26 ,Kyoto,20_ 24,1990,Heisei,2,220611,116146,104465
26 ,Kyoto,25_ 29,1990,Heisei,2,165248,81879,83369
26 ,Kyoto,30_ 34,1990,Heisei,2,149329,73939,75390
26 ,Kyoto,35_ 39,1990,Heisei,2,171706,84073,87633
26 ,Kyoto,40_ 44,1990,Heisei,2,228773,112249,116524
26 ,Kyoto,45_ 49,1990,Heisei,2,193419,94738,98681
26 ,Kyoto,50_ 54,1990,Heisei,2,165503,81413,84090
26 ,Kyoto,55_ 59,1990,Heisei,2,157260,77231,80029
26 ,Kyoto,60_ 64,1990,Heisei,2,136676,65082,71594
26 ,Kyoto,65_ 69,1990,Heisei,2,103262,42361,60901
26 ,Kyoto,70_ 74,1990,Heisei,2,81770,31406,50364
26 ,Kyoto,75_ 79,1990,Heisei,2,70160,26843,43317
26 ,Kyoto,80_ 84,1990,Heisei,2,45521,17204,28317
26 ,Kyoto,over_85,1990,Heisei,2,26716,8645,18071
26 ,Kyoto,total,1995,Heisei,7,2629592,1276838,1352754
26 ,Kyoto,0_ 4,1995,Heisei,7,116644,59616,57028
26 ,Kyoto,5_ 9,1995,Heisei,7,127547,65591,61956
26 ,Kyoto,10_ 14,1995,Heisei,7,145947,75297,70650
26 ,Kyoto,15_ 19,1995,Heisei,7,190872,97739,93133
26 ,Kyoto,20_ 24,1995,Heisei,7,252615,132134,120481
26 ,Kyoto,25_ 29,1995,Heisei,7,184673,91856,92817
26 ,Kyoto,30_ 34,1995,Heisei,7,161736,79952,81784
26 ,Kyoto,35_ 39,1995,Heisei,7,147220,72931,74289
26 ,Kyoto,40_ 44,1995,Heisei,7,170224,83142,87082
26 ,Kyoto,45_ 49,1995,Heisei,7,228201,111520,116681
26 ,Kyoto,50_ 54,1995,Heisei,7,191571,93650,97921
26 ,Kyoto,55_ 59,1995,Heisei,7,162962,79675,83287
26 ,Kyoto,60_ 64,1995,Heisei,7,152393,73887,78506
26 ,Kyoto,65_ 69,1995,Heisei,7,129314,60413,68901
26 ,Kyoto,70_ 74,1995,Heisei,7,95107,37473,57634
26 ,Kyoto,75_ 79,1995,Heisei,7,70618,25368,45250
26 ,Kyoto,80_ 84,1995,Heisei,7,53441,18512,34929
26 ,Kyoto,over_85,1995,Heisei,7,38496,12028,26468
26 ,Kyoto,total,2000,Heisei,12,2644391,1278142,1366249
26 ,Kyoto,0_ 4,2000,Heisei,12,117945,60248,57697
26 ,Kyoto,5_ 9,2000,Heisei,12,116313,59328,56985
26 ,Kyoto,10_ 14,2000,Heisei,12,126273,64948,61325
26 ,Kyoto,15_ 19,2000,Heisei,12,162950,83189,79761
26 ,Kyoto,20_ 24,2000,Heisei,12,213800,110469,103331
26 ,Kyoto,25_ 29,2000,Heisei,12,210796,104834,105962
26 ,Kyoto,30_ 34,2000,Heisei,12,178412,88510,89902
26 ,Kyoto,35_ 39,2000,Heisei,12,158576,77969,80607
26 ,Kyoto,40_ 44,2000,Heisei,12,145369,71691,73678
26 ,Kyoto,45_ 49,2000,Heisei,12,168558,81861,86697
26 ,Kyoto,50_ 54,2000,Heisei,12,224944,109289,115655
26 ,Kyoto,55_ 59,2000,Heisei,12,188003,91267,96736
26 ,Kyoto,60_ 64,2000,Heisei,12,158825,76806,82019
26 ,Kyoto,65_ 69,2000,Heisei,12,145382,69091,76291
26 ,Kyoto,70_ 74,2000,Heisei,12,119689,54164,65525
26 ,Kyoto,75_ 79,2000,Heisei,12,84971,31941,53030
26 ,Kyoto,80_ 84,2000,Heisei,12,56495,18579,37916
26 ,Kyoto,over_85,2000,Heisei,12,52736,15215,37521
26 ,Kyoto,total,2005,Heisei,17,2647660,1272993,1374667
26 ,Kyoto,0_ 4,2005,Heisei,17,111514,56870,54644
26 ,Kyoto,5_ 9,2005,Heisei,17,118128,60415,57713
26 ,Kyoto,10_ 14,2005,Heisei,17,115429,58941,56488
26 ,Kyoto,15_ 19,2005,Heisei,17,143798,73855,69943
26 ,Kyoto,20_ 24,2005,Heisei,17,187179,95743,91436
26 ,Kyoto,25_ 29,2005,Heisei,17,175907,87319,88588
26 ,Kyoto,30_ 34,2005,Heisei,17,202301,100071,102230
26 ,Kyoto,35_ 39,2005,Heisei,17,174667,86329,88338
26 ,Kyoto,40_ 44,2005,Heisei,17,156900,76764,80136
26 ,Kyoto,45_ 49,2005,Heisei,17,143804,70408,73396
26 ,Kyoto,50_ 54,2005,Heisei,17,166162,80121,86041
26 ,Kyoto,55_ 59,2005,Heisei,17,220675,106254,114421
26 ,Kyoto,60_ 64,2005,Heisei,17,184054,88562,95492
26 ,Kyoto,65_ 69,2005,Heisei,17,152537,72674,79863
26 ,Kyoto,70_ 74,2005,Heisei,17,135780,62593,73187
26 ,Kyoto,75_ 79,2005,Heisei,17,106828,45764,61064
26 ,Kyoto,80_ 84,2005,Heisei,17,69909,24061,45848
26 ,Kyoto,over_85,2005,Heisei,17,65296,16880,48416
26 ,Kyoto,total,2010,Heisei,22,2636092,1265387,1370705
26 ,Kyoto,0_ 4,2010,Heisei,22,105562,54067,51495
26 ,Kyoto,5_ 9,2010,Heisei,22,111333,56823,54510
26 ,Kyoto,10_ 14,2010,Heisei,22,117549,60034,57515
26 ,Kyoto,15_ 19,2010,Heisei,22,130780,66839,63941
26 ,Kyoto,20_ 24,2010,Heisei,22,158153,80854,77299
26 ,Kyoto,25_ 29,2010,Heisei,22,148125,72896,75229
26 ,Kyoto,30_ 34,2010,Heisei,22,166881,82568,84313
26 ,Kyoto,35_ 39,2010,Heisei,22,198650,98234,100416
26 ,Kyoto,40_ 44,2010,Heisei,22,172942,85158,87784
26 ,Kyoto,45_ 49,2010,Heisei,22,156165,76198,79967
26 ,Kyoto,50_ 54,2010,Heisei,22,142366,69544,72822
26 ,Kyoto,55_ 59,2010,Heisei,22,163431,78224,85207
26 ,Kyoto,60_ 64,2010,Heisei,22,216319,103225,113094
26 ,Kyoto,65_ 69,2010,Heisei,22,176653,83731,92922
26 ,Kyoto,70_ 74,2010,Heisei,22,142861,66115,76746
26 ,Kyoto,75_ 79,2010,Heisei,22,120796,52979,67817
26 ,Kyoto,80_ 84,2010,Heisei,22,87049,34059,52990
26 ,Kyoto,over_85,2010,Heisei,22,78350,20354,57996
26 ,Kyoto,total,2015,Heisei,27,2610353,1248972,1361381
26 ,Kyoto,0_ 4,2015,Heisei,27,97280,49926,47354
26 ,Kyoto,5_ 9,2015,Heisei,27,105169,54001,51168
26 ,Kyoto,10_ 14,2015,Heisei,27,111417,56853,54564
26 ,Kyoto,15_ 19,2015,Heisei,27,131235,66973,64262
26 ,Kyoto,20_ 24,2015,Heisei,27,147511,75026,72485
26 ,Kyoto,25_ 29,2015,Heisei,27,131935,65446,66489
26 ,Kyoto,30_ 34,2015,Heisei,27,140899,68779,72120
26 ,Kyoto,35_ 39,2015,Heisei,27,163859,80786,83073
26 ,Kyoto,40_ 44,2015,Heisei,27,196711,96717,99994
26 ,Kyoto,45_ 49,2015,Heisei,27,172296,84496,87800
26 ,Kyoto,50_ 54,2015,Heisei,27,154842,75265,79577
26 ,Kyoto,55_ 59,2015,Heisei,27,140488,68230,72258
26 ,Kyoto,60_ 64,2015,Heisei,27,159764,75795,83969
26 ,Kyoto,65_ 69,2015,Heisei,27,207567,97506,110061
26 ,Kyoto,70_ 74,2015,Heisei,27,166300,76712,89588
26 ,Kyoto,75_ 79,2015,Heisei,27,128812,57399,71413
26 ,Kyoto,80_ 84,2015,Heisei,27,101223,41254,59969
26 ,Kyoto,over_85,2015,Heisei,27,99517,29416,70101
27 ,Osaka,total,1920,Taisho,9,2587847,1344846,1243001
27 ,Osaka,0_ 4,1920,Taisho,9,282488,142632,139856
27 ,Osaka,5_ 9,1920,Taisho,9,267779,136166,131613
27 ,Osaka,10_ 14,1920,Taisho,9,271550,140142,131408
27 ,Osaka,15_ 19,1920,Taisho,9,311698,168448,143250
27 ,Osaka,20_ 24,1920,Taisho,9,272451,141578,130873
27 ,Osaka,25_ 29,1920,Taisho,9,225157,123378,101779
27 ,Osaka,30_ 34,1920,Taisho,9,194116,106503,87613
27 ,Osaka,35_ 39,1920,Taisho,9,176356,94446,81910
27 ,Osaka,40_ 44,1920,Taisho,9,155971,83230,72741
27 ,Osaka,45_ 49,1920,Taisho,9,120958,64158,56800
27 ,Osaka,50_ 54,1920,Taisho,9,93473,48262,45211
27 ,Osaka,55_ 59,1920,Taisho,9,69951,34693,35258
27 ,Osaka,60_ 64,1920,Taisho,9,58905,27360,31545
27 ,Osaka,65_ 69,1920,Taisho,9,42744,18359,24385
27 ,Osaka,70_ 74,1920,Taisho,9,26222,9968,16254
27 ,Osaka,75_ 79,1920,Taisho,9,12406,4063,8343
27 ,Osaka,over_80,1920,Taisho,9,5622,1460,4162
27 ,Osaka,total,1925,Taisho,14,3059502,1594227,1465275
27 ,Osaka,0_ 4,1925,Taisho,14,357766,181449,176317
27 ,Osaka,5_ 9,1925,Taisho,14,273059,138656,134403
27 ,Osaka,10_ 14,1925,Taisho,14,310262,158655,151607
27 ,Osaka,15_ 19,1925,Taisho,14,392269,209363,182906
27 ,Osaka,20_ 24,1925,Taisho,14,344613,180851,163762
27 ,Osaka,25_ 29,1925,Taisho,14,293273,159523,133750
27 ,Osaka,30_ 34,1925,Taisho,14,224852,125114,99738
27 ,Osaka,35_ 39,1925,Taisho,14,192205,106430,85775
27 ,Osaka,40_ 44,1925,Taisho,14,169373,91005,78368
27 ,Osaka,45_ 49,1925,Taisho,14,149707,78748,70959
27 ,Osaka,50_ 54,1925,Taisho,14,112330,58059,54271
27 ,Osaka,55_ 59,1925,Taisho,14,83837,41343,42494
27 ,Osaka,60_ 64,1925,Taisho,14,59069,27606,31463
27 ,Osaka,65_ 69,1925,Taisho,14,45170,19468,25702
27 ,Osaka,70_ 74,1925,Taisho,14,29577,11275,18302
27 ,Osaka,75_ 79,1925,Taisho,14,15052,4856,10196
27 ,Osaka,80_ 84,1925,Taisho,14,5419,1459,3960
27 ,Osaka,over_85,1925,Taisho,14,1669,367,1302
27 ,Osaka,total,1930,Showa,5,3540017,1845786,1694231
27 ,Osaka,0_ 4,1930,Showa,5,441701,223177,218524
27 ,Osaka,5_ 9,1930,Showa,5,341512,173543,167969
27 ,Osaka,10_ 14,1930,Showa,5,302670,156962,145708
27 ,Osaka,15_ 19,1930,Showa,5,438424,234566,203858
27 ,Osaka,20_ 24,1930,Showa,5,402576,210961,191615
27 ,Osaka,25_ 29,1930,Showa,5,348089,187506,160583
27 ,Osaka,30_ 34,1930,Showa,5,284634,155964,128670
27 ,Osaka,35_ 39,1930,Showa,5,218579,121196,97383
27 ,Osaka,40_ 44,1930,Showa,5,183859,101368,82491
27 ,Osaka,45_ 49,1930,Showa,5,160525,85022,75503
27 ,Osaka,50_ 54,1930,Showa,5,138643,71169,67474
27 ,Osaka,55_ 59,1930,Showa,5,101689,50332,51357
27 ,Osaka,60_ 64,1930,Showa,5,72143,33428,38715
27 ,Osaka,65_ 69,1930,Showa,5,46848,20223,26625
27 ,Osaka,70_ 74,1930,Showa,5,31873,12337,19536
27 ,Osaka,75_ 79,1930,Showa,5,17196,5802,11394
27 ,Osaka,over_80,1930,Showa,5,9056,2230,6826
27 ,Osaka,total,1935,Showa,10,4297174,2241666,2055508
27 ,Osaka,0_ 4,1935,Showa,10,511254,258859,252395
27 ,Osaka,5_ 9,1935,Showa,10,433723,219152,214571
27 ,Osaka,10_ 14,1935,Showa,10,394248,201807,192441
27 ,Osaka,15_ 19,1935,Showa,10,512526,273919,238607
27 ,Osaka,20_ 24,1935,Showa,10,506619,266125,240494
27 ,Osaka,25_ 29,1935,Showa,10,429638,233379,196259
27 ,Osaka,30_ 34,1935,Showa,10,347934,189285,158649
27 ,Osaka,35_ 39,1935,Showa,10,282484,155857,126627
27 ,Osaka,40_ 44,1935,Showa,10,211455,117539,93916
27 ,Osaka,45_ 49,1935,Showa,10,177503,96643,80860
27 ,Osaka,50_ 54,1935,Showa,10,151551,77978,73573
27 ,Osaka,55_ 59,1935,Showa,10,127125,62270,64855
27 ,Osaka,60_ 64,1935,Showa,10,89300,41663,47637
27 ,Osaka,65_ 69,1935,Showa,10,58125,24800,33325
27 ,Osaka,70_ 74,1935,Showa,10,34065,13166,20899
27 ,Osaka,75_ 79,1935,Showa,10,18870,6355,12515
27 ,Osaka,over_80,1935,Showa,10,10754,2869,7885
27 ,Osaka,total,1940,Showa,15,4790024,2458223,2331801
27 ,Osaka,0_ 4,1940,Showa,15,553828,280577,273251
27 ,Osaka,5_ 9,1940,Showa,15,491910,249294,242616
27 ,Osaka,10_ 14,1940,Showa,15,466209,237920,228289
27 ,Osaka,15_ 19,1940,Showa,15,569627,302526,267101
27 ,Osaka,20_ 24,1940,Showa,15,471582,225438,246144
27 ,Osaka,25_ 29,1940,Showa,15,481629,250819,230810
27 ,Osaka,30_ 34,1940,Showa,15,406114,218401,187713
27 ,Osaka,35_ 39,1940,Showa,15,332380,179167,153213
27 ,Osaka,40_ 44,1940,Showa,15,265806,144962,120844
27 ,Osaka,45_ 49,1940,Showa,15,198841,108738,90103
27 ,Osaka,50_ 54,1940,Showa,15,163006,86430,76576
27 ,Osaka,55_ 59,1940,Showa,15,136141,67243,68898
27 ,Osaka,60_ 64,1940,Showa,15,109415,50675,58740
27 ,Osaka,65_ 69,1940,Showa,15,70954,30564,40390
27 ,Osaka,70_ 74,1940,Showa,15,41169,15742,25427
27 ,Osaka,75_ 79,1940,Showa,15,19758,6648,13110
27 ,Osaka,80_ 84,1940,Showa,15,8343,2338,6005
27 ,Osaka,over_85,1940,Showa,15,3267,722,2545
27 ,Osaka,total,1945,Showa,20,2800958,1353776,1447182
27 ,Osaka,1_ 5,1945,Showa,20,310627,157178,153449
27 ,Osaka,6_ 10,1945,Showa,20,273667,138741,134926
27 ,Osaka,11_ 15,1945,Showa,20,299864,152923,146941
27 ,Osaka,16_ 20,1945,Showa,20,313700,159109,154591
27 ,Osaka,21_ 25,1945,Showa,20,225470,88116,137354
27 ,Osaka,26_ 30,1945,Showa,20,187962,72913,115049
27 ,Osaka,31_ 35,1945,Showa,20,201380,87036,114344
27 ,Osaka,36_ 40,1945,Showa,20,206905,99679,107226
27 ,Osaka,41_ 45,1945,Showa,20,200034,105330,94704
27 ,Osaka,46_ 50,1945,Showa,20,171477,92196,79281
27 ,Osaka,51_ 55,1945,Showa,20,127971,69414,58557
27 ,Osaka,56_ 60,1945,Showa,20,101797,53480,48317
27 ,Osaka,61_ 65,1945,Showa,20,75747,36183,39564
27 ,Osaka,66_ 70,1945,Showa,20,53881,23373,30508
27 ,Osaka,71_ 75,1945,Showa,20,31052,12089,18963
27 ,Osaka,76_ 80,1945,Showa,20,13163,4374,8789
27 ,Osaka,81_ 85,1945,Showa,20,4938,1340,3598
27 ,Osaka,86以上,1945,Showa,20,1323,302,1021
27 ,Osaka,total,1950,Showa,25,3857047,1899745,1957302
27 ,Osaka,0_ 4,1950,Showa,25,489422,250597,238825
27 ,Osaka,5_ 9,1950,Showa,25,406401,205780,200621
27 ,Osaka,10_ 14,1950,Showa,25,345155,174666,170489
27 ,Osaka,15_ 19,1950,Showa,25,399151,200764,198387
27 ,Osaka,20_ 24,1950,Showa,25,388567,195489,193078
27 ,Osaka,25_ 29,1950,Showa,25,312747,143423,169324
27 ,Osaka,30_ 34,1950,Showa,25,265869,120444,145425
27 ,Osaka,35_ 39,1950,Showa,25,267661,127430,140231
27 ,Osaka,40_ 44,1950,Showa,25,239871,119082,120789
27 ,Osaka,45_ 49,1950,Showa,25,210250,107637,102613
27 ,Osaka,50_ 54,1950,Showa,25,169445,88104,81341
27 ,Osaka,55_ 59,1950,Showa,25,124534,63950,60584
27 ,Osaka,60_ 64,1950,Showa,25,94601,46095,48506
27 ,Osaka,65_ 69,1950,Showa,25,67278,29218,38060
27 ,Osaka,70_ 74,1950,Showa,25,44616,17160,27456
27 ,Osaka,75_ 79,1950,Showa,25,21753,7315,14438
27 ,Osaka,over_80,1950,Showa,25,9502,2474,7028
27 ,Osaka,total,1955,Showa,30,4618308,2290170,2328138
27 ,Osaka,0_ 4,1955,Showa,30,416076,213220,202856
27 ,Osaka,5_ 9,1955,Showa,30,520836,266918,253918
27 ,Osaka,10_ 14,1955,Showa,30,439399,222410,216989
27 ,Osaka,15_ 19,1955,Showa,30,479112,249617,229495
27 ,Osaka,20_ 24,1955,Showa,30,502998,259987,243011
27 ,Osaka,25_ 29,1955,Showa,30,433616,216404,217212
27 ,Osaka,30_ 34,1955,Showa,30,336264,154043,182221
27 ,Osaka,35_ 39,1955,Showa,30,280402,126600,153802
27 ,Osaka,40_ 44,1955,Showa,30,279561,132506,147055
27 ,Osaka,45_ 49,1955,Showa,30,247152,121709,125443
27 ,Osaka,50_ 54,1955,Showa,30,211434,106767,104667
27 ,Osaka,55_ 59,1955,Showa,30,166603,84753,81850
27 ,Osaka,60_ 64,1955,Showa,30,116972,58133,58839
27 ,Osaka,65_ 69,1955,Showa,30,83577,38844,44733
27 ,Osaka,70_ 74,1955,Showa,30,55914,22497,33417
27 ,Osaka,75_ 79,1955,Showa,30,31936,11244,20692
27 ,Osaka,80_ 84,1955,Showa,30,12617,3647,8970
27 ,Osaka,over_85,1955,Showa,30,3785,848,2937
27 ,Osaka,total,1960,Showa,35,5504746,2766229,2738517
27 ,Osaka,0_ 4,1960,Showa,35,427407,219761,207646
27 ,Osaka,5_ 9,1960,Showa,35,436500,223645,212855
27 ,Osaka,10_ 14,1960,Showa,35,544844,278987,265857
27 ,Osaka,15_ 19,1960,Showa,35,668997,358004,310993
27 ,Osaka,20_ 24,1960,Showa,35,626626,332599,294027
27 ,Osaka,25_ 29,1960,Showa,35,568320,292203,276117
27 ,Osaka,30_ 34,1960,Showa,35,465914,235639,230275
27 ,Osaka,35_ 39,1960,Showa,35,350771,162260,188511
27 ,Osaka,40_ 44,1960,Showa,35,287408,130146,157262
27 ,Osaka,45_ 49,1960,Showa,35,283613,133705,149908
27 ,Osaka,50_ 54,1960,Showa,35,247205,120443,126762
27 ,Osaka,55_ 59,1960,Showa,35,206650,102390,104260
27 ,Osaka,60_ 64,1960,Showa,35,156333,76837,79496
27 ,Osaka,65_ 69,1960,Showa,35,103467,49033,54434
27 ,Osaka,70_ 74,1960,Showa,35,67816,29479,38337
27 ,Osaka,75_ 79,1960,Showa,35,39054,14311,24743
27 ,Osaka,80_ 84,1960,Showa,35,17629,5301,12328
27 ,Osaka,over_85,1960,Showa,35,6192,1486,4706
27 ,Osaka,total,1965,Showa,40,6657189,3355699,3301490
27 ,Osaka,0_ 4,1965,Showa,40,605959,309711,296248
27 ,Osaka,5_ 9,1965,Showa,40,456169,233318,222851
27 ,Osaka,10_ 14,1965,Showa,40,464695,237083,227612
27 ,Osaka,15_ 19,1965,Showa,40,783050,412487,370563
27 ,Osaka,20_ 24,1965,Showa,40,819937,433866,386071
27 ,Osaka,25_ 29,1965,Showa,40,715236,369733,345503
27 ,Osaka,30_ 34,1965,Showa,40,621267,321409,299858
27 ,Osaka,35_ 39,1965,Showa,40,496060,253125,242935
27 ,Osaka,40_ 44,1965,Showa,40,366645,171033,195612
27 ,Osaka,45_ 49,1965,Showa,40,296972,134700,162272
27 ,Osaka,50_ 54,1965,Showa,40,287155,134309,152846
27 ,Osaka,55_ 59,1965,Showa,40,245509,118289,127220
27 ,Osaka,60_ 64,1965,Showa,40,195015,94184,100831
27 ,Osaka,65_ 69,1965,Showa,40,139021,65954,73067
27 ,Osaka,70_ 74,1965,Showa,40,85009,37928,47081
27 ,Osaka,75_ 79,1965,Showa,40,48249,19156,29093
27 ,Osaka,80_ 84,1965,Showa,40,21951,7079,14872
27 ,Osaka,over_85,1965,Showa,40,9290,2335,6955
27 ,Osaka,total,1970,Showa,45,7620480,3823622,3796858
27 ,Osaka,0_ 4,1970,Showa,45,749327,384667,364660
27 ,Osaka,5_ 9,1970,Showa,45,606301,309955,296346
27 ,Osaka,10_ 14,1970,Showa,45,464955,238075,226880
27 ,Osaka,15_ 19,1970,Showa,45,624845,321774,303071
27 ,Osaka,20_ 24,1970,Showa,45,930192,483963,446229
27 ,Osaka,25_ 29,1970,Showa,45,839533,425678,413855
27 ,Osaka,30_ 34,1970,Showa,45,716965,369199,347766
27 ,Osaka,35_ 39,1970,Showa,45,622731,322408,300323
27 ,Osaka,40_ 44,1970,Showa,45,494544,252952,241592
27 ,Osaka,45_ 49,1970,Showa,45,370160,172401,197759
27 ,Osaka,50_ 54,1970,Showa,45,297478,133713,163765
27 ,Osaka,55_ 59,1970,Showa,45,278668,128755,149913
27 ,Osaka,60_ 64,1970,Showa,45,230976,108265,122711
27 ,Osaka,65_ 69,1970,Showa,45,175071,81405,93666
27 ,Osaka,70_ 74,1970,Showa,45,115835,51604,64231
27 ,Osaka,75_ 79,1970,Showa,45,62121,25452,36669
27 ,Osaka,80_ 84,1970,Showa,45,28639,10098,18541
27 ,Osaka,over_85,1970,Showa,45,12139,3258,8881
27 ,Osaka,total,1975,Showa,50,8278925,4132495,4146430
27 ,Osaka,0_ 4,1975,Showa,50,816605,419641,396964
27 ,Osaka,5_ 9,1975,Showa,50,712893,366220,346673
27 ,Osaka,10_ 14,1975,Showa,50,591494,302867,288627
27 ,Osaka,15_ 19,1975,Showa,50,541796,277083,264713
27 ,Osaka,20_ 24,1975,Showa,50,716864,368807,348057
27 ,Osaka,25_ 29,1975,Showa,50,904521,455546,448975
27 ,Osaka,30_ 34,1975,Showa,50,805152,405726,399426
27 ,Osaka,35_ 39,1975,Showa,50,687095,351808,335287
27 ,Osaka,40_ 44,1975,Showa,50,603990,311031,292959
27 ,Osaka,45_ 49,1975,Showa,50,486015,246077,239938
27 ,Osaka,50_ 54,1975,Showa,50,358841,165364,193477
27 ,Osaka,55_ 59,1975,Showa,50,284022,125374,158648
27 ,Osaka,60_ 64,1975,Showa,50,264215,118414,145801
27 ,Osaka,65_ 69,1975,Showa,50,210177,94722,115455
27 ,Osaka,70_ 74,1975,Showa,50,147704,65143,82561
27 ,Osaka,75_ 79,1975,Showa,50,87399,36099,51300
27 ,Osaka,80_ 84,1975,Showa,50,38874,14439,24435
27 ,Osaka,over_85,1975,Showa,50,16520,4921,11599
27 ,Osaka,total,1980,Showa,55,8473446,4203838,4269608
27 ,Osaka,0_ 4,1980,Showa,55,612532,313948,298584
27 ,Osaka,5_ 9,1980,Showa,55,767953,394740,373213
27 ,Osaka,10_ 14,1980,Showa,55,687098,353344,333754
27 ,Osaka,15_ 19,1980,Showa,55,626590,318932,307658
27 ,Osaka,20_ 24,1980,Showa,55,591162,301084,290078
27 ,Osaka,25_ 29,1980,Showa,55,657664,329831,327833
27 ,Osaka,30_ 34,1980,Showa,55,842621,419379,423242
27 ,Osaka,35_ 39,1980,Showa,55,758966,379553,379413
27 ,Osaka,40_ 44,1980,Showa,55,655668,332551,323117
27 ,Osaka,45_ 49,1980,Showa,55,581486,296694,284792
27 ,Osaka,50_ 54,1980,Showa,55,464899,233335,231564
27 ,Osaka,55_ 59,1980,Showa,55,339719,154123,185596
27 ,Osaka,60_ 64,1980,Showa,55,264525,113838,150687
27 ,Osaka,65_ 69,1980,Showa,55,239091,103381,135710
27 ,Osaka,70_ 74,1980,Showa,55,179954,77151,102803
27 ,Osaka,75_ 79,1980,Showa,55,113905,46812,67093
27 ,Osaka,80_ 84,1980,Showa,55,56561,21233,35328
27 ,Osaka,over_85,1980,Showa,55,23850,7583,16267
27 ,Osaka,total,1985,Showa,60,8668095,4286445,4381650
27 ,Osaka,0_ 4,1985,Showa,60,517246,265482,251764
27 ,Osaka,5_ 9,1985,Showa,60,586591,300495,286096
27 ,Osaka,10_ 14,1985,Showa,60,746342,383777,362565
27 ,Osaka,15_ 19,1985,Showa,60,714442,366474,347968
27 ,Osaka,20_ 24,1985,Showa,60,675317,343536,331781
27 ,Osaka,25_ 29,1985,Showa,60,557370,280740,276630
27 ,Osaka,30_ 34,1985,Showa,60,632412,315846,316566
27 ,Osaka,35_ 39,1985,Showa,60,810454,402338,408116
27 ,Osaka,40_ 44,1985,Showa,60,736937,366528,370409
27 ,Osaka,45_ 49,1985,Showa,60,640662,323228,317434
27 ,Osaka,50_ 54,1985,Showa,60,562935,285086,277849
27 ,Osaka,55_ 59,1985,Showa,60,443333,219627,223706
27 ,Osaka,60_ 64,1985,Showa,60,319875,142082,177793
27 ,Osaka,65_ 69,1985,Showa,60,243872,101065,142807
27 ,Osaka,70_ 74,1985,Showa,60,210795,86389,124406
27 ,Osaka,75_ 79,1985,Showa,60,145754,57878,87876
27 ,Osaka,80_ 84,1985,Showa,60,78060,28739,49321
27 ,Osaka,over_85,1985,Showa,60,38098,12158,25940
27 ,Osaka,total,1990,Heisei,2,8734516,4308184,4426332
27 ,Osaka,0_ 4,1990,Heisei,2,446891,228619,218272
27 ,Osaka,5_ 9,1990,Heisei,2,489671,251120,238551
27 ,Osaka,10_ 14,1990,Heisei,2,567323,290468,276855
27 ,Osaka,15_ 19,1990,Heisei,2,770234,395350,374884
27 ,Osaka,20_ 24,1990,Heisei,2,744670,376433,368237
27 ,Osaka,25_ 29,1990,Heisei,2,625121,313531,311590
27 ,Osaka,30_ 34,1990,Heisei,2,526346,264179,262167
27 ,Osaka,35_ 39,1990,Heisei,2,601695,299300,302395
27 ,Osaka,40_ 44,1990,Heisei,2,785335,388393,396942
27 ,Osaka,45_ 49,1990,Heisei,2,719935,357094,362841
27 ,Osaka,50_ 54,1990,Heisei,2,622533,312874,309659
27 ,Osaka,55_ 59,1990,Heisei,2,537337,269601,267736
27 ,Osaka,60_ 64,1990,Heisei,2,414319,201657,212662
27 ,Osaka,65_ 69,1990,Heisei,2,293326,126226,167100
27 ,Osaka,70_ 74,1990,Heisei,2,215705,85216,130489
27 ,Osaka,75_ 79,1990,Heisei,2,173578,66401,107177
27 ,Osaka,80_ 84,1990,Heisei,2,103459,36978,66481
27 ,Osaka,over_85,1990,Heisei,2,56956,17567,39389
27 ,Osaka,total,1995,Heisei,7,8797268,4321575,4475693
27 ,Osaka,0_ 4,1995,Heisei,7,419591,214738,204853
27 ,Osaka,5_ 9,1995,Heisei,7,427651,218834,208817
27 ,Osaka,10_ 14,1995,Heisei,7,474233,243115,231118
27 ,Osaka,15_ 19,1995,Heisei,7,597675,305000,292675
27 ,Osaka,20_ 24,1995,Heisei,7,816185,413296,402889
27 ,Osaka,25_ 29,1995,Heisei,7,712356,356845,355511
27 ,Osaka,30_ 34,1995,Heisei,7,598521,300897,297624
27 ,Osaka,35_ 39,1995,Heisei,7,504836,253157,251679
27 ,Osaka,40_ 44,1995,Heisei,7,585736,290251,295485
27 ,Osaka,45_ 49,1995,Heisei,7,773987,382092,391895
27 ,Osaka,50_ 54,1995,Heisei,7,706069,349503,356566
27 ,Osaka,55_ 59,1995,Heisei,7,606107,303512,302595
27 ,Osaka,60_ 64,1995,Heisei,7,510473,251963,258510
27 ,Osaka,65_ 69,1995,Heisei,7,386574,183028,203546
27 ,Osaka,70_ 74,1995,Heisei,7,265189,109079,156110
27 ,Osaka,75_ 79,1995,Heisei,7,182675,67094,115581
27 ,Osaka,80_ 84,1995,Heisei,7,129181,44038,85143
27 ,Osaka,over_85,1995,Heisei,7,84256,24338,59918
27 ,Osaka,total,2000,Heisei,12,8805081,4304059,4501022
27 ,Osaka,0_ 4,2000,Heisei,12,428610,219218,209392
27 ,Osaka,5_ 9,2000,Heisei,12,404083,206796,197287
27 ,Osaka,10_ 14,2000,Heisei,12,417262,213553,203709
27 ,Osaka,15_ 19,2000,Heisei,12,501106,255411,245695
27 ,Osaka,20_ 24,2000,Heisei,12,639816,323216,316600
27 ,Osaka,25_ 29,2000,Heisei,12,767702,382790,384912
27 ,Osaka,30_ 34,2000,Heisei,12,677012,337565,339447
27 ,Osaka,35_ 39,2000,Heisei,12,574151,287017,287134
27 ,Osaka,40_ 44,2000,Heisei,12,490096,244256,245840
27 ,Osaka,45_ 49,2000,Heisei,12,571587,281958,289629
27 ,Osaka,50_ 54,2000,Heisei,12,749718,368143,381575
27 ,Osaka,55_ 59,2000,Heisei,12,678053,332823,345230
27 ,Osaka,60_ 64,2000,Heisei,12,574945,283515,291430
27 ,Osaka,65_ 69,2000,Heisei,12,474898,229037,245861
27 ,Osaka,70_ 74,2000,Heisei,12,347748,158395,189353
27 ,Osaka,75_ 79,2000,Heisei,12,229384,89210,140174
27 ,Osaka,80_ 84,2000,Heisei,12,142058,47334,94724
27 ,Osaka,over_85,2000,Heisei,12,121125,33526,87599
27 ,Osaka,total,2005,Heisei,17,8817166,4280622,4536544
27 ,Osaka,0_ 4,2005,Heisei,17,394679,202125,192554
27 ,Osaka,5_ 9,2005,Heisei,17,418247,214319,203928
27 ,Osaka,10_ 14,2005,Heisei,17,398331,204021,194310
27 ,Osaka,15_ 19,2005,Heisei,17,438173,223237,214936
27 ,Osaka,20_ 24,2005,Heisei,17,532331,268066,264265
27 ,Osaka,25_ 29,2005,Heisei,17,590338,290009,300329
27 ,Osaka,30_ 34,2005,Heisei,17,730881,360766,370115
27 ,Osaka,35_ 39,2005,Heisei,17,649803,321513,328290
27 ,Osaka,40_ 44,2005,Heisei,17,557837,276343,281494
27 ,Osaka,45_ 49,2005,Heisei,17,478932,236715,242217
27 ,Osaka,50_ 54,2005,Heisei,17,556546,272338,284208
27 ,Osaka,55_ 59,2005,Heisei,17,726275,353921,372354
27 ,Osaka,60_ 64,2005,Heisei,17,652442,316380,336062
27 ,Osaka,65_ 69,2005,Heisei,17,546547,265095,281452
27 ,Osaka,70_ 74,2005,Heisei,17,437785,204092,233693
27 ,Osaka,75_ 79,2005,Heisei,17,306063,131775,174288
27 ,Osaka,80_ 84,2005,Heisei,17,185971,66048,119923
27 ,Osaka,over_85,2005,Heisei,17,157852,40641,117211
27 ,Osaka,total,2010,Heisei,22,8865245,4285566,4579679
27 ,Osaka,0_ 4,2010,Heisei,22,364903,186340,178563
27 ,Osaka,5_ 9,2010,Heisei,22,386363,197845,188518
27 ,Osaka,10_ 14,2010,Heisei,22,413934,211819,202115
27 ,Osaka,15_ 19,2010,Heisei,22,416930,212903,204027
27 ,Osaka,20_ 24,2010,Heisei,22,469906,235054,234852
27 ,Osaka,25_ 29,2010,Heisei,22,517377,254579,262798
27 ,Osaka,30_ 34,2010,Heisei,22,583863,286712,297151
27 ,Osaka,35_ 39,2010,Heisei,22,723186,357817,365369
27 ,Osaka,40_ 44,2010,Heisei,22,648690,321068,327622
27 ,Osaka,45_ 49,2010,Heisei,22,556064,275299,280765
27 ,Osaka,50_ 54,2010,Heisei,22,475890,234201,241689
27 ,Osaka,55_ 59,2010,Heisei,22,549216,267894,281322
27 ,Osaka,60_ 64,2010,Heisei,22,706948,341809,365139
27 ,Osaka,65_ 69,2010,Heisei,22,622138,295817,326321
27 ,Osaka,70_ 74,2010,Heisei,22,507503,238157,269346
27 ,Osaka,75_ 79,2010,Heisei,22,384569,169549,215020
27 ,Osaka,80_ 84,2010,Heisei,22,246060,95560,150500
27 ,Osaka,over_85,2010,Heisei,22,202478,53024,149454
27 ,Osaka,total,2015,Heisei,27,8839469,4256049,4583420
27 ,Osaka,0_ 4,2015,Heisei,27,342645,174506,168139
27 ,Osaka,5_ 9,2015,Heisei,27,361836,185319,176517
27 ,Osaka,10_ 14,2015,Heisei,27,388630,199029,189601
27 ,Osaka,15_ 19,2015,Heisei,27,432442,220305,212137
27 ,Osaka,20_ 24,2015,Heisei,27,446399,223152,223247
27 ,Osaka,25_ 29,2015,Heisei,27,463425,227414,236011
27 ,Osaka,30_ 34,2015,Heisei,27,508261,250022,258239
27 ,Osaka,35_ 39,2015,Heisei,27,578529,283946,294583
27 ,Osaka,40_ 44,2015,Heisei,27,718598,354421,364177
27 ,Osaka,45_ 49,2015,Heisei,27,643324,317665,325659
27 ,Osaka,50_ 54,2015,Heisei,27,551324,272067,279257
27 ,Osaka,55_ 59,2015,Heisei,27,467690,229542,238148
27 ,Osaka,60_ 64,2015,Heisei,27,531662,257279,274383
27 ,Osaka,65_ 69,2015,Heisei,27,672033,319015,353018
27 ,Osaka,70_ 74,2015,Heisei,27,575811,265395,310416
27 ,Osaka,75_ 79,2015,Heisei,27,449207,200879,248328
27 ,Osaka,80_ 84,2015,Heisei,27,314931,127182,187749
27 ,Osaka,over_85,2015,Heisei,27,266342,78344,187998
28 ,Hyogo,total,1920,Taisho,9,2301799,1175426,1126373
28 ,Hyogo,0_ 4,1920,Taisho,9,282961,142567,140394
28 ,Hyogo,5_ 9,1920,Taisho,9,269322,136813,132509
28 ,Hyogo,10_ 14,1920,Taisho,9,246020,124340,121680
28 ,Hyogo,15_ 19,1920,Taisho,9,235863,120674,115189
28 ,Hyogo,20_ 24,1920,Taisho,9,210615,108394,102221
28 ,Hyogo,25_ 29,1920,Taisho,9,174957,93966,80991
28 ,Hyogo,30_ 34,1920,Taisho,9,157028,84177,72851
28 ,Hyogo,35_ 39,1920,Taisho,9,141032,73897,67135
28 ,Hyogo,40_ 44,1920,Taisho,9,132848,70307,62541
28 ,Hyogo,45_ 49,1920,Taisho,9,106032,55239,50793
28 ,Hyogo,50_ 54,1920,Taisho,9,87522,44640,42882
28 ,Hyogo,55_ 59,1920,Taisho,9,72072,36180,35892
28 ,Hyogo,60_ 64,1920,Taisho,9,67765,32669,35096
28 ,Hyogo,65_ 69,1920,Taisho,9,53310,24966,28344
28 ,Hyogo,70_ 74,1920,Taisho,9,35825,15878,19947
28 ,Hyogo,75_ 79,1920,Taisho,9,18962,7538,11424
28 ,Hyogo,over_80,1920,Taisho,9,9665,3181,6484
28 ,Hyogo,total,1925,Taisho,14,2454679,1239326,1215353
28 ,Hyogo,0_ 4,1925,Taisho,14,319560,161585,157975
28 ,Hyogo,5_ 9,1925,Taisho,14,263269,133089,130180
28 ,Hyogo,10_ 14,1925,Taisho,14,267096,134005,133091
28 ,Hyogo,15_ 19,1925,Taisho,14,253026,123862,129164
28 ,Hyogo,20_ 24,1925,Taisho,14,221285,109243,112042
28 ,Hyogo,25_ 29,1925,Taisho,14,200247,104412,95835
28 ,Hyogo,30_ 34,1925,Taisho,14,162074,86739,75335
28 ,Hyogo,35_ 39,1925,Taisho,14,147526,78874,68652
28 ,Hyogo,40_ 44,1925,Taisho,14,132537,69311,63226
28 ,Hyogo,45_ 49,1925,Taisho,14,124342,65218,59124
28 ,Hyogo,50_ 54,1925,Taisho,14,98409,50436,47973
28 ,Hyogo,55_ 59,1925,Taisho,14,78424,38979,39445
28 ,Hyogo,60_ 64,1925,Taisho,14,62000,29936,32064
28 ,Hyogo,65_ 69,1925,Taisho,14,53705,24619,29086
28 ,Hyogo,70_ 74,1925,Taisho,14,38193,16665,21528
28 ,Hyogo,75_ 79,1925,Taisho,14,21608,8629,12979
28 ,Hyogo,80_ 84,1925,Taisho,14,8618,2972,5646
28 ,Hyogo,over_85,1925,Taisho,14,2760,752,2008
28 ,Hyogo,total,1930,Showa,5,2646301,1332918,1313383
28 ,Hyogo,0_ 4,1930,Showa,5,349366,175866,173500
28 ,Hyogo,5_ 9,1930,Showa,5,298681,151063,147618
28 ,Hyogo,10_ 14,1930,Showa,5,258481,130232,128249
28 ,Hyogo,15_ 19,1930,Showa,5,270740,132534,138206
28 ,Hyogo,20_ 24,1930,Showa,5,242044,119119,122925
28 ,Hyogo,25_ 29,1930,Showa,5,218980,112751,106229
28 ,Hyogo,30_ 34,1930,Showa,5,191008,100356,90652
28 ,Hyogo,35_ 39,1930,Showa,5,154703,82876,71827
28 ,Hyogo,40_ 44,1930,Showa,5,138515,73824,64691
28 ,Hyogo,45_ 49,1930,Showa,5,124002,64302,59700
28 ,Hyogo,50_ 54,1930,Showa,5,115086,59152,55934
28 ,Hyogo,55_ 59,1930,Showa,5,89257,44621,44636
28 ,Hyogo,60_ 64,1930,Showa,5,68245,32442,35803
28 ,Hyogo,65_ 69,1930,Showa,5,50587,23206,27381
28 ,Hyogo,70_ 74,1930,Showa,5,39209,16780,22429
28 ,Hyogo,75_ 79,1930,Showa,5,23510,9194,14316
28 ,Hyogo,over_80,1930,Showa,5,13887,4600,9287
28 ,Hyogo,total,1935,Showa,10,2923249,1466284,1456965
28 ,Hyogo,0_ 4,1935,Showa,10,368419,186466,181953
28 ,Hyogo,5_ 9,1935,Showa,10,334468,168698,165770
28 ,Hyogo,10_ 14,1935,Showa,10,301280,150535,150745
28 ,Hyogo,15_ 19,1935,Showa,10,281909,133899,148010
28 ,Hyogo,20_ 24,1935,Showa,10,276205,134214,141991
28 ,Hyogo,25_ 29,1935,Showa,10,247928,127024,120904
28 ,Hyogo,30_ 34,1935,Showa,10,216018,112803,103215
28 ,Hyogo,35_ 39,1935,Showa,10,186128,98744,87384
28 ,Hyogo,40_ 44,1935,Showa,10,147912,79368,68544
28 ,Hyogo,45_ 49,1935,Showa,10,131296,69705,61591
28 ,Hyogo,50_ 54,1935,Showa,10,115242,58757,56485
28 ,Hyogo,55_ 59,1935,Showa,10,105313,52870,52443
28 ,Hyogo,60_ 64,1935,Showa,10,78458,37743,40715
28 ,Hyogo,65_ 69,1935,Showa,10,55852,25057,30795
28 ,Hyogo,70_ 74,1935,Showa,10,37386,16043,21343
28 ,Hyogo,75_ 79,1935,Showa,10,23907,9273,14634
28 ,Hyogo,over_80,1935,Showa,10,15528,5085,10443
28 ,Hyogo,total,1940,Showa,15,3212045,1617241,1594804
28 ,Hyogo,0_ 4,1940,Showa,15,371465,188394,183071
28 ,Hyogo,5_ 9,1940,Showa,15,360040,181971,178069
28 ,Hyogo,10_ 14,1940,Showa,15,339665,170978,168687
28 ,Hyogo,15_ 19,1940,Showa,15,333586,167196,166390
28 ,Hyogo,20_ 24,1940,Showa,15,281387,135080,146307
28 ,Hyogo,25_ 29,1940,Showa,15,282960,144129,138831
28 ,Hyogo,30_ 34,1940,Showa,15,246823,128009,118814
28 ,Hyogo,35_ 39,1940,Showa,15,212198,111363,100835
28 ,Hyogo,40_ 44,1940,Showa,15,178679,94874,83805
28 ,Hyogo,45_ 49,1940,Showa,15,140479,74469,66010
28 ,Hyogo,50_ 54,1940,Showa,15,122952,63975,58977
28 ,Hyogo,55_ 59,1940,Showa,15,105647,52481,53166
28 ,Hyogo,60_ 64,1940,Showa,15,92695,44415,48280
28 ,Hyogo,65_ 69,1940,Showa,15,64448,29229,35219
28 ,Hyogo,70_ 74,1940,Showa,15,40858,16888,23970
28 ,Hyogo,75_ 79,1940,Showa,15,22554,8762,13792
28 ,Hyogo,80_ 84,1940,Showa,15,10906,3685,7221
28 ,Hyogo,over_85,1940,Showa,15,4414,1217,3197
28 ,Hyogo,total,1945,Showa,20,2821892,1344778,1477114
28 ,Hyogo,1_ 5,1945,Showa,20,346972,175546,171426
28 ,Hyogo,6_ 10,1945,Showa,20,302740,153705,149035
28 ,Hyogo,11_ 15,1945,Showa,20,315938,160029,155909
28 ,Hyogo,16_ 20,1945,Showa,20,296912,147252,149660
28 ,Hyogo,21_ 25,1945,Showa,20,212778,79453,133325
28 ,Hyogo,26_ 30,1945,Showa,20,181813,68997,112816
28 ,Hyogo,31_ 35,1945,Showa,20,194178,83669,110509
28 ,Hyogo,36_ 40,1945,Showa,20,188399,88315,100084
28 ,Hyogo,41_ 45,1945,Showa,20,178225,91664,86561
28 ,Hyogo,46_ 50,1945,Showa,20,154057,80651,73406
28 ,Hyogo,51_ 55,1945,Showa,20,120885,63019,57866
28 ,Hyogo,56_ 60,1945,Showa,20,104332,53185,51147
28 ,Hyogo,61_ 65,1945,Showa,20,82689,39645,43044
28 ,Hyogo,66_ 70,1945,Showa,20,67818,30722,37096
28 ,Hyogo,71_ 75,1945,Showa,20,42412,17677,24735
28 ,Hyogo,76_ 80,1945,Showa,20,20117,7483,12634
28 ,Hyogo,81_ 85,1945,Showa,20,8658,2904,5754
28 ,Hyogo,86以上,1945,Showa,20,2969,862,2107
28 ,Hyogo,total,1950,Showa,25,3309935,1622755,1687180
28 ,Hyogo,0_ 4,1950,Showa,25,425231,216897,208334
28 ,Hyogo,5_ 9,1950,Showa,25,364277,184252,180025
28 ,Hyogo,10_ 14,1950,Showa,25,313312,158857,154455
28 ,Hyogo,15_ 19,1950,Showa,25,333982,164318,169664
28 ,Hyogo,20_ 24,1950,Showa,25,311834,155876,155958
28 ,Hyogo,25_ 29,1950,Showa,25,253161,116461,136700
28 ,Hyogo,30_ 34,1950,Showa,25,214134,96416,117718
28 ,Hyogo,35_ 39,1950,Showa,25,218254,104360,113894
28 ,Hyogo,40_ 44,1950,Showa,25,194870,96027,98843
28 ,Hyogo,45_ 49,1950,Showa,25,171794,87255,84539
28 ,Hyogo,50_ 54,1950,Showa,25,143511,73482,70029
28 ,Hyogo,55_ 59,1950,Showa,25,111627,56264,55363
28 ,Hyogo,60_ 64,1950,Showa,25,92338,44768,47570
28 ,Hyogo,65_ 69,1950,Showa,25,69380,31346,38034
28 ,Hyogo,70_ 74,1950,Showa,25,50956,21457,29499
28 ,Hyogo,75_ 79,1950,Showa,25,27121,10292,16829
28 ,Hyogo,over_80,1950,Showa,25,13819,4281,9538
28 ,Hyogo,total,1955,Showa,30,3620947,1773488,1847459
28 ,Hyogo,0_ 4,1955,Showa,30,340454,174082,166372
28 ,Hyogo,5_ 9,1955,Showa,30,430346,219799,210547
28 ,Hyogo,10_ 14,1955,Showa,30,371602,187868,183734
28 ,Hyogo,15_ 19,1955,Showa,30,330229,162027,168202
28 ,Hyogo,20_ 24,1955,Showa,30,346574,172246,174328
28 ,Hyogo,25_ 29,1955,Showa,30,320684,160807,159877
28 ,Hyogo,30_ 34,1955,Showa,30,256591,117576,139015
28 ,Hyogo,35_ 39,1955,Showa,30,214539,95939,118600
28 ,Hyogo,40_ 44,1955,Showa,30,216974,103203,113771
28 ,Hyogo,45_ 49,1955,Showa,30,191833,93822,98011
28 ,Hyogo,50_ 54,1955,Showa,30,167222,84119,83103
28 ,Hyogo,55_ 59,1955,Showa,30,137155,69151,68004
28 ,Hyogo,60_ 64,1955,Showa,30,102365,50335,52030
28 ,Hyogo,65_ 69,1955,Showa,30,80230,37479,42751
28 ,Hyogo,70_ 74,1955,Showa,30,56325,24092,32233
28 ,Hyogo,75_ 79,1955,Showa,30,36581,14155,22426
28 ,Hyogo,80_ 84,1955,Showa,30,15753,5321,10432
28 ,Hyogo,over_85,1955,Showa,30,5393,1419,3974
28 ,Hyogo,total,1960,Showa,35,3906487,1917887,1988600
28 ,Hyogo,0_ 4,1960,Showa,35,311160,159321,151839
28 ,Hyogo,5_ 9,1960,Showa,35,344053,175983,168070
28 ,Hyogo,10_ 14,1960,Showa,35,433859,221514,212345
28 ,Hyogo,15_ 19,1960,Showa,35,403637,198261,205376
28 ,Hyogo,20_ 24,1960,Showa,35,354679,177775,176904
28 ,Hyogo,25_ 29,1960,Showa,35,356484,178808,177676
28 ,Hyogo,30_ 34,1960,Showa,35,323968,163052,160916
28 ,Hyogo,35_ 39,1960,Showa,35,257064,118349,138715
28 ,Hyogo,40_ 44,1960,Showa,35,212824,95298,117526
28 ,Hyogo,45_ 49,1960,Showa,35,213656,101370,112286
28 ,Hyogo,50_ 54,1960,Showa,35,186417,90417,96000
28 ,Hyogo,55_ 59,1960,Showa,35,159557,79058,80499
28 ,Hyogo,60_ 64,1960,Showa,35,126536,62324,64212
28 ,Hyogo,65_ 69,1960,Showa,35,89767,42658,47109
28 ,Hyogo,70_ 74,1960,Showa,35,65002,28775,36227
28 ,Hyogo,75_ 79,1960,Showa,35,39293,15467,23826
28 ,Hyogo,80_ 84,1960,Showa,35,20556,7189,13367
28 ,Hyogo,over_85,1960,Showa,35,7975,2268,5707
28 ,Hyogo,total,1965,Showa,40,4309944,2120749,2189195
28 ,Hyogo,0_ 4,1965,Showa,40,362139,184454,177685
28 ,Hyogo,5_ 9,1965,Showa,40,321693,163745,157948
28 ,Hyogo,10_ 14,1965,Showa,40,353561,179726,173835
28 ,Hyogo,15_ 19,1965,Showa,40,474509,235741,238768
28 ,Hyogo,20_ 24,1965,Showa,40,428007,213930,214077
28 ,Hyogo,25_ 29,1965,Showa,40,385664,194317,191347
28 ,Hyogo,30_ 34,1965,Showa,40,373654,188721,184933
28 ,Hyogo,35_ 39,1965,Showa,40,333222,168686,164536
28 ,Hyogo,40_ 44,1965,Showa,40,260084,120192,139892
28 ,Hyogo,45_ 49,1965,Showa,40,213367,95943,117424
28 ,Hyogo,50_ 54,1965,Showa,40,210153,99562,110591
28 ,Hyogo,55_ 59,1965,Showa,40,179920,86695,93225
28 ,Hyogo,60_ 64,1965,Showa,40,148394,72117,76277
28 ,Hyogo,65_ 69,1965,Showa,40,111969,53586,58383
28 ,Hyogo,70_ 74,1965,Showa,40,74095,33453,40642
28 ,Hyogo,75_ 79,1965,Showa,40,46616,19131,27485
28 ,Hyogo,80_ 84,1965,Showa,40,22012,7673,14339
28 ,Hyogo,over_85,1965,Showa,40,10885,3077,7808
28 ,Hyogo,total,1970,Showa,45,4667928,2299961,2367967
28 ,Hyogo,0_ 4,1970,Showa,45,410525,210780,199745
28 ,Hyogo,5_ 9,1970,Showa,45,362337,185147,177190
28 ,Hyogo,10_ 14,1970,Showa,45,324096,165585,158511
28 ,Hyogo,15_ 19,1970,Showa,45,382359,191074,191285
28 ,Hyogo,20_ 24,1970,Showa,45,494449,245861,248588
28 ,Hyogo,25_ 29,1970,Showa,45,438233,219688,218545
28 ,Hyogo,30_ 34,1970,Showa,45,384106,193715,190391
28 ,Hyogo,35_ 39,1970,Showa,45,374553,189008,185545
28 ,Hyogo,40_ 44,1970,Showa,45,331383,168038,163345
28 ,Hyogo,45_ 49,1970,Showa,45,260121,120289,139832
28 ,Hyogo,50_ 54,1970,Showa,45,211061,94695,116366
28 ,Hyogo,55_ 59,1970,Showa,45,201925,94577,107348
28 ,Hyogo,60_ 64,1970,Showa,45,168775,79278,89497
28 ,Hyogo,65_ 69,1970,Showa,45,133849,62665,71184
28 ,Hyogo,70_ 74,1970,Showa,45,94281,42588,51693
28 ,Hyogo,75_ 79,1970,Showa,45,54829,22965,31864
28 ,Hyogo,80_ 84,1970,Showa,45,28260,10320,17940
28 ,Hyogo,over_85,1970,Showa,45,12786,3688,9098
28 ,Hyogo,total,1975,Showa,50,4992140,2453277,2538863
28 ,Hyogo,0_ 4,1975,Showa,50,461750,236925,224825
28 ,Hyogo,5_ 9,1975,Showa,50,402551,206752,195799
28 ,Hyogo,10_ 14,1975,Showa,50,360237,184184,176053
28 ,Hyogo,15_ 19,1975,Showa,50,336805,167855,168950
28 ,Hyogo,20_ 24,1975,Showa,50,392525,193311,199214
28 ,Hyogo,25_ 29,1975,Showa,50,493986,247862,246124
28 ,Hyogo,30_ 34,1975,Showa,50,428776,214146,214630
28 ,Hyogo,35_ 39,1975,Showa,50,375473,188256,187217
28 ,Hyogo,40_ 44,1975,Showa,50,368025,184945,183080
28 ,Hyogo,45_ 49,1975,Showa,50,327171,164825,162346
28 ,Hyogo,50_ 54,1975,Showa,50,252755,115588,137167
28 ,Hyogo,55_ 59,1975,Showa,50,202093,88877,113216
28 ,Hyogo,60_ 64,1975,Showa,50,191968,87482,104486
28 ,Hyogo,65_ 69,1975,Showa,50,155415,70208,85207
28 ,Hyogo,70_ 74,1975,Showa,50,115310,51386,63924
28 ,Hyogo,75_ 79,1975,Showa,50,73060,30800,42260
28 ,Hyogo,80_ 84,1975,Showa,50,34939,13257,21682
28 ,Hyogo,over_85,1975,Showa,50,17003,5105,11898
28 ,Hyogo,total,1980,Showa,55,5144892,2512358,2632534
28 ,Hyogo,0_ 4,1980,Showa,55,376457,192927,183530
28 ,Hyogo,5_ 9,1980,Showa,55,453343,232654,220689
28 ,Hyogo,10_ 14,1980,Showa,55,397970,204306,193664
28 ,Hyogo,15_ 19,1980,Showa,55,355232,176025,179207
28 ,Hyogo,20_ 24,1980,Showa,55,324729,154804,169925
28 ,Hyogo,25_ 29,1980,Showa,55,382915,189793,193122
28 ,Hyogo,30_ 34,1980,Showa,55,478437,238520,239917
28 ,Hyogo,35_ 39,1980,Showa,55,418962,208234,210728
28 ,Hyogo,40_ 44,1980,Showa,55,366667,183132,183535
28 ,Hyogo,45_ 49,1980,Showa,55,358339,178409,179930
28 ,Hyogo,50_ 54,1980,Showa,55,316589,157782,158807
28 ,Hyogo,55_ 59,1980,Showa,55,242504,109147,133357
28 ,Hyogo,60_ 64,1980,Showa,55,190653,82011,108642
28 ,Hyogo,65_ 69,1980,Showa,55,176447,77953,98494
28 ,Hyogo,70_ 74,1980,Showa,55,135564,58294,77270
28 ,Hyogo,75_ 79,1980,Showa,55,91032,37744,53288
28 ,Hyogo,80_ 84,1980,Showa,55,48860,18539,30321
28 ,Hyogo,over_85,1980,Showa,55,22805,7338,15467
28 ,Hyogo,total,1985,Showa,60,5278050,2567814,2710236
28 ,Hyogo,0_ 4,1985,Showa,60,324476,165588,158888
28 ,Hyogo,5_ 9,1985,Showa,60,373527,191348,182179
28 ,Hyogo,10_ 14,1985,Showa,60,451102,231150,219952
28 ,Hyogo,15_ 19,1985,Showa,60,392823,197104,195719
28 ,Hyogo,20_ 24,1985,Showa,60,349164,167558,181606
28 ,Hyogo,25_ 29,1985,Showa,60,325495,159914,165581
28 ,Hyogo,30_ 34,1985,Showa,60,378545,187312,191233
28 ,Hyogo,35_ 39,1985,Showa,60,473840,235414,238426
28 ,Hyogo,40_ 44,1985,Showa,60,413394,204963,208431
28 ,Hyogo,45_ 49,1985,Showa,60,361083,179456,181627
28 ,Hyogo,50_ 54,1985,Showa,60,350392,173301,177091
28 ,Hyogo,55_ 59,1985,Showa,60,305472,150310,155162
28 ,Hyogo,60_ 64,1985,Showa,60,231335,102161,129174
28 ,Hyogo,65_ 69,1985,Showa,60,177822,74292,103530
28 ,Hyogo,70_ 74,1985,Showa,60,158213,66892,91321
28 ,Hyogo,75_ 79,1985,Showa,60,111395,44848,66547
28 ,Hyogo,80_ 84,1985,Showa,60,63653,23884,39769
28 ,Hyogo,over_85,1985,Showa,60,34299,10991,23308
28 ,Hyogo,total,1990,Heisei,2,5405040,2619692,2785348
28 ,Hyogo,0_ 4,1990,Heisei,2,285746,146618,139128
28 ,Hyogo,5_ 9,1990,Heisei,2,329979,168507,161472
28 ,Hyogo,10_ 14,1990,Heisei,2,375320,191799,183521
28 ,Hyogo,15_ 19,1990,Heisei,2,444738,222606,222132
28 ,Hyogo,20_ 24,1990,Heisei,2,379295,182248,197047
28 ,Hyogo,25_ 29,1990,Heisei,2,347794,169433,178361
28 ,Hyogo,30_ 34,1990,Heisei,2,327452,160602,166850
28 ,Hyogo,35_ 39,1990,Heisei,2,380701,187890,192811
28 ,Hyogo,40_ 44,1990,Heisei,2,473120,235160,237960
28 ,Hyogo,45_ 49,1990,Heisei,2,409152,202106,207046
28 ,Hyogo,50_ 54,1990,Heisei,2,355058,175227,179831
28 ,Hyogo,55_ 59,1990,Heisei,2,341604,166847,174757
28 ,Hyogo,60_ 64,1990,Heisei,2,293966,142274,151692
28 ,Hyogo,65_ 69,1990,Heisei,2,217944,93723,124221
28 ,Hyogo,70_ 74,1990,Heisei,2,161388,64579,96809
28 ,Hyogo,75_ 79,1990,Heisei,2,132978,52700,80278
28 ,Hyogo,80_ 84,1990,Heisei,2,81349,29678,51671
28 ,Hyogo,over_85,1990,Heisei,2,48742,15451,33291
28 ,Hyogo,total,1995,Heisei,7,5401877,2612369,2789508
28 ,Hyogo,0_ 4,1995,Heisei,7,261645,134121,127524
28 ,Hyogo,5_ 9,1995,Heisei,7,289027,148181,140846
28 ,Hyogo,10_ 14,1995,Heisei,7,329422,168124,161298
28 ,Hyogo,15_ 19,1995,Heisei,7,368045,183768,184277
28 ,Hyogo,20_ 24,1995,Heisei,7,422307,204360,217947
28 ,Hyogo,25_ 29,1995,Heisei,7,374839,184321,190518
28 ,Hyogo,30_ 34,1995,Heisei,7,347081,169993,177088
28 ,Hyogo,35_ 39,1995,Heisei,7,329004,161954,167050
28 ,Hyogo,40_ 44,1995,Heisei,7,379072,187412,191660
28 ,Hyogo,45_ 49,1995,Heisei,7,467674,232708,234966
28 ,Hyogo,50_ 54,1995,Heisei,7,400280,197366,202914
28 ,Hyogo,55_ 59,1995,Heisei,7,344064,168973,175091
28 ,Hyogo,60_ 64,1995,Heisei,7,323134,155633,167501
28 ,Hyogo,65_ 69,1995,Heisei,7,272013,128635,143378
28 ,Hyogo,70_ 74,1995,Heisei,7,195079,80835,114244
28 ,Hyogo,75_ 79,1995,Heisei,7,134349,50249,84100
28 ,Hyogo,80_ 84,1995,Heisei,7,96818,34450,62368
28 ,Hyogo,over_85,1995,Heisei,7,65493,19580,45913
28 ,Hyogo,total,2000,Heisei,12,5550574,2674625,2875949
28 ,Hyogo,0_ 4,2000,Heisei,12,268862,137427,131435
28 ,Hyogo,5_ 9,2000,Heisei,12,268994,137942,131052
28 ,Hyogo,10_ 14,2000,Heisei,12,292256,149739,142517
28 ,Hyogo,15_ 19,2000,Heisei,12,327690,164448,163242
28 ,Hyogo,20_ 24,2000,Heisei,12,359161,173633,185528
28 ,Hyogo,25_ 29,2000,Heisei,12,432593,212667,219926
28 ,Hyogo,30_ 34,2000,Heisei,12,387340,190128,197212
28 ,Hyogo,35_ 39,2000,Heisei,12,355657,174537,181120
28 ,Hyogo,40_ 44,2000,Heisei,12,334301,164361,169940
28 ,Hyogo,45_ 49,2000,Heisei,12,379606,186955,192651
28 ,Hyogo,50_ 54,2000,Heisei,12,464832,229304,235528
28 ,Hyogo,55_ 59,2000,Heisei,12,396736,193658,203078
28 ,Hyogo,60_ 64,2000,Heisei,12,338567,164063,174504
28 ,Hyogo,65_ 69,2000,Heisei,12,310630,146092,164538
28 ,Hyogo,70_ 74,2000,Heisei,12,252765,114971,137794
28 ,Hyogo,75_ 79,2000,Heisei,12,174042,68226,105816
28 ,Hyogo,80_ 84,2000,Heisei,12,107886,36754,71132
28 ,Hyogo,over_85,2000,Heisei,12,94627,27236,67391
28 ,Hyogo,total,2005,Heisei,17,5590601,2680288,2910313
28 ,Hyogo,0_ 4,2005,Heisei,17,252707,129242,123465
28 ,Hyogo,5_ 9,2005,Heisei,17,272261,139288,132973
28 ,Hyogo,10_ 14,2005,Heisei,17,268917,137855,131062
28 ,Hyogo,15_ 19,2005,Heisei,17,290117,146811,143306
28 ,Hyogo,20_ 24,2005,Heisei,17,310158,150674,159484
28 ,Hyogo,25_ 29,2005,Heisei,17,346890,167884,179006
28 ,Hyogo,30_ 34,2005,Heisei,17,431015,210912,220103
28 ,Hyogo,35_ 39,2005,Heisei,17,385849,188620,197229
28 ,Hyogo,40_ 44,2005,Heisei,17,354275,172838,181437
28 ,Hyogo,45_ 49,2005,Heisei,17,329474,160373,169101
28 ,Hyogo,50_ 54,2005,Heisei,17,373072,181910,191162
28 ,Hyogo,55_ 59,2005,Heisei,17,457257,223381,233876
28 ,Hyogo,60_ 64,2005,Heisei,17,389368,188025,201343
28 ,Hyogo,65_ 69,2005,Heisei,17,325891,155154,170737
28 ,Hyogo,70_ 74,2005,Heisei,17,291058,133012,158046
28 ,Hyogo,75_ 79,2005,Heisei,17,225832,97504,128328
28 ,Hyogo,80_ 84,2005,Heisei,17,143078,51461,91617
28 ,Hyogo,over_85,2005,Heisei,17,122705,32946,89759
28 ,Hyogo,total,2010,Heisei,22,5588133,2673328,2914805
28 ,Hyogo,0_ 4,2010,Heisei,22,236222,120792,115430
28 ,Hyogo,5_ 9,2010,Heisei,22,252506,129333,123173
28 ,Hyogo,10_ 14,2010,Heisei,22,270549,138029,132520
28 ,Hyogo,15_ 19,2010,Heisei,22,268710,136239,132471
28 ,Hyogo,20_ 24,2010,Heisei,22,274110,134078,140032
28 ,Hyogo,25_ 29,2010,Heisei,22,301352,147496,153856
28 ,Hyogo,30_ 34,2010,Heisei,22,351120,170931,180189
28 ,Hyogo,35_ 39,2010,Heisei,22,433957,212974,220983
28 ,Hyogo,40_ 44,2010,Heisei,22,387432,189760,197672
28 ,Hyogo,45_ 49,2010,Heisei,22,352851,171733,181118
28 ,Hyogo,50_ 54,2010,Heisei,22,326460,157962,168498
28 ,Hyogo,55_ 59,2010,Heisei,22,369226,179109,190117
28 ,Hyogo,60_ 64,2010,Heisei,22,450224,218167,232057
28 ,Hyogo,65_ 69,2010,Heisei,22,375521,178711,196810
28 ,Hyogo,70_ 74,2010,Heisei,22,305642,141667,163975
28 ,Hyogo,75_ 79,2010,Heisei,22,259181,112423,146758
28 ,Hyogo,80_ 84,2010,Heisei,22,184280,72506,111774
28 ,Hyogo,over_85,2010,Heisei,22,156862,42698,114164
28 ,Hyogo,total,2015,Heisei,27,5534800,2641561,2893239
28 ,Hyogo,0_ 4,2015,Heisei,27,218203,111517,106686
28 ,Hyogo,5_ 9,2015,Heisei,27,236216,120769,115447
28 ,Hyogo,10_ 14,2015,Heisei,27,252452,129389,123063
28 ,Hyogo,15_ 19,2015,Heisei,27,270905,137222,133683
28 ,Hyogo,20_ 24,2015,Heisei,27,250659,123045,127614
28 ,Hyogo,25_ 29,2015,Heisei,27,262439,130001,132438
28 ,Hyogo,30_ 34,2015,Heisei,27,299718,146692,153026
28 ,Hyogo,35_ 39,2015,Heisei,27,349868,170553,179315
28 ,Hyogo,40_ 44,2015,Heisei,27,430624,210980,219644
28 ,Hyogo,45_ 49,2015,Heisei,27,383156,186728,196428
28 ,Hyogo,50_ 54,2015,Heisei,27,347775,168080,179695
28 ,Hyogo,55_ 59,2015,Heisei,27,322093,154977,167116
28 ,Hyogo,60_ 64,2015,Heisei,27,362975,174574,188401
28 ,Hyogo,65_ 69,2015,Heisei,27,434111,207193,226918
28 ,Hyogo,70_ 74,2015,Heisei,27,352666,163152,189514
28 ,Hyogo,75_ 79,2015,Heisei,27,274773,121621,153152
28 ,Hyogo,80_ 84,2015,Heisei,27,215838,86433,129405
28 ,Hyogo,over_85,2015,Heisei,27,204258,61362,142896
29 ,Nara,total,1920,Taisho,9,564607,280383,284224
29 ,Nara,0_ 4,1920,Taisho,9,73004,36859,36145
29 ,Nara,5_ 9,1920,Taisho,9,73268,37188,36080
29 ,Nara,10_ 14,1920,Taisho,9,65788,33002,32786
29 ,Nara,15_ 19,1920,Taisho,9,53601,26248,27353
29 ,Nara,20_ 24,1920,Taisho,9,42725,20438,22287
29 ,Nara,25_ 29,1920,Taisho,9,36195,18331,17864
29 ,Nara,30_ 34,1920,Taisho,9,33557,16801,16756
29 ,Nara,35_ 39,1920,Taisho,9,34544,17131,17413
29 ,Nara,40_ 44,1920,Taisho,9,34425,17586,16839
29 ,Nara,45_ 49,1920,Taisho,9,29268,14869,14399
29 ,Nara,50_ 54,1920,Taisho,9,23097,11767,11330
29 ,Nara,55_ 59,1920,Taisho,9,19322,9587,9735
29 ,Nara,60_ 64,1920,Taisho,9,17405,8252,9153
29 ,Nara,65_ 69,1920,Taisho,9,12942,6066,6876
29 ,Nara,70_ 74,1920,Taisho,9,8898,3936,4962
29 ,Nara,75_ 79,1920,Taisho,9,4572,1697,2875
29 ,Nara,over_80,1920,Taisho,9,1996,625,1371
29 ,Nara,total,1925,Taisho,14,583828,289770,294058
29 ,Nara,0_ 4,1925,Taisho,14,76626,38828,37798
29 ,Nara,5_ 9,1925,Taisho,14,67777,34205,33572
29 ,Nara,10_ 14,1925,Taisho,14,69086,34676,34410
29 ,Nara,15_ 19,1925,Taisho,14,57097,27442,29655
29 ,Nara,20_ 24,1925,Taisho,14,47413,23652,23761
29 ,Nara,25_ 29,1925,Taisho,14,40315,20246,20069
29 ,Nara,30_ 34,1925,Taisho,14,34034,17197,16837
29 ,Nara,35_ 39,1925,Taisho,14,32034,16153,15881
29 ,Nara,40_ 44,1925,Taisho,14,32761,16294,16467
29 ,Nara,45_ 49,1925,Taisho,14,32510,16517,15993
29 ,Nara,50_ 54,1925,Taisho,14,27155,13640,13515
29 ,Nara,55_ 59,1925,Taisho,14,20604,10299,10305
29 ,Nara,60_ 64,1925,Taisho,14,16311,7870,8441
29 ,Nara,65_ 69,1925,Taisho,14,13422,6057,7365
29 ,Nara,70_ 74,1925,Taisho,14,8989,3849,5140
29 ,Nara,75_ 79,1925,Taisho,14,5080,1995,3085
29 ,Nara,80_ 84,1925,Taisho,14,2036,675,1361
29 ,Nara,over_85,1925,Taisho,14,578,175,403
29 ,Nara,total,1930,Showa,5,596225,295456,300769
29 ,Nara,0_ 4,1930,Showa,5,77865,39277,38588
29 ,Nara,5_ 9,1930,Showa,5,71785,36520,35265
29 ,Nara,10_ 14,1930,Showa,5,63846,32139,31707
29 ,Nara,15_ 19,1930,Showa,5,57633,27755,29878
29 ,Nara,20_ 24,1930,Showa,5,49042,23532,25510
29 ,Nara,25_ 29,1930,Showa,5,43161,21701,21460
29 ,Nara,30_ 34,1930,Showa,5,38238,19404,18834
29 ,Nara,35_ 39,1930,Showa,5,32556,16553,16003
29 ,Nara,40_ 44,1930,Showa,5,30116,15291,14825
29 ,Nara,45_ 49,1930,Showa,5,30602,15205,15397
29 ,Nara,50_ 54,1930,Showa,5,29614,14983,14631
29 ,Nara,55_ 59,1930,Showa,5,24130,11970,12160
29 ,Nara,60_ 64,1930,Showa,5,17365,8373,8992
29 ,Nara,65_ 69,1930,Showa,5,12771,5892,6879
29 ,Nara,70_ 74,1930,Showa,5,9277,3841,5436
29 ,Nara,75_ 79,1930,Showa,5,5167,1995,3172
29 ,Nara,over_80,1930,Showa,5,3057,1025,2032
29 ,Nara,total,1935,Showa,10,620471,306011,314460
29 ,Nara,0_ 4,1935,Showa,10,76690,38785,37905
29 ,Nara,5_ 9,1935,Showa,10,74360,37539,36821
29 ,Nara,10_ 14,1935,Showa,10,69042,34679,34363
29 ,Nara,15_ 19,1935,Showa,10,53758,25398,28360
29 ,Nara,20_ 24,1935,Showa,10,51184,23930,27254
29 ,Nara,25_ 29,1935,Showa,10,47462,23620,23842
29 ,Nara,30_ 34,1935,Showa,10,41875,21167,20708
29 ,Nara,35_ 39,1935,Showa,10,37355,19040,18315
29 ,Nara,40_ 44,1935,Showa,10,31474,16131,15343
29 ,Nara,45_ 49,1935,Showa,10,29076,14786,14290
29 ,Nara,50_ 54,1935,Showa,10,28849,14277,14572
29 ,Nara,55_ 59,1935,Showa,10,27088,13434,13654
29 ,Nara,60_ 64,1935,Showa,10,20858,10102,10756
29 ,Nara,65_ 69,1935,Showa,10,13814,6295,7519
29 ,Nara,70_ 74,1935,Showa,10,8960,3780,5180
29 ,Nara,75_ 79,1935,Showa,10,5396,2009,3387
29 ,Nara,over_80,1935,Showa,10,3230,1039,2191
29 ,Nara,total,1940,Showa,15,620197,305508,314689
29 ,Nara,0_ 4,1940,Showa,15,69356,35143,34213
29 ,Nara,5_ 9,1940,Showa,15,72696,36756,35940
29 ,Nara,10_ 14,1940,Showa,15,72012,36120,35892
29 ,Nara,15_ 19,1940,Showa,15,58256,27593,30663
29 ,Nara,20_ 24,1940,Showa,15,48857,24052,24805
29 ,Nara,25_ 29,1940,Showa,15,45944,22503,23441
29 ,Nara,30_ 34,1940,Showa,15,42569,20929,21640
29 ,Nara,35_ 39,1940,Showa,15,38854,19478,19376
29 ,Nara,40_ 44,1940,Showa,15,34395,17415,16980
29 ,Nara,45_ 49,1940,Showa,15,28985,14706,14279
29 ,Nara,50_ 54,1940,Showa,15,26314,13282,13032
29 ,Nara,55_ 59,1940,Showa,15,25087,12209,12878
29 ,Nara,60_ 64,1940,Showa,15,22776,10958,11818
29 ,Nara,65_ 69,1940,Showa,15,16240,7434,8806
29 ,Nara,70_ 74,1940,Showa,15,9412,3955,5457
29 ,Nara,75_ 79,1940,Showa,15,5228,1997,3231
29 ,Nara,80_ 84,1940,Showa,15,2291,728,1563
29 ,Nara,over_85,1940,Showa,15,916,248,668
29 ,Nara,total,1945,Showa,20,779685,355351,424334
29 ,Nara,1_ 5,1945,Showa,20,92639,47036,45603
29 ,Nara,6_ 10,1945,Showa,20,91197,45791,45406
29 ,Nara,11_ 15,1945,Showa,20,92182,46395,45787
29 ,Nara,16_ 20,1945,Showa,20,81281,39111,42170
29 ,Nara,21_ 25,1945,Showa,20,57637,20370,37267
29 ,Nara,26_ 30,1945,Showa,20,46605,14568,32037
29 ,Nara,31_ 35,1945,Showa,20,49735,17595,32140
29 ,Nara,36_ 40,1945,Showa,20,48532,20240,28292
29 ,Nara,41_ 45,1945,Showa,20,47150,23119,24031
29 ,Nara,46_ 50,1945,Showa,20,41062,20506,20556
29 ,Nara,51_ 55,1945,Showa,20,33624,16843,16781
29 ,Nara,56_ 60,1945,Showa,20,29348,14332,15016
29 ,Nara,61_ 65,1945,Showa,20,25339,11626,13713
29 ,Nara,66_ 70,1945,Showa,20,21436,9457,11979
29 ,Nara,71_ 75,1945,Showa,20,13166,5332,7834
29 ,Nara,76_ 80,1945,Showa,20,5690,2087,3603
29 ,Nara,81_ 85,1945,Showa,20,2341,768,1573
29 ,Nara,86以上,1945,Showa,20,721,175,546
29 ,Nara,total,1950,Showa,25,763883,368863,395020
29 ,Nara,0_ 4,1950,Showa,25,88926,45353,43573
29 ,Nara,5_ 9,1950,Showa,25,79493,40378,39115
29 ,Nara,10_ 14,1950,Showa,25,77791,39187,38604
29 ,Nara,15_ 19,1950,Showa,25,80953,40092,40861
29 ,Nara,20_ 24,1950,Showa,25,72094,35436,36658
29 ,Nara,25_ 29,1950,Showa,25,55149,25201,29948
29 ,Nara,30_ 34,1950,Showa,25,46046,19770,26276
29 ,Nara,35_ 39,1950,Showa,25,48063,21266,26797
29 ,Nara,40_ 44,1950,Showa,25,44958,21326,23632
29 ,Nara,45_ 49,1950,Showa,25,40352,20121,20231
29 ,Nara,50_ 54,1950,Showa,25,34666,17370,17296
29 ,Nara,55_ 59,1950,Showa,25,27893,13917,13976
29 ,Nara,60_ 64,1950,Showa,25,23553,11216,12337
29 ,Nara,65_ 69,1950,Showa,25,18983,8435,10548
29 ,Nara,70_ 74,1950,Showa,25,14052,5853,8199
29 ,Nara,75_ 79,1950,Showa,25,7382,2820,4562
29 ,Nara,over_80,1950,Showa,25,3385,1045,2340
29 ,Nara,total,1955,Showa,30,776861,377961,398900
29 ,Nara,0_ 4,1955,Showa,30,72261,37024,35237
29 ,Nara,5_ 9,1955,Showa,30,85370,43603,41767
29 ,Nara,10_ 14,1955,Showa,30,76350,38790,37560
29 ,Nara,15_ 19,1955,Showa,30,74376,36687,37689
29 ,Nara,20_ 24,1955,Showa,30,75144,37448,37696
29 ,Nara,25_ 29,1955,Showa,30,65512,33380,32132
29 ,Nara,30_ 34,1955,Showa,30,51902,23848,28054
29 ,Nara,35_ 39,1955,Showa,30,44041,18981,25060
29 ,Nara,40_ 44,1955,Showa,30,45751,20348,25403
29 ,Nara,45_ 49,1955,Showa,30,42718,20296,22422
29 ,Nara,50_ 54,1955,Showa,30,38030,18885,19145
29 ,Nara,55_ 59,1955,Showa,30,32030,15985,16045
29 ,Nara,60_ 64,1955,Showa,30,24692,12069,12623
29 ,Nara,65_ 69,1955,Showa,30,19562,9120,10442
29 ,Nara,70_ 74,1955,Showa,30,14628,6188,8440
29 ,Nara,75_ 79,1955,Showa,30,9318,3607,5711
29 ,Nara,80_ 84,1955,Showa,30,3991,1368,2623
29 ,Nara,over_85,1955,Showa,30,1176,331,845
29 ,Nara,total,1960,Showa,35,781058,382494,398564
29 ,Nara,0_ 4,1960,Showa,35,58503,29952,28551
29 ,Nara,5_ 9,1960,Showa,35,70852,36291,34561
29 ,Nara,10_ 14,1960,Showa,35,83828,42743,41085
29 ,Nara,15_ 19,1960,Showa,35,75896,37424,38472
29 ,Nara,20_ 24,1960,Showa,35,69597,34722,34875
29 ,Nara,25_ 29,1960,Showa,35,66408,34478,31930
29 ,Nara,30_ 34,1960,Showa,35,62050,31795,30255
29 ,Nara,35_ 39,1960,Showa,35,50303,23392,26911
29 ,Nara,40_ 44,1960,Showa,35,42624,18579,24045
29 ,Nara,45_ 49,1960,Showa,35,44066,19784,24282
29 ,Nara,50_ 54,1960,Showa,35,40514,19253,21261
29 ,Nara,55_ 59,1960,Showa,35,35323,17456,17867
29 ,Nara,60_ 64,1960,Showa,35,28645,14023,14622
29 ,Nara,65_ 69,1960,Showa,35,20936,9929,11007
29 ,Nara,70_ 74,1960,Showa,35,15145,6648,8497
29 ,Nara,75_ 79,1960,Showa,35,9646,3803,5843
29 ,Nara,80_ 84,1960,Showa,35,4867,1683,3184
29 ,Nara,over_85,1960,Showa,35,1855,539,1316
29 ,Nara,total,1965,Showa,40,825965,400353,425612
29 ,Nara,0_ 4,1965,Showa,40,64246,32631,31615
29 ,Nara,5_ 9,1965,Showa,40,60584,30801,29783
29 ,Nara,10_ 14,1965,Showa,40,72120,36783,35337
29 ,Nara,15_ 19,1965,Showa,40,90551,44143,46408
29 ,Nara,20_ 24,1965,Showa,40,74557,35441,39116
29 ,Nara,25_ 29,1965,Showa,40,67183,33573,33610
29 ,Nara,30_ 34,1965,Showa,40,67438,34790,32648
29 ,Nara,35_ 39,1965,Showa,40,62322,31634,30688
29 ,Nara,40_ 44,1965,Showa,40,49919,22894,27025
29 ,Nara,45_ 49,1965,Showa,40,42028,18089,23939
29 ,Nara,50_ 54,1965,Showa,40,42791,19045,23746
29 ,Nara,55_ 59,1965,Showa,40,38886,18345,20541
29 ,Nara,60_ 64,1965,Showa,40,32736,15829,16907
29 ,Nara,65_ 69,1965,Showa,40,25173,11910,13263
29 ,Nara,70_ 74,1965,Showa,40,17084,7673,9411
29 ,Nara,75_ 79,1965,Showa,40,10600,4246,6354
29 ,Nara,80_ 84,1965,Showa,40,5221,1795,3426
29 ,Nara,over_85,1965,Showa,40,2526,731,1795
29 ,Nara,total,1970,Showa,45,930160,450668,479492
29 ,Nara,0_ 4,1970,Showa,45,78556,40123,38433
29 ,Nara,5_ 9,1970,Showa,45,70130,35792,34338
29 ,Nara,10_ 14,1970,Showa,45,64161,32577,31584
29 ,Nara,15_ 19,1970,Showa,45,81608,39709,41899
29 ,Nara,20_ 24,1970,Showa,45,93456,44147,49309
29 ,Nara,25_ 29,1970,Showa,45,80417,38589,41828
29 ,Nara,30_ 34,1970,Showa,45,75428,38360,37068
29 ,Nara,35_ 39,1970,Showa,45,72490,37455,35035
29 ,Nara,40_ 44,1970,Showa,45,64546,32891,31655
29 ,Nara,45_ 49,1970,Showa,45,52125,23836,28289
29 ,Nara,50_ 54,1970,Showa,45,43038,18408,24630
29 ,Nara,55_ 59,1970,Showa,45,42441,18978,23463
29 ,Nara,60_ 64,1970,Showa,45,37614,17461,20153
29 ,Nara,65_ 69,1970,Showa,45,30133,14039,16094
29 ,Nara,70_ 74,1970,Showa,45,21747,9757,11990
29 ,Nara,75_ 79,1970,Showa,45,12752,5309,7443
29 ,Nara,80_ 84,1970,Showa,45,6488,2370,4118
29 ,Nara,over_85,1970,Showa,45,3030,867,2163
29 ,Nara,total,1975,Showa,50,1077491,523633,553858
29 ,Nara,0_ 4,1975,Showa,50,97978,50290,47688
29 ,Nara,5_ 9,1975,Showa,50,87146,44671,42475
29 ,Nara,10_ 14,1975,Showa,50,76008,38851,37157
29 ,Nara,15_ 19,1975,Showa,50,74734,36462,38272
29 ,Nara,20_ 24,1975,Showa,50,84295,39682,44613
29 ,Nara,25_ 29,1975,Showa,50,100837,48543,52294
29 ,Nara,30_ 34,1975,Showa,50,92104,45326,46778
29 ,Nara,35_ 39,1975,Showa,50,82570,42196,40374
29 ,Nara,40_ 44,1975,Showa,50,78356,40394,37962
29 ,Nara,45_ 49,1975,Showa,50,69417,35162,34255
29 ,Nara,50_ 54,1975,Showa,50,54441,24816,29625
29 ,Nara,55_ 59,1975,Showa,50,44254,18973,25281
29 ,Nara,60_ 64,1975,Showa,50,42981,18877,24104
29 ,Nara,65_ 69,1975,Showa,50,35981,16054,19927
29 ,Nara,70_ 74,1975,Showa,50,26767,11839,14928
29 ,Nara,75_ 79,1975,Showa,50,16978,7019,9959
29 ,Nara,80_ 84,1975,Showa,50,8330,3126,5204
29 ,Nara,over_85,1975,Showa,50,3977,1142,2835
29 ,Nara,total,1980,Showa,55,1209365,587067,622298
29 ,Nara,0_ 4,1980,Showa,55,88473,45208,43265
29 ,Nara,5_ 9,1980,Showa,55,108732,55813,52919
29 ,Nara,10_ 14,1980,Showa,55,94281,48109,46172
29 ,Nara,15_ 19,1980,Showa,55,85823,42140,43683
29 ,Nara,20_ 24,1980,Showa,55,76573,35936,40637
29 ,Nara,25_ 29,1980,Showa,55,88124,42482,45642
29 ,Nara,30_ 34,1980,Showa,55,112267,54250,58017
29 ,Nara,35_ 39,1980,Showa,55,101500,50067,51433
29 ,Nara,40_ 44,1980,Showa,55,87768,45062,42706
29 ,Nara,45_ 49,1980,Showa,55,81147,41501,39646
29 ,Nara,50_ 54,1980,Showa,55,71648,35909,35739
29 ,Nara,55_ 59,1980,Showa,55,55296,25003,30293
29 ,Nara,60_ 64,1980,Showa,55,44162,18624,25538
29 ,Nara,65_ 69,1980,Showa,55,41362,17626,23736
29 ,Nara,70_ 74,1980,Showa,55,32641,13910,18731
29 ,Nara,75_ 79,1980,Showa,55,21701,8918,12783
29 ,Nara,80_ 84,1980,Showa,55,11501,4323,7178
29 ,Nara,over_85,1980,Showa,55,5548,1714,3834
29 ,Nara,total,1985,Showa,60,1304866,632955,671911
29 ,Nara,0_ 4,1985,Showa,60,79690,40826,38864
29 ,Nara,5_ 9,1985,Showa,60,94648,48490,46158
29 ,Nara,10_ 14,1985,Showa,60,114177,58469,55708
29 ,Nara,15_ 19,1985,Showa,60,102928,51511,51417
29 ,Nara,20_ 24,1985,Showa,60,86672,41093,45579
29 ,Nara,25_ 29,1985,Showa,60,76786,37293,39493
29 ,Nara,30_ 34,1985,Showa,60,93203,44783,48420
29 ,Nara,35_ 39,1985,Showa,60,119274,57711,61563
29 ,Nara,40_ 44,1985,Showa,60,105589,52188,53401
29 ,Nara,45_ 49,1985,Showa,60,89553,45826,43727
29 ,Nara,50_ 54,1985,Showa,60,82107,41535,40572
29 ,Nara,55_ 59,1985,Showa,60,72293,35811,36482
29 ,Nara,60_ 64,1985,Showa,60,55382,24694,30688
29 ,Nara,65_ 69,1985,Showa,60,42757,17568,25189
29 ,Nara,70_ 74,1985,Showa,60,38216,15626,22590
29 ,Nara,75_ 79,1985,Showa,60,27435,10915,16520
29 ,Nara,80_ 84,1985,Showa,60,15490,5757,9733
29 ,Nara,over_85,1985,Showa,60,8211,2596,5615
29 ,Nara,total,1990,Heisei,2,1375481,663591,711890
29 ,Nara,0_ 4,1990,Heisei,2,71758,36693,35065
29 ,Nara,5_ 9,1990,Heisei,2,85280,43590,41690
29 ,Nara,10_ 14,1990,Heisei,2,98825,50607,48218
29 ,Nara,15_ 19,1990,Heisei,2,121601,61210,60391
29 ,Nara,20_ 24,1990,Heisei,2,99239,46828,52411
29 ,Nara,25_ 29,1990,Heisei,2,83588,39853,43735
29 ,Nara,30_ 34,1990,Heisei,2,80796,38871,41925
29 ,Nara,35_ 39,1990,Heisei,2,98159,47309,50850
29 ,Nara,40_ 44,1990,Heisei,2,123061,59415,63646
29 ,Nara,45_ 49,1990,Heisei,2,106952,52798,54154
29 ,Nara,50_ 54,1990,Heisei,2,90271,45817,44454
29 ,Nara,55_ 59,1990,Heisei,2,82515,41054,41461
29 ,Nara,60_ 64,1990,Heisei,2,72287,35217,37070
29 ,Nara,65_ 69,1990,Heisei,2,53971,23558,30413
29 ,Nara,70_ 74,1990,Heisei,2,39918,15775,24143
29 ,Nara,75_ 79,1990,Heisei,2,32840,12514,20326
29 ,Nara,80_ 84,1990,Heisei,2,20517,7502,13015
29 ,Nara,over_85,1990,Heisei,2,12008,3769,8239
29 ,Nara,total,1995,Heisei,7,1430862,688741,742121
29 ,Nara,0_ 4,1995,Heisei,7,68176,34890,33286
29 ,Nara,5_ 9,1995,Heisei,7,76125,38916,37209
29 ,Nara,10_ 14,1995,Heisei,7,88117,45074,43043
29 ,Nara,15_ 19,1995,Heisei,7,105435,52953,52482
29 ,Nara,20_ 24,1995,Heisei,7,117687,56479,61208
29 ,Nara,25_ 29,1995,Heisei,7,96043,45789,50254
29 ,Nara,30_ 34,1995,Heisei,7,88540,42804,45736
29 ,Nara,35_ 39,1995,Heisei,7,85347,41380,43967
29 ,Nara,40_ 44,1995,Heisei,7,101758,49313,52445
29 ,Nara,45_ 49,1995,Heisei,7,125236,60602,64634
29 ,Nara,50_ 54,1995,Heisei,7,107583,52837,54746
29 ,Nara,55_ 59,1995,Heisei,7,90470,45646,44824
29 ,Nara,60_ 64,1995,Heisei,7,81162,39962,41200
29 ,Nara,65_ 69,1995,Heisei,7,69455,33105,36350
29 ,Nara,70_ 74,1995,Heisei,7,50505,21118,29387
29 ,Nara,75_ 79,1995,Heisei,7,35206,13112,22094
29 ,Nara,80_ 84,1995,Heisei,7,25576,8790,16786
29 ,Nara,over_85,1995,Heisei,7,17450,5258,12192
29 ,Nara,total,2000,Heisei,12,1442795,691098,751697
29 ,Nara,0_ 4,2000,Heisei,12,66732,34301,32431
29 ,Nara,5_ 9,2000,Heisei,12,69887,35714,34173
29 ,Nara,10_ 14,2000,Heisei,12,77203,39578,37625
29 ,Nara,15_ 19,2000,Heisei,12,91985,46273,45712
29 ,Nara,20_ 24,2000,Heisei,12,97859,47195,50664
29 ,Nara,25_ 29,2000,Heisei,12,107127,51765,55362
29 ,Nara,30_ 34,2000,Heisei,12,95003,45419,49584
29 ,Nara,35_ 39,2000,Heisei,12,89414,43146,46268
29 ,Nara,40_ 44,2000,Heisei,12,86168,41573,44595
29 ,Nara,45_ 49,2000,Heisei,12,101481,48901,52580
29 ,Nara,50_ 54,2000,Heisei,12,123528,59159,64369
29 ,Nara,55_ 59,2000,Heisei,12,106304,51802,54502
29 ,Nara,60_ 64,2000,Heisei,12,88566,44049,44517
29 ,Nara,65_ 69,2000,Heisei,12,77600,37243,40357
29 ,Nara,70_ 74,2000,Heisei,12,64052,29444,34608
29 ,Nara,75_ 79,2000,Heisei,12,44784,17733,27051
29 ,Nara,80_ 84,2000,Heisei,12,28151,9495,18656
29 ,Nara,over_85,2000,Heisei,12,24845,7082,17763
29 ,Nara,total,2005,Heisei,17,1421310,676375,744935
29 ,Nara,0_ 4,2005,Heisei,17,60298,31075,29223
29 ,Nara,5_ 9,2005,Heisei,17,67209,34495,32714
29 ,Nara,10_ 14,2005,Heisei,17,69629,35637,33992
29 ,Nara,15_ 19,2005,Heisei,17,79761,40357,39404
29 ,Nara,20_ 24,2005,Heisei,17,84208,40803,43405
29 ,Nara,25_ 29,2005,Heisei,17,85210,40903,44307
29 ,Nara,30_ 34,2005,Heisei,17,101222,48965,52257
29 ,Nara,35_ 39,2005,Heisei,17,92619,44131,48488
29 ,Nara,40_ 44,2005,Heisei,17,87901,42057,45844
29 ,Nara,45_ 49,2005,Heisei,17,84381,40284,44097
29 ,Nara,50_ 54,2005,Heisei,17,99097,47335,51762
29 ,Nara,55_ 59,2005,Heisei,17,120511,57160,63351
29 ,Nara,60_ 64,2005,Heisei,17,103792,50206,53586
29 ,Nara,65_ 69,2005,Heisei,17,85043,41624,43419
29 ,Nara,70_ 74,2005,Heisei,17,72236,33682,38554
29 ,Nara,75_ 79,2005,Heisei,17,57050,24667,32383
29 ,Nara,80_ 84,2005,Heisei,17,36992,13327,23665
29 ,Nara,over_85,2005,Heisei,17,32207,8600,23607
29 ,Nara,total,2010,Heisei,22,1400728,663321,737407
29 ,Nara,0_ 4,2010,Heisei,22,55125,27913,27212
29 ,Nara,5_ 9,2010,Heisei,22,61298,31507,29791
29 ,Nara,10_ 14,2010,Heisei,22,67588,34708,32880
29 ,Nara,15_ 19,2010,Heisei,22,72494,36774,35720
29 ,Nara,20_ 24,2010,Heisei,22,72474,34990,37484
29 ,Nara,25_ 29,2010,Heisei,22,72000,34587,37413
29 ,Nara,30_ 34,2010,Heisei,22,81063,39033,42030
29 ,Nara,35_ 39,2010,Heisei,22,100595,48672,51923
29 ,Nara,40_ 44,2010,Heisei,22,92203,43710,48493
29 ,Nara,45_ 49,2010,Heisei,22,86511,41033,45478
29 ,Nara,50_ 54,2010,Heisei,22,82631,39081,43550
29 ,Nara,55_ 59,2010,Heisei,22,96932,45994,50938
29 ,Nara,60_ 64,2010,Heisei,22,118159,55744,62415
29 ,Nara,65_ 69,2010,Heisei,22,99854,47528,52326
29 ,Nara,70_ 74,2010,Heisei,22,79835,38236,41599
29 ,Nara,75_ 79,2010,Heisei,22,64748,28764,35984
29 ,Nara,80_ 84,2010,Heisei,22,47229,18664,28565
29 ,Nara,over_85,2010,Heisei,22,42080,11549,30531
29 ,Nara,total,2015,Heisei,27,1364316,643946,720370
29 ,Nara,0_ 4,2015,Heisei,27,50390,25677,24713
29 ,Nara,5_ 9,2015,Heisei,27,56593,28754,27839
29 ,Nara,10_ 14,2015,Heisei,27,61987,31962,30025
29 ,Nara,15_ 19,2015,Heisei,27,70004,35472,34532
29 ,Nara,20_ 24,2015,Heisei,27,65484,31891,33593
29 ,Nara,25_ 29,2015,Heisei,27,61935,29857,32078
29 ,Nara,30_ 34,2015,Heisei,27,68091,32808,35283
29 ,Nara,35_ 39,2015,Heisei,27,79979,38523,41456
29 ,Nara,40_ 44,2015,Heisei,27,99571,47963,51608
29 ,Nara,45_ 49,2015,Heisei,27,90666,42950,47716
29 ,Nara,50_ 54,2015,Heisei,27,84853,40125,44728
29 ,Nara,55_ 59,2015,Heisei,27,80986,38198,42788
29 ,Nara,60_ 64,2015,Heisei,27,94983,44965,50018
29 ,Nara,65_ 69,2015,Heisei,27,113923,53309,60614
29 ,Nara,70_ 74,2015,Heisei,27,94142,43922,50220
29 ,Nara,75_ 79,2015,Heisei,27,72335,33395,38940
29 ,Nara,80_ 84,2015,Heisei,27,54294,22478,31816
29 ,Nara,over_85,2015,Heisei,27,53920,16242,37678
30 ,Wakayama,total,1920,Taisho,9,750411,372058,378353
30 ,Wakayama,0_ 4,1920,Taisho,9,99191,50336,48855
30 ,Wakayama,5_ 9,1920,Taisho,9,98539,50043,48496
30 ,Wakayama,10_ 14,1920,Taisho,9,86926,44034,42892
30 ,Wakayama,15_ 19,1920,Taisho,9,67527,33481,34046
30 ,Wakayama,20_ 24,1920,Taisho,9,56121,27350,28771
30 ,Wakayama,25_ 29,1920,Taisho,9,47350,23995,23355
30 ,Wakayama,30_ 34,1920,Taisho,9,41603,20801,20802
30 ,Wakayama,35_ 39,1920,Taisho,9,44526,21710,22816
30 ,Wakayama,40_ 44,1920,Taisho,9,46061,22633,23428
30 ,Wakayama,45_ 49,1920,Taisho,9,38297,19028,19269
30 ,Wakayama,50_ 54,1920,Taisho,9,29446,14749,14697
30 ,Wakayama,55_ 59,1920,Taisho,9,26256,13098,13158
30 ,Wakayama,60_ 64,1920,Taisho,9,25496,12313,13183
30 ,Wakayama,65_ 69,1920,Taisho,9,18736,8716,10020
30 ,Wakayama,70_ 74,1920,Taisho,9,13367,5820,7547
30 ,Wakayama,75_ 79,1920,Taisho,9,7306,2812,4494
30 ,Wakayama,over_80,1920,Taisho,9,3663,1139,2524
30 ,Wakayama,total,1925,Taisho,14,787511,392191,395320
30 ,Wakayama,0_ 4,1925,Taisho,14,104017,52822,51195
30 ,Wakayama,5_ 9,1925,Taisho,14,94298,47848,46450
30 ,Wakayama,10_ 14,1925,Taisho,14,94781,47728,47053
30 ,Wakayama,15_ 19,1925,Taisho,14,75952,37515,38437
30 ,Wakayama,20_ 24,1925,Taisho,14,61064,30162,30902
30 ,Wakayama,25_ 29,1925,Taisho,14,54616,27938,26678
30 ,Wakayama,30_ 34,1925,Taisho,14,45462,23369,22093
30 ,Wakayama,35_ 39,1925,Taisho,14,40289,20394,19895
30 ,Wakayama,40_ 44,1925,Taisho,14,42411,21038,21373
30 ,Wakayama,45_ 49,1925,Taisho,14,43725,21671,22054
30 ,Wakayama,50_ 54,1925,Taisho,14,35713,17725,17988
30 ,Wakayama,55_ 59,1925,Taisho,14,26602,13154,13448
30 ,Wakayama,60_ 64,1925,Taisho,14,22606,11026,11580
30 ,Wakayama,65_ 69,1925,Taisho,14,20185,9382,10803
30 ,Wakayama,70_ 74,1925,Taisho,14,13371,5853,7518
30 ,Wakayama,75_ 79,1925,Taisho,14,7980,3152,4828
30 ,Wakayama,80_ 84,1925,Taisho,14,3353,1116,2237
30 ,Wakayama,over_85,1925,Taisho,14,1086,298,788
30 ,Wakayama,total,1930,Showa,5,830748,415035,415713
30 ,Wakayama,0_ 4,1930,Showa,5,111043,56248,54795
30 ,Wakayama,5_ 9,1930,Showa,5,100807,51254,49553
30 ,Wakayama,10_ 14,1930,Showa,5,91139,46022,45117
30 ,Wakayama,15_ 19,1930,Showa,5,80958,40314,40644
30 ,Wakayama,20_ 24,1930,Showa,5,67911,33803,34108
30 ,Wakayama,25_ 29,1930,Showa,5,59495,30258,29237
30 ,Wakayama,30_ 34,1930,Showa,5,52787,27044,25743
30 ,Wakayama,35_ 39,1930,Showa,5,44168,22846,21322
30 ,Wakayama,40_ 44,1930,Showa,5,38617,19779,18838
30 ,Wakayama,45_ 49,1930,Showa,5,40546,20080,20466
30 ,Wakayama,50_ 54,1930,Showa,5,41001,20213,20788
30 ,Wakayama,55_ 59,1930,Showa,5,32575,16030,16545
30 ,Wakayama,60_ 64,1930,Showa,5,23186,11177,12009
30 ,Wakayama,65_ 69,1930,Showa,5,18285,8499,9786
30 ,Wakayama,70_ 74,1930,Showa,5,14653,6415,8238
30 ,Wakayama,75_ 79,1930,Showa,5,8311,3290,5021
30 ,Wakayama,over_80,1930,Showa,5,5266,1763,3503
30 ,Wakayama,total,1935,Showa,10,864087,428638,435449
30 ,Wakayama,0_ 4,1935,Showa,10,109172,55388,53784
30 ,Wakayama,5_ 9,1935,Showa,10,107350,54442,52908
30 ,Wakayama,10_ 14,1935,Showa,10,98392,49228,49164
30 ,Wakayama,15_ 19,1935,Showa,10,76235,36313,39922
30 ,Wakayama,20_ 24,1935,Showa,10,70188,33923,36265
30 ,Wakayama,25_ 29,1935,Showa,10,64626,32433,32193
30 ,Wakayama,30_ 34,1935,Showa,10,57391,29304,28087
30 ,Wakayama,35_ 39,1935,Showa,10,51021,26289,24732
30 ,Wakayama,40_ 44,1935,Showa,10,42211,21912,20299
30 ,Wakayama,45_ 49,1935,Showa,10,36745,18783,17962
30 ,Wakayama,50_ 54,1935,Showa,10,38133,18838,19295
30 ,Wakayama,55_ 59,1935,Showa,10,37318,18168,19150
30 ,Wakayama,60_ 64,1935,Showa,10,28384,13623,14761
30 ,Wakayama,65_ 69,1935,Showa,10,18896,8710,10186
30 ,Wakayama,70_ 74,1935,Showa,10,13436,5864,7572
30 ,Wakayama,75_ 79,1935,Showa,10,8922,3568,5354
30 ,Wakayama,over_80,1935,Showa,10,5667,1852,3815
30 ,Wakayama,total,1940,Showa,15,864451,426876,437575
30 ,Wakayama,0_ 4,1940,Showa,15,98178,49882,48296
30 ,Wakayama,5_ 9,1940,Showa,15,104095,52725,51370
30 ,Wakayama,10_ 14,1940,Showa,15,102560,51333,51227
30 ,Wakayama,15_ 19,1940,Showa,15,77566,36332,41234
30 ,Wakayama,20_ 24,1940,Showa,15,66860,33676,33184
30 ,Wakayama,25_ 29,1940,Showa,15,63591,31235,32356
30 ,Wakayama,30_ 34,1940,Showa,15,59246,29290,29956
30 ,Wakayama,35_ 39,1940,Showa,15,53350,26744,26606
30 ,Wakayama,40_ 44,1940,Showa,15,47697,24363,23334
30 ,Wakayama,45_ 49,1940,Showa,15,39387,20237,19150
30 ,Wakayama,50_ 54,1940,Showa,15,33898,17032,16866
30 ,Wakayama,55_ 59,1940,Showa,15,34410,16734,17676
30 ,Wakayama,60_ 64,1940,Showa,15,32516,15457,17059
30 ,Wakayama,65_ 69,1940,Showa,15,23111,10659,12452
30 ,Wakayama,70_ 74,1940,Showa,15,13631,5915,7716
30 ,Wakayama,75_ 79,1940,Showa,15,8314,3294,5020
30 ,Wakayama,80_ 84,1940,Showa,15,4361,1475,2886
30 ,Wakayama,over_85,1940,Showa,15,1674,490,1184
30 ,Wakayama,total,1945,Showa,20,936006,430015,505991
30 ,Wakayama,1_ 5,1945,Showa,20,112443,56838,55605
30 ,Wakayama,6_ 10,1945,Showa,20,107280,54464,52816
30 ,Wakayama,11_ 15,1945,Showa,20,111911,56266,55645
30 ,Wakayama,16_ 20,1945,Showa,20,99572,48017,51555
30 ,Wakayama,21_ 25,1945,Showa,20,68637,23845,44792
30 ,Wakayama,26_ 30,1945,Showa,20,55226,17825,37401
30 ,Wakayama,31_ 35,1945,Showa,20,56679,20132,36547
30 ,Wakayama,36_ 40,1945,Showa,20,57411,24641,32770
30 ,Wakayama,41_ 45,1945,Showa,20,55732,27473,28259
30 ,Wakayama,46_ 50,1945,Showa,20,49090,24834,24256
30 ,Wakayama,51_ 55,1945,Showa,20,39602,20288,19314
30 ,Wakayama,56_ 60,1945,Showa,20,33990,16653,17337
30 ,Wakayama,61_ 65,1945,Showa,20,30887,14474,16413
30 ,Wakayama,66_ 70,1945,Showa,20,26923,12033,14890
30 ,Wakayama,71_ 75,1945,Showa,20,17571,7477,10094
30 ,Wakayama,76_ 80,1945,Showa,20,7985,3097,4888
30 ,Wakayama,81_ 85,1945,Showa,20,3695,1264,2431
30 ,Wakayama,86以上,1945,Showa,20,1372,394,978
30 ,Wakayama,total,1950,Showa,25,982113,475324,506789
30 ,Wakayama,0_ 4,1950,Showa,25,118567,60724,57843
30 ,Wakayama,5_ 9,1950,Showa,25,107049,54211,52838
30 ,Wakayama,10_ 14,1950,Showa,25,101024,51206,49818
30 ,Wakayama,15_ 19,1950,Showa,25,98109,49225,48884
30 ,Wakayama,20_ 24,1950,Showa,25,86975,42443,44532
30 ,Wakayama,25_ 29,1950,Showa,25,70320,31196,39124
30 ,Wakayama,30_ 34,1950,Showa,25,60319,26390,33929
30 ,Wakayama,35_ 39,1950,Showa,25,60879,27196,33683
30 ,Wakayama,40_ 44,1950,Showa,25,56756,26845,29911
30 ,Wakayama,45_ 49,1950,Showa,25,51673,25779,25894
30 ,Wakayama,50_ 54,1950,Showa,25,44459,22397,22062
30 ,Wakayama,55_ 59,1950,Showa,25,35716,17924,17792
30 ,Wakayama,60_ 64,1950,Showa,25,28849,13899,14950
30 ,Wakayama,65_ 69,1950,Showa,25,25313,11410,13903
30 ,Wakayama,70_ 74,1950,Showa,25,19682,8349,11333
30 ,Wakayama,75_ 79,1950,Showa,25,10849,4328,6521
30 ,Wakayama,over_80,1950,Showa,25,5495,1772,3723
30 ,Wakayama,total,1955,Showa,30,1006819,490533,516286
30 ,Wakayama,0_ 4,1955,Showa,30,92762,47382,45380
30 ,Wakayama,5_ 9,1955,Showa,30,115663,59056,56607
30 ,Wakayama,10_ 14,1955,Showa,30,104346,52854,51492
30 ,Wakayama,15_ 19,1955,Showa,30,89074,44244,44830
30 ,Wakayama,20_ 24,1955,Showa,30,88503,43826,44677
30 ,Wakayama,25_ 29,1955,Showa,30,84966,42772,42194
30 ,Wakayama,30_ 34,1955,Showa,30,69124,31350,37774
30 ,Wakayama,35_ 39,1955,Showa,30,58946,26240,32706
30 ,Wakayama,40_ 44,1955,Showa,30,58975,26613,32362
30 ,Wakayama,45_ 49,1955,Showa,30,54865,26129,28736
30 ,Wakayama,50_ 54,1955,Showa,30,49079,24559,24520
30 ,Wakayama,55_ 59,1955,Showa,30,41801,21026,20775
30 ,Wakayama,60_ 64,1955,Showa,30,32293,16082,16211
30 ,Wakayama,65_ 69,1955,Showa,30,24534,11568,12966
30 ,Wakayama,70_ 74,1955,Showa,30,19961,8665,11296
30 ,Wakayama,75_ 79,1955,Showa,30,13748,5388,8360
30 ,Wakayama,80_ 84,1955,Showa,30,6121,2184,3937
30 ,Wakayama,over_85,1955,Showa,30,2042,585,1457
30 ,Wakayama,total,1960,Showa,35,1002191,484994,517197
30 ,Wakayama,0_ 4,1960,Showa,35,79399,40895,38504
30 ,Wakayama,5_ 9,1960,Showa,35,91245,46655,44590
30 ,Wakayama,10_ 14,1960,Showa,35,113750,58126,55624
30 ,Wakayama,15_ 19,1960,Showa,35,87529,42313,45216
30 ,Wakayama,20_ 24,1960,Showa,35,76627,36297,40330
30 ,Wakayama,25_ 29,1960,Showa,35,83365,41491,41874
30 ,Wakayama,30_ 34,1960,Showa,35,81575,40791,40784
30 ,Wakayama,35_ 39,1960,Showa,35,66502,29948,36554
30 ,Wakayama,40_ 44,1960,Showa,35,56746,25204,31542
30 ,Wakayama,45_ 49,1960,Showa,35,56404,25343,31061
30 ,Wakayama,50_ 54,1960,Showa,35,51973,24458,27515
30 ,Wakayama,55_ 59,1960,Showa,35,46089,22728,23361
30 ,Wakayama,60_ 64,1960,Showa,35,38193,18858,19335
30 ,Wakayama,65_ 69,1960,Showa,35,28133,13571,14562
30 ,Wakayama,70_ 74,1960,Showa,35,19935,8990,10945
30 ,Wakayama,75_ 79,1960,Showa,35,13883,5621,8262
30 ,Wakayama,80_ 84,1960,Showa,35,7786,2745,5041
30 ,Wakayama,over_85,1960,Showa,35,3057,960,2097
30 ,Wakayama,total,1965,Showa,40,1026975,497256,529719
30 ,Wakayama,0_ 4,1965,Showa,40,81577,41585,39992
30 ,Wakayama,5_ 9,1965,Showa,40,79575,40710,38865
30 ,Wakayama,10_ 14,1965,Showa,40,91013,46264,44749
30 ,Wakayama,15_ 19,1965,Showa,40,100643,49538,51105
30 ,Wakayama,20_ 24,1965,Showa,40,81499,38544,42955
30 ,Wakayama,25_ 29,1965,Showa,40,77921,38531,39390
30 ,Wakayama,30_ 34,1965,Showa,40,83516,41827,41689
30 ,Wakayama,35_ 39,1965,Showa,40,81082,40774,40308
30 ,Wakayama,40_ 44,1965,Showa,40,66065,29831,36234
30 ,Wakayama,45_ 49,1965,Showa,40,55509,24812,30697
30 ,Wakayama,50_ 54,1965,Showa,40,54231,24379,29852
30 ,Wakayama,55_ 59,1965,Showa,40,49463,23283,26180
30 ,Wakayama,60_ 64,1965,Showa,40,42388,20581,21807
30 ,Wakayama,65_ 69,1965,Showa,40,33469,16049,17420
30 ,Wakayama,70_ 74,1965,Showa,40,22951,10555,12396
30 ,Wakayama,75_ 79,1965,Showa,40,14274,5955,8319
30 ,Wakayama,80_ 84,1965,Showa,40,7848,2862,4986
30 ,Wakayama,over_85,1965,Showa,40,3951,1176,2775
30 ,Wakayama,total,1970,Showa,45,1042736,503202,539534
30 ,Wakayama,0_ 4,1970,Showa,45,82871,42791,40080
30 ,Wakayama,5_ 9,1970,Showa,45,81439,41594,39845
30 ,Wakayama,10_ 14,1970,Showa,45,79175,40580,38595
30 ,Wakayama,15_ 19,1970,Showa,45,79199,39248,39951
30 ,Wakayama,20_ 24,1970,Showa,45,90191,42421,47770
30 ,Wakayama,25_ 29,1970,Showa,45,81432,39502,41930
30 ,Wakayama,30_ 34,1970,Showa,45,76961,38195,38766
30 ,Wakayama,35_ 39,1970,Showa,45,82231,41116,41115
30 ,Wakayama,40_ 44,1970,Showa,45,77850,39200,38650
30 ,Wakayama,45_ 49,1970,Showa,45,64531,28736,35795
30 ,Wakayama,50_ 54,1970,Showa,45,53716,23799,29917
30 ,Wakayama,55_ 59,1970,Showa,45,50847,22660,28187
30 ,Wakayama,60_ 64,1970,Showa,45,46009,21020,24989
30 ,Wakayama,65_ 69,1970,Showa,45,38059,17808,20251
30 ,Wakayama,70_ 74,1970,Showa,45,28457,12892,15565
30 ,Wakayama,75_ 79,1970,Showa,45,16830,7158,9672
30 ,Wakayama,80_ 84,1970,Showa,45,8533,3140,5393
30 ,Wakayama,over_85,1970,Showa,45,4405,1342,3063
30 ,Wakayama,total,1975,Showa,50,1072118,517868,554250
30 ,Wakayama,0_ 4,1975,Showa,50,88726,45876,42850
30 ,Wakayama,5_ 9,1975,Showa,50,81968,42268,39700
30 ,Wakayama,10_ 14,1975,Showa,50,80924,41428,39496
30 ,Wakayama,15_ 19,1975,Showa,50,69890,35150,34740
30 ,Wakayama,20_ 24,1975,Showa,50,69786,32650,37136
30 ,Wakayama,25_ 29,1975,Showa,50,90902,44431,46471
30 ,Wakayama,30_ 34,1975,Showa,50,80947,39752,41195
30 ,Wakayama,35_ 39,1975,Showa,50,75829,37526,38303
30 ,Wakayama,40_ 44,1975,Showa,50,81059,40538,40521
30 ,Wakayama,45_ 49,1975,Showa,50,77527,38762,38765
30 ,Wakayama,50_ 54,1975,Showa,50,62254,27683,34571
30 ,Wakayama,55_ 59,1975,Showa,50,51680,22629,29051
30 ,Wakayama,60_ 64,1975,Showa,50,48943,21242,27701
30 ,Wakayama,65_ 69,1975,Showa,50,42081,18598,23483
30 ,Wakayama,70_ 74,1975,Showa,50,32384,14472,17912
30 ,Wakayama,75_ 79,1975,Showa,50,21500,9141,12359
30 ,Wakayama,80_ 84,1975,Showa,50,10392,3972,6420
30 ,Wakayama,over_85,1975,Showa,50,5161,1637,3524
30 ,Wakayama,total,1980,Showa,55,1087012,523467,563545
30 ,Wakayama,0_ 4,1980,Showa,55,73060,37639,35421
30 ,Wakayama,5_ 9,1980,Showa,55,89112,46026,43086
30 ,Wakayama,10_ 14,1980,Showa,55,81805,42149,39656
30 ,Wakayama,15_ 19,1980,Showa,55,73128,36868,36260
30 ,Wakayama,20_ 24,1980,Showa,55,59498,27808,31690
30 ,Wakayama,25_ 29,1980,Showa,55,73016,35324,37692
30 ,Wakayama,30_ 34,1980,Showa,55,90634,44576,46058
30 ,Wakayama,35_ 39,1980,Showa,55,80443,39359,41084
30 ,Wakayama,40_ 44,1980,Showa,55,74571,36869,37702
30 ,Wakayama,45_ 49,1980,Showa,55,78983,39180,39803
30 ,Wakayama,50_ 54,1980,Showa,55,75143,37159,37984
30 ,Wakayama,55_ 59,1980,Showa,55,60133,26373,33760
30 ,Wakayama,60_ 64,1980,Showa,55,49131,21094,28037
30 ,Wakayama,65_ 69,1980,Showa,55,45130,19038,26092
30 ,Wakayama,70_ 74,1980,Showa,55,36809,15576,21233
30 ,Wakayama,75_ 79,1980,Showa,55,25349,10576,14773
30 ,Wakayama,80_ 84,1980,Showa,55,14040,5434,8606
30 ,Wakayama,over_85,1980,Showa,55,6622,2169,4453
30 ,Wakayama,total,1985,Showa,60,1087206,520172,567034
30 ,Wakayama,0_ 4,1985,Showa,60,63444,32519,30925
30 ,Wakayama,5_ 9,1985,Showa,60,72970,37450,35520
30 ,Wakayama,10_ 14,1985,Showa,60,88794,45855,42939
30 ,Wakayama,15_ 19,1985,Showa,60,75120,38284,36836
30 ,Wakayama,20_ 24,1985,Showa,60,59716,27289,32427
30 ,Wakayama,25_ 29,1985,Showa,60,62166,29899,32267
30 ,Wakayama,30_ 34,1985,Showa,60,72602,35379,37223
30 ,Wakayama,35_ 39,1985,Showa,60,90006,44194,45812
30 ,Wakayama,40_ 44,1985,Showa,60,79266,38614,40652
30 ,Wakayama,45_ 49,1985,Showa,60,72634,35691,36943
30 ,Wakayama,50_ 54,1985,Showa,60,76608,37511,39097
30 ,Wakayama,55_ 59,1985,Showa,60,72673,35377,37296
30 ,Wakayama,60_ 64,1985,Showa,60,57589,24825,32764
30 ,Wakayama,65_ 69,1985,Showa,60,46002,19228,26774
30 ,Wakayama,70_ 74,1985,Showa,60,40366,16338,24028
30 ,Wakayama,75_ 79,1985,Showa,60,30132,11870,18262
30 ,Wakayama,80_ 84,1985,Showa,60,17402,6581,10821
30 ,Wakayama,over_85,1985,Showa,60,9631,3223,6408
30 ,Wakayama,total,1990,Heisei,2,1074325,510777,563548
30 ,Wakayama,0_ 4,1990,Heisei,2,55574,28532,27042
30 ,Wakayama,5_ 9,1990,Heisei,2,64465,32977,31488
30 ,Wakayama,10_ 14,1990,Heisei,2,72800,37414,35386
30 ,Wakayama,15_ 19,1990,Heisei,2,79910,40817,39093
30 ,Wakayama,20_ 24,1990,Heisei,2,58703,26892,31811
30 ,Wakayama,25_ 29,1990,Heisei,2,61229,28492,32737
30 ,Wakayama,30_ 34,1990,Heisei,2,62248,30131,32117
30 ,Wakayama,35_ 39,1990,Heisei,2,72563,35463,37100
30 ,Wakayama,40_ 44,1990,Heisei,2,89080,43840,45240
30 ,Wakayama,45_ 49,1990,Heisei,2,77558,37674,39884
30 ,Wakayama,50_ 54,1990,Heisei,2,70807,34526,36281
30 ,Wakayama,55_ 59,1990,Heisei,2,74222,35796,38426
30 ,Wakayama,60_ 64,1990,Heisei,2,69841,33438,36403
30 ,Wakayama,65_ 69,1990,Heisei,2,54351,22837,31514
30 ,Wakayama,70_ 74,1990,Heisei,2,41694,16820,24874
30 ,Wakayama,75_ 79,1990,Heisei,2,33854,12857,20997
30 ,Wakayama,80_ 84,1990,Heisei,2,21637,7752,13885
30 ,Wakayama,over_85,1990,Heisei,2,13016,4058,8958
30 ,Wakayama,total,1995,Heisei,7,1080435,513450,566985
30 ,Wakayama,0_ 4,1995,Heisei,7,50815,26165,24650
30 ,Wakayama,5_ 9,1995,Heisei,7,58761,30216,28545
30 ,Wakayama,10_ 14,1995,Heisei,7,66084,33839,32245
30 ,Wakayama,15_ 19,1995,Heisei,7,67325,34628,32697
30 ,Wakayama,20_ 24,1995,Heisei,7,67526,32771,34755
30 ,Wakayama,25_ 29,1995,Heisei,7,63167,29806,33361
30 ,Wakayama,30_ 34,1995,Heisei,7,64231,30351,33880
30 ,Wakayama,35_ 39,1995,Heisei,7,64781,31645,33136
30 ,Wakayama,40_ 44,1995,Heisei,7,74044,36426,37618
30 ,Wakayama,45_ 49,1995,Heisei,7,89314,43977,45337
30 ,Wakayama,50_ 54,1995,Heisei,7,76901,37206,39695
30 ,Wakayama,55_ 59,1995,Heisei,7,69838,33644,36194
30 ,Wakayama,60_ 64,1995,Heisei,7,71965,34025,37940
30 ,Wakayama,65_ 69,1995,Heisei,7,66416,30992,35424
30 ,Wakayama,70_ 74,1995,Heisei,7,50023,20304,29719
30 ,Wakayama,75_ 79,1995,Heisei,7,35719,13551,22168
30 ,Wakayama,80_ 84,1995,Heisei,7,25512,8632,16880
30 ,Wakayama,over_85,1995,Heisei,7,17905,5204,12701
30 ,Wakayama,total,2000,Heisei,12,1069912,506882,563030
30 ,Wakayama,0_ 4,2000,Heisei,12,48615,24754,23861
30 ,Wakayama,5_ 9,2000,Heisei,12,51936,26778,25158
30 ,Wakayama,10_ 14,2000,Heisei,12,58945,30280,28665
30 ,Wakayama,15_ 19,2000,Heisei,12,60715,31223,29492
30 ,Wakayama,20_ 24,2000,Heisei,12,55488,27276,28212
30 ,Wakayama,25_ 29,2000,Heisei,12,69535,33825,35710
30 ,Wakayama,30_ 34,2000,Heisei,12,63705,30237,33468
30 ,Wakayama,35_ 39,2000,Heisei,12,64771,30645,34126
30 ,Wakayama,40_ 44,2000,Heisei,12,64535,31550,32985
30 ,Wakayama,45_ 49,2000,Heisei,12,72993,35763,37230
30 ,Wakayama,50_ 54,2000,Heisei,12,87829,42988,44841
30 ,Wakayama,55_ 59,2000,Heisei,12,75737,36296,39441
30 ,Wakayama,60_ 64,2000,Heisei,12,68497,32582,35915
30 ,Wakayama,65_ 69,2000,Heisei,12,68558,31676,36882
30 ,Wakayama,70_ 74,2000,Heisei,12,61293,27658,33635
30 ,Wakayama,75_ 79,2000,Heisei,12,43981,16823,27158
30 ,Wakayama,80_ 84,2000,Heisei,12,28228,9713,18515
30 ,Wakayama,over_85,2000,Heisei,12,24263,6623,17640
30 ,Wakayama,total,2005,Heisei,17,1035969,488022,547947
30 ,Wakayama,0_ 4,2005,Heisei,17,42358,21741,20617
30 ,Wakayama,5_ 9,2005,Heisei,17,48931,24889,24042
30 ,Wakayama,10_ 14,2005,Heisei,17,51381,26488,24893
30 ,Wakayama,15_ 19,2005,Heisei,17,53397,27498,25899
30 ,Wakayama,20_ 24,2005,Heisei,17,47142,22983,24159
30 ,Wakayama,25_ 29,2005,Heisei,17,54445,26524,27921
30 ,Wakayama,30_ 34,2005,Heisei,17,67811,33071,34740
30 ,Wakayama,35_ 39,2005,Heisei,17,62305,29546,32759
30 ,Wakayama,40_ 44,2005,Heisei,17,63261,29724,33537
30 ,Wakayama,45_ 49,2005,Heisei,17,63132,30672,32460
30 ,Wakayama,50_ 54,2005,Heisei,17,71341,34811,36530
30 ,Wakayama,55_ 59,2005,Heisei,17,85602,41353,44249
30 ,Wakayama,60_ 64,2005,Heisei,17,73992,35048,38944
30 ,Wakayama,65_ 69,2005,Heisei,17,65569,30706,34863
30 ,Wakayama,70_ 74,2005,Heisei,17,63576,28392,35184
30 ,Wakayama,75_ 79,2005,Heisei,17,54032,23085,30947
30 ,Wakayama,80_ 84,2005,Heisei,17,35606,12510,23096
30 ,Wakayama,over_85,2005,Heisei,17,30690,8161,22529
30 ,Wakayama,total,2010,Heisei,22,1002198,471397,530801
30 ,Wakayama,0_ 4,2010,Heisei,22,37354,19135,18219
30 ,Wakayama,5_ 9,2010,Heisei,22,42341,21755,20586
30 ,Wakayama,10_ 14,2010,Heisei,22,48310,24531,23779
30 ,Wakayama,15_ 19,2010,Heisei,22,46996,24343,22653
30 ,Wakayama,20_ 24,2010,Heisei,22,41014,20321,20693
30 ,Wakayama,25_ 29,2010,Heisei,22,46398,22539,23859
30 ,Wakayama,30_ 34,2010,Heisei,22,53593,26471,27122
30 ,Wakayama,35_ 39,2010,Heisei,22,67300,33002,34298
30 ,Wakayama,40_ 44,2010,Heisei,22,61637,29309,32328
30 ,Wakayama,45_ 49,2010,Heisei,22,61994,29160,32834
30 ,Wakayama,50_ 54,2010,Heisei,22,61855,29917,31938
30 ,Wakayama,55_ 59,2010,Heisei,22,69965,33871,36094
30 ,Wakayama,60_ 64,2010,Heisei,22,83821,40178,43643
30 ,Wakayama,65_ 69,2010,Heisei,22,70825,33101,37724
30 ,Wakayama,70_ 74,2010,Heisei,22,61097,27692,33405
30 ,Wakayama,75_ 79,2010,Heisei,22,56324,23812,32512
30 ,Wakayama,80_ 84,2010,Heisei,22,43657,16964,26693
30 ,Wakayama,over_85,2010,Heisei,22,38943,10335,28608
30 ,Wakayama,total,2015,Heisei,27,963579,453216,510363
30 ,Wakayama,0_ 4,2015,Heisei,27,35018,17748,17270
30 ,Wakayama,5_ 9,2015,Heisei,27,38506,19705,18801
30 ,Wakayama,10_ 14,2015,Heisei,27,42888,21997,20891
30 ,Wakayama,15_ 19,2015,Heisei,27,45295,23044,22251
30 ,Wakayama,20_ 24,2015,Heisei,27,37816,19009,18807
30 ,Wakayama,25_ 29,2015,Heisei,27,42095,21022,21073
30 ,Wakayama,30_ 34,2015,Heisei,27,46856,22949,23907
30 ,Wakayama,35_ 39,2015,Heisei,27,54178,26760,27418
30 ,Wakayama,40_ 44,2015,Heisei,27,67600,33245,34355
30 ,Wakayama,45_ 49,2015,Heisei,27,61294,29207,32087
30 ,Wakayama,50_ 54,2015,Heisei,27,61287,28898,32389
30 ,Wakayama,55_ 59,2015,Heisei,27,61026,29402,31624
30 ,Wakayama,60_ 64,2015,Heisei,27,68832,33098,35734
30 ,Wakayama,65_ 69,2015,Heisei,27,80784,38219,42565
30 ,Wakayama,70_ 74,2015,Heisei,27,66362,30215,36147
30 ,Wakayama,75_ 79,2015,Heisei,27,54721,23834,30887
30 ,Wakayama,80_ 84,2015,Heisei,27,46214,18032,28182
30 ,Wakayama,over_85,2015,Heisei,27,48158,14163,33995
31 ,Tottori,total,1920,Taisho,9,454675,222802,231873
31 ,Tottori,0_ 4,1920,Taisho,9,58276,29444,28832
31 ,Tottori,5_ 9,1920,Taisho,9,53526,26989,26537
31 ,Tottori,10_ 14,1920,Taisho,9,46873,23742,23131
31 ,Tottori,15_ 19,1920,Taisho,9,39491,19201,20290
31 ,Tottori,20_ 24,1920,Taisho,9,34258,16648,17610
31 ,Tottori,25_ 29,1920,Taisho,9,27845,13828,14017
31 ,Tottori,30_ 34,1920,Taisho,9,28428,14101,14327
31 ,Tottori,35_ 39,1920,Taisho,9,27212,13122,14090
31 ,Tottori,40_ 44,1920,Taisho,9,25087,12537,12550
31 ,Tottori,45_ 49,1920,Taisho,9,22219,10882,11337
31 ,Tottori,50_ 54,1920,Taisho,9,19546,9375,10171
31 ,Tottori,55_ 59,1920,Taisho,9,18962,9231,9731
31 ,Tottori,60_ 64,1920,Taisho,9,19314,9207,10107
31 ,Tottori,65_ 69,1920,Taisho,9,13775,6434,7341
31 ,Tottori,70_ 74,1920,Taisho,9,9959,4339,5620
31 ,Tottori,75_ 79,1920,Taisho,9,6303,2486,3817
31 ,Tottori,over_80,1920,Taisho,9,3601,1236,2365
31 ,Tottori,total,1925,Taisho,14,472230,230580,241650
31 ,Tottori,0_ 4,1925,Taisho,14,64202,32433,31769
31 ,Tottori,5_ 9,1925,Taisho,14,55167,27883,27284
31 ,Tottori,10_ 14,1925,Taisho,14,51544,25908,25636
31 ,Tottori,15_ 19,1925,Taisho,14,42417,20698,21719
31 ,Tottori,20_ 24,1925,Taisho,14,33695,15951,17744
31 ,Tottori,25_ 29,1925,Taisho,14,31667,15708,15959
31 ,Tottori,30_ 34,1925,Taisho,14,26239,13056,13183
31 ,Tottori,35_ 39,1925,Taisho,14,27139,13447,13692
31 ,Tottori,40_ 44,1925,Taisho,14,25873,12510,13363
31 ,Tottori,45_ 49,1925,Taisho,14,23702,11754,11948
31 ,Tottori,50_ 54,1925,Taisho,14,20529,9874,10655
31 ,Tottori,55_ 59,1925,Taisho,14,17664,8322,9342
31 ,Tottori,60_ 64,1925,Taisho,14,16448,7752,8696
31 ,Tottori,65_ 69,1925,Taisho,14,15645,7115,8530
31 ,Tottori,70_ 74,1925,Taisho,14,10089,4368,5721
31 ,Tottori,75_ 79,1925,Taisho,14,6190,2456,3734
31 ,Tottori,80_ 84,1925,Taisho,14,3051,1063,1988
31 ,Tottori,over_85,1925,Taisho,14,969,282,687
31 ,Tottori,total,1930,Showa,5,489266,239084,250182
31 ,Tottori,0_ 4,1930,Showa,5,63547,31947,31600
31 ,Tottori,5_ 9,1930,Showa,5,60728,30728,30000
31 ,Tottori,10_ 14,1930,Showa,5,53052,26738,26314
31 ,Tottori,15_ 19,1930,Showa,5,45457,22056,23401
31 ,Tottori,20_ 24,1930,Showa,5,36414,17872,18542
31 ,Tottori,25_ 29,1930,Showa,5,32079,15942,16137
31 ,Tottori,30_ 34,1930,Showa,5,30312,15123,15189
31 ,Tottori,35_ 39,1930,Showa,5,25310,12584,12726
31 ,Tottori,40_ 44,1930,Showa,5,25902,12828,13074
31 ,Tottori,45_ 49,1930,Showa,5,24578,11768,12810
31 ,Tottori,50_ 54,1930,Showa,5,21850,10663,11187
31 ,Tottori,55_ 59,1930,Showa,5,18678,8797,9881
31 ,Tottori,60_ 64,1930,Showa,5,15428,7066,8362
31 ,Tottori,65_ 69,1930,Showa,5,13530,6047,7483
31 ,Tottori,70_ 74,1930,Showa,5,11567,4935,6632
31 ,Tottori,75_ 79,1930,Showa,5,6521,2610,3911
31 ,Tottori,over_80,1930,Showa,5,4313,1380,2933
31 ,Tottori,total,1935,Showa,10,490461,239301,251160
31 ,Tottori,0_ 4,1935,Showa,10,62224,31503,30721
31 ,Tottori,5_ 9,1935,Showa,10,59930,30105,29825
31 ,Tottori,10_ 14,1935,Showa,10,57311,29168,28143
31 ,Tottori,15_ 19,1935,Showa,10,41744,20185,21559
31 ,Tottori,20_ 24,1935,Showa,10,36106,17023,19083
31 ,Tottori,25_ 29,1935,Showa,10,32492,15901,16591
31 ,Tottori,30_ 34,1935,Showa,10,29986,14994,14992
31 ,Tottori,35_ 39,1935,Showa,10,28639,14284,14355
31 ,Tottori,40_ 44,1935,Showa,10,23621,11749,11872
31 ,Tottori,45_ 49,1935,Showa,10,24424,12084,12340
31 ,Tottori,50_ 54,1935,Showa,10,22862,10911,11951
31 ,Tottori,55_ 59,1935,Showa,10,20018,9656,10362
31 ,Tottori,60_ 64,1935,Showa,10,16472,7606,8866
31 ,Tottori,65_ 69,1935,Showa,10,12658,5522,7136
31 ,Tottori,70_ 74,1935,Showa,10,10005,4228,5777
31 ,Tottori,75_ 79,1935,Showa,10,7386,2880,4506
31 ,Tottori,over_80,1935,Showa,10,4583,1502,3081
31 ,Tottori,total,1940,Showa,15,484306,233909,250397
31 ,Tottori,0_ 4,1940,Showa,15,57140,28820,28320
31 ,Tottori,5_ 9,1940,Showa,15,58559,29566,28993
31 ,Tottori,10_ 14,1940,Showa,15,56455,28152,28303
31 ,Tottori,15_ 19,1940,Showa,15,43857,20383,23474
31 ,Tottori,20_ 24,1940,Showa,15,36346,18097,18249
31 ,Tottori,25_ 29,1940,Showa,15,31647,14968,16679
31 ,Tottori,30_ 34,1940,Showa,15,29144,13926,15218
31 ,Tottori,35_ 39,1940,Showa,15,27682,13537,14145
31 ,Tottori,40_ 44,1940,Showa,15,26635,13089,13546
31 ,Tottori,45_ 49,1940,Showa,15,22032,10836,11196
31 ,Tottori,50_ 54,1940,Showa,15,22673,11032,11641
31 ,Tottori,55_ 59,1940,Showa,15,20626,9583,11043
31 ,Tottori,60_ 64,1940,Showa,15,17594,8271,9323
31 ,Tottori,65_ 69,1940,Showa,15,13455,5903,7552
31 ,Tottori,70_ 74,1940,Showa,15,9256,3756,5500
31 ,Tottori,75_ 79,1940,Showa,15,6202,2353,3849
31 ,Tottori,80_ 84,1940,Showa,15,3677,1289,2388
31 ,Tottori,over_85,1940,Showa,15,1326,348,978
31 ,Tottori,total,1945,Showa,20,563220,255525,307695
31 ,Tottori,1_ 5,1945,Showa,20,70340,35763,34577
31 ,Tottori,6_ 10,1945,Showa,20,66668,33546,33122
31 ,Tottori,11_ 15,1945,Showa,20,67172,33824,33348
31 ,Tottori,16_ 20,1945,Showa,20,58445,27422,31023
31 ,Tottori,21_ 25,1945,Showa,20,42221,14693,27528
31 ,Tottori,26_ 30,1945,Showa,20,33294,10788,22506
31 ,Tottori,31_ 35,1945,Showa,20,32953,12224,20729
31 ,Tottori,36_ 40,1945,Showa,20,31630,13373,18257
31 ,Tottori,41_ 45,1945,Showa,20,29779,14011,15768
31 ,Tottori,46_ 50,1945,Showa,20,28662,13994,14668
31 ,Tottori,51_ 55,1945,Showa,20,23388,11466,11922
31 ,Tottori,56_ 60,1945,Showa,20,22736,10944,11792
31 ,Tottori,61_ 65,1945,Showa,20,19856,8901,10955
31 ,Tottori,66_ 70,1945,Showa,20,15302,6772,8530
31 ,Tottori,71_ 75,1945,Showa,20,10577,4336,6241
31 ,Tottori,76_ 80,1945,Showa,20,5786,2082,3704
31 ,Tottori,81_ 85,1945,Showa,20,3071,996,2075
31 ,Tottori,86以上,1945,Showa,20,1340,390,950
31 ,Tottori,total,1950,Showa,25,600177,289787,310390
31 ,Tottori,0_ 4,1950,Showa,25,76986,39312,37674
31 ,Tottori,5_ 9,1950,Showa,25,66543,33881,32662
31 ,Tottori,10_ 14,1950,Showa,25,63101,31731,31370
31 ,Tottori,15_ 19,1950,Showa,25,59400,30490,28910
31 ,Tottori,20_ 24,1950,Showa,25,51808,24870,26938
31 ,Tottori,25_ 29,1950,Showa,25,43834,19459,24375
31 ,Tottori,30_ 34,1950,Showa,25,36167,15842,20325
31 ,Tottori,35_ 39,1950,Showa,25,35316,16134,19182
31 ,Tottori,40_ 44,1950,Showa,25,32055,15367,16688
31 ,Tottori,45_ 49,1950,Showa,25,29002,14364,14638
31 ,Tottori,50_ 54,1950,Showa,25,26644,12986,13658
31 ,Tottori,55_ 59,1950,Showa,25,21131,10313,10818
31 ,Tottori,60_ 64,1950,Showa,25,20029,9500,10529
31 ,Tottori,65_ 69,1950,Showa,25,16023,7006,9017
31 ,Tottori,70_ 74,1950,Showa,25,11171,4713,6458
31 ,Tottori,75_ 79,1950,Showa,25,6618,2467,4151
31 ,Tottori,over_80,1950,Showa,25,4255,1317,2938
31 ,Tottori,total,1955,Showa,30,614259,297015,317244
31 ,Tottori,0_ 4,1955,Showa,30,63951,32847,31104
31 ,Tottori,5_ 9,1955,Showa,30,74395,38012,36383
31 ,Tottori,10_ 14,1955,Showa,30,64835,32929,31906
31 ,Tottori,15_ 19,1955,Showa,30,54120,27168,26952
31 ,Tottori,20_ 24,1955,Showa,30,50708,24220,26488
31 ,Tottori,25_ 29,1955,Showa,30,49448,24083,25365
31 ,Tottori,30_ 34,1955,Showa,30,42244,19039,23205
31 ,Tottori,35_ 39,1955,Showa,30,34988,15470,19518
31 ,Tottori,40_ 44,1955,Showa,30,34040,15586,18454
31 ,Tottori,45_ 49,1955,Showa,30,30722,14785,15937
31 ,Tottori,50_ 54,1955,Showa,30,27590,13667,13923
31 ,Tottori,55_ 59,1955,Showa,30,25055,12148,12907
31 ,Tottori,60_ 64,1955,Showa,30,18954,9108,9846
31 ,Tottori,65_ 69,1955,Showa,30,17053,7853,9200
31 ,Tottori,70_ 74,1955,Showa,30,12941,5375,7566
31 ,Tottori,75_ 79,1955,Showa,30,7805,3047,4758
31 ,Tottori,80_ 84,1955,Showa,30,3808,1262,2546
31 ,Tottori,over_85,1955,Showa,30,1601,415,1186
31 ,Tottori,total,1960,Showa,35,599135,286716,312419
31 ,Tottori,0_ 4,1960,Showa,35,50520,25834,24686
31 ,Tottori,5_ 9,1960,Showa,35,62659,32207,30452
31 ,Tottori,10_ 14,1960,Showa,35,73228,37352,35876
31 ,Tottori,15_ 19,1960,Showa,35,48954,24306,24648
31 ,Tottori,20_ 24,1960,Showa,35,40507,18001,22506
31 ,Tottori,25_ 29,1960,Showa,35,45780,21876,23904
31 ,Tottori,30_ 34,1960,Showa,35,47042,22845,24197
31 ,Tottori,35_ 39,1960,Showa,35,40627,18121,22506
31 ,Tottori,40_ 44,1960,Showa,35,33616,14788,18828
31 ,Tottori,45_ 49,1960,Showa,35,32466,14749,17717
31 ,Tottori,50_ 54,1960,Showa,35,29178,13905,15273
31 ,Tottori,55_ 59,1960,Showa,35,25913,12576,13337
31 ,Tottori,60_ 64,1960,Showa,35,22678,10760,11918
31 ,Tottori,65_ 69,1960,Showa,35,16512,7693,8819
31 ,Tottori,70_ 74,1960,Showa,35,13697,6020,7677
31 ,Tottori,75_ 79,1960,Showa,35,9122,3522,5600
31 ,Tottori,80_ 84,1960,Showa,35,4565,1585,2980
31 ,Tottori,over_85,1960,Showa,35,2071,576,1495
31 ,Tottori,total,1965,Showa,40,579853,275572,304281
31 ,Tottori,0_ 4,1965,Showa,40,43015,21851,21164
31 ,Tottori,5_ 9,1965,Showa,40,49804,25277,24527
31 ,Tottori,10_ 14,1965,Showa,40,61770,31539,30231
31 ,Tottori,15_ 19,1965,Showa,40,58051,28880,29171
31 ,Tottori,20_ 24,1965,Showa,40,35049,15043,20006
31 ,Tottori,25_ 29,1965,Showa,40,37365,17454,19911
31 ,Tottori,30_ 34,1965,Showa,40,44389,21563,22826
31 ,Tottori,35_ 39,1965,Showa,40,45870,22252,23618
31 ,Tottori,40_ 44,1965,Showa,40,39292,17496,21796
31 ,Tottori,45_ 49,1965,Showa,40,32456,14154,18302
31 ,Tottori,50_ 54,1965,Showa,40,30933,14082,16851
31 ,Tottori,55_ 59,1965,Showa,40,27445,13051,14394
31 ,Tottori,60_ 64,1965,Showa,40,23675,11333,12342
31 ,Tottori,65_ 69,1965,Showa,40,19871,9158,10713
31 ,Tottori,70_ 74,1965,Showa,40,13369,5888,7481
31 ,Tottori,75_ 79,1965,Showa,40,9764,4006,5758
31 ,Tottori,80_ 84,1965,Showa,40,5241,1818,3423
31 ,Tottori,over_85,1965,Showa,40,2494,727,1767
31 ,Tottori,total,1970,Showa,45,568777,269497,299280
31 ,Tottori,0_ 4,1970,Showa,45,38565,19769,18796
31 ,Tottori,5_ 9,1970,Showa,45,43455,22183,21272
31 ,Tottori,10_ 14,1970,Showa,45,49705,25293,24412
31 ,Tottori,15_ 19,1970,Showa,45,50017,25146,24871
31 ,Tottori,20_ 24,1970,Showa,45,42983,19389,23594
31 ,Tottori,25_ 29,1970,Showa,45,36263,17282,18981
31 ,Tottori,30_ 34,1970,Showa,45,37781,18008,19773
31 ,Tottori,35_ 39,1970,Showa,45,44031,21347,22684
31 ,Tottori,40_ 44,1970,Showa,45,44877,21675,23202
31 ,Tottori,45_ 49,1970,Showa,45,38366,16953,21413
31 ,Tottori,50_ 54,1970,Showa,45,31386,13557,17829
31 ,Tottori,55_ 59,1970,Showa,45,29313,13135,16178
31 ,Tottori,60_ 64,1970,Showa,45,25482,11776,13706
31 ,Tottori,65_ 69,1970,Showa,45,21107,9757,11350
31 ,Tottori,70_ 74,1970,Showa,45,16547,7118,9429
31 ,Tottori,75_ 79,1970,Showa,45,9926,4084,5842
31 ,Tottori,80_ 84,1970,Showa,45,5901,2138,3763
31 ,Tottori,over_85,1970,Showa,45,3072,887,2185
31 ,Tottori,total,1975,Showa,50,581311,277151,304160
31 ,Tottori,0_ 4,1975,Showa,50,44579,22894,21685
31 ,Tottori,5_ 9,1975,Showa,50,39900,20482,19418
31 ,Tottori,10_ 14,1975,Showa,50,43882,22362,21520
31 ,Tottori,15_ 19,1975,Showa,50,42002,21228,20774
31 ,Tottori,20_ 24,1975,Showa,50,37994,17674,20320
31 ,Tottori,25_ 29,1975,Showa,50,46497,23089,23408
31 ,Tottori,30_ 34,1975,Showa,50,38394,18991,19403
31 ,Tottori,35_ 39,1975,Showa,50,38620,18579,20041
31 ,Tottori,40_ 44,1975,Showa,50,44067,21380,22687
31 ,Tottori,45_ 49,1975,Showa,50,44446,21432,23014
31 ,Tottori,50_ 54,1975,Showa,50,37595,16463,21132
31 ,Tottori,55_ 59,1975,Showa,50,30391,12963,17428
31 ,Tottori,60_ 64,1975,Showa,50,28149,12395,15754
31 ,Tottori,65_ 69,1975,Showa,50,23560,10521,13039
31 ,Tottori,70_ 74,1975,Showa,50,18249,7999,10250
31 ,Tottori,75_ 79,1975,Showa,50,12878,5183,7695
31 ,Tottori,80_ 84,1975,Showa,50,6351,2368,3983
31 ,Tottori,over_85,1975,Showa,50,3682,1098,2584
31 ,Tottori,total,1980,Showa,55,604221,289946,314275
31 ,Tottori,0_ 4,1980,Showa,55,42884,21890,20994
31 ,Tottori,5_ 9,1980,Showa,55,46832,24080,22752
31 ,Tottori,10_ 14,1980,Showa,55,40915,20977,19938
31 ,Tottori,15_ 19,1980,Showa,55,39403,20309,19094
31 ,Tottori,20_ 24,1980,Showa,55,34151,16245,17906
31 ,Tottori,25_ 29,1980,Showa,55,43676,21776,21900
31 ,Tottori,30_ 34,1980,Showa,55,49481,25129,24352
31 ,Tottori,35_ 39,1980,Showa,55,39871,19962,19909
31 ,Tottori,40_ 44,1980,Showa,55,39022,18821,20201
31 ,Tottori,45_ 49,1980,Showa,55,43692,21161,22531
31 ,Tottori,50_ 54,1980,Showa,55,43723,20892,22831
31 ,Tottori,55_ 59,1980,Showa,55,36748,15893,20855
31 ,Tottori,60_ 64,1980,Showa,55,29177,12281,16896
31 ,Tottori,65_ 69,1980,Showa,55,26133,11219,14914
31 ,Tottori,70_ 74,1980,Showa,55,20730,8799,11931
31 ,Tottori,75_ 79,1980,Showa,55,14589,5974,8615
31 ,Tottori,80_ 84,1980,Showa,55,8613,3074,5539
31 ,Tottori,over_85,1980,Showa,55,4409,1352,3057
31 ,Tottori,total,1985,Showa,60,616024,295511,320513
31 ,Tottori,0_ 4,1985,Showa,60,39644,20333,19311
31 ,Tottori,5_ 9,1985,Showa,60,43834,22470,21364
31 ,Tottori,10_ 14,1985,Showa,60,47190,24250,22940
31 ,Tottori,15_ 19,1985,Showa,60,38018,19701,18317
31 ,Tottori,20_ 24,1985,Showa,60,31793,15383,16410
31 ,Tottori,25_ 29,1985,Showa,60,37651,18342,19309
31 ,Tottori,30_ 34,1985,Showa,60,44718,22710,22008
31 ,Tottori,35_ 39,1985,Showa,60,49693,25227,24466
31 ,Tottori,40_ 44,1985,Showa,60,39652,19746,19906
31 ,Tottori,45_ 49,1985,Showa,60,38349,18366,19983
31 ,Tottori,50_ 54,1985,Showa,60,42793,20464,22329
31 ,Tottori,55_ 59,1985,Showa,60,42664,20087,22577
31 ,Tottori,60_ 64,1985,Showa,60,35386,15077,20309
31 ,Tottori,65_ 69,1985,Showa,60,27450,11258,16192
31 ,Tottori,70_ 74,1985,Showa,60,23562,9632,13930
31 ,Tottori,75_ 79,1985,Showa,60,16998,6716,10282
31 ,Tottori,80_ 84,1985,Showa,60,10300,3815,6485
31 ,Tottori,over_85,1985,Showa,60,6299,1917,4382
31 ,Tottori,total,1990,Heisei,2,615722,294899,320823
31 ,Tottori,0_ 4,1990,Heisei,2,34093,17458,16635
31 ,Tottori,5_ 9,1990,Heisei,2,40146,20535,19611
31 ,Tottori,10_ 14,1990,Heisei,2,43962,22531,21431
31 ,Tottori,15_ 19,1990,Heisei,2,42838,22202,20636
31 ,Tottori,20_ 24,1990,Heisei,2,29747,14693,15054
31 ,Tottori,25_ 29,1990,Heisei,2,33169,16031,17138
31 ,Tottori,30_ 34,1990,Heisei,2,38110,18795,19315
31 ,Tottori,35_ 39,1990,Heisei,2,44989,22917,22072
31 ,Tottori,40_ 44,1990,Heisei,2,49439,25140,24299
31 ,Tottori,45_ 49,1990,Heisei,2,38844,19280,19564
31 ,Tottori,50_ 54,1990,Heisei,2,37472,17768,19704
31 ,Tottori,55_ 59,1990,Heisei,2,41544,19650,21894
31 ,Tottori,60_ 64,1990,Heisei,2,41066,18990,22076
31 ,Tottori,65_ 69,1990,Heisei,2,33602,13983,19619
31 ,Tottori,70_ 74,1990,Heisei,2,25047,9792,15255
31 ,Tottori,75_ 79,1990,Heisei,2,20168,7736,12432
31 ,Tottori,80_ 84,1990,Heisei,2,12632,4504,8128
31 ,Tottori,over_85,1990,Heisei,2,8279,2533,5746
31 ,Tottori,total,1995,Heisei,7,614929,294414,320515
31 ,Tottori,0_ 4,1995,Heisei,7,29808,15227,14581
31 ,Tottori,5_ 9,1995,Heisei,7,35073,17923,17150
31 ,Tottori,10_ 14,1995,Heisei,7,40575,20791,19784
31 ,Tottori,15_ 19,1995,Heisei,7,40446,21077,19369
31 ,Tottori,20_ 24,1995,Heisei,7,35111,17955,17156
31 ,Tottori,25_ 29,1995,Heisei,7,31940,15714,16226
31 ,Tottori,30_ 34,1995,Heisei,7,34448,16866,17582
31 ,Tottori,35_ 39,1995,Heisei,7,38875,19305,19570
31 ,Tottori,40_ 44,1995,Heisei,7,45312,23122,22190
31 ,Tottori,45_ 49,1995,Heisei,7,49124,25027,24097
31 ,Tottori,50_ 54,1995,Heisei,7,38475,18937,19538
31 ,Tottori,55_ 59,1995,Heisei,7,36771,17284,19487
31 ,Tottori,60_ 64,1995,Heisei,7,40462,18780,21682
31 ,Tottori,65_ 69,1995,Heisei,7,39062,17573,21489
31 ,Tottori,70_ 74,1995,Heisei,7,30965,12287,18678
31 ,Tottori,75_ 79,1995,Heisei,7,21739,7961,13778
31 ,Tottori,80_ 84,1995,Heisei,7,15546,5279,10267
31 ,Tottori,over_85,1995,Heisei,7,11068,3223,7845
31 ,Tottori,total,2000,Heisei,12,613289,293403,319886
31 ,Tottori,0_ 4,2000,Heisei,12,27651,14201,13450
31 ,Tottori,5_ 9,2000,Heisei,12,30590,15555,15035
31 ,Tottori,10_ 14,2000,Heisei,12,35343,18049,17294
31 ,Tottori,15_ 19,2000,Heisei,12,36749,18963,17786
31 ,Tottori,20_ 24,2000,Heisei,12,33251,16934,16317
31 ,Tottori,25_ 29,2000,Heisei,12,38390,19418,18972
31 ,Tottori,30_ 34,2000,Heisei,12,33318,16520,16798
31 ,Tottori,35_ 39,2000,Heisei,12,35016,17214,17802
31 ,Tottori,40_ 44,2000,Heisei,12,39197,19528,19669
31 ,Tottori,45_ 49,2000,Heisei,12,45138,22984,22154
31 ,Tottori,50_ 54,2000,Heisei,12,48600,24621,23979
31 ,Tottori,55_ 59,2000,Heisei,12,37958,18536,19422
31 ,Tottori,60_ 64,2000,Heisei,12,36304,16899,19405
31 ,Tottori,65_ 69,2000,Heisei,12,38661,17510,21151
31 ,Tottori,70_ 74,2000,Heisei,12,36180,15659,20521
31 ,Tottori,75_ 79,2000,Heisei,12,27415,10282,17133
31 ,Tottori,80_ 84,2000,Heisei,12,17229,5737,11492
31 ,Tottori,over_85,2000,Heisei,12,15499,4261,11238
31 ,Tottori,total,2005,Heisei,17,607012,290190,316822
31 ,Tottori,0_ 4,2005,Heisei,17,26333,13372,12961
31 ,Tottori,5_ 9,2005,Heisei,17,27945,14347,13598
31 ,Tottori,10_ 14,2005,Heisei,17,30545,15565,14980
31 ,Tottori,15_ 19,2005,Heisei,17,32239,16797,15442
31 ,Tottori,20_ 24,2005,Heisei,17,31331,16397,14934
31 ,Tottori,25_ 29,2005,Heisei,17,35464,17954,17510
31 ,Tottori,30_ 34,2005,Heisei,17,38890,19617,19273
31 ,Tottori,35_ 39,2005,Heisei,17,33490,16548,16942
31 ,Tottori,40_ 44,2005,Heisei,17,35032,17222,17810
31 ,Tottori,45_ 49,2005,Heisei,17,38768,19263,19505
31 ,Tottori,50_ 54,2005,Heisei,17,44873,22733,22140
31 ,Tottori,55_ 59,2005,Heisei,17,48068,24157,23911
31 ,Tottori,60_ 64,2005,Heisei,17,37384,18060,19324
31 ,Tottori,65_ 69,2005,Heisei,17,35001,15975,19026
31 ,Tottori,70_ 74,2005,Heisei,17,36028,15809,20219
31 ,Tottori,75_ 79,2005,Heisei,17,32420,13255,19165
31 ,Tottori,80_ 84,2005,Heisei,17,22804,7749,15055
31 ,Tottori,over_85,2005,Heisei,17,19860,5030,14830
31 ,Tottori,total,2010,Heisei,22,588667,280701,307966
31 ,Tottori,0_ 4,2010,Heisei,22,24181,12415,11766
31 ,Tottori,5_ 9,2010,Heisei,22,26174,13244,12930
31 ,Tottori,10_ 14,2010,Heisei,22,27596,14198,13398
31 ,Tottori,15_ 19,2010,Heisei,22,27864,14390,13474
31 ,Tottori,20_ 24,2010,Heisei,22,24777,12887,11890
31 ,Tottori,25_ 29,2010,Heisei,22,30209,15215,14994
31 ,Tottori,30_ 34,2010,Heisei,22,34895,17583,17312
31 ,Tottori,35_ 39,2010,Heisei,22,38199,19220,18979
31 ,Tottori,40_ 44,2010,Heisei,22,32876,16243,16633
31 ,Tottori,45_ 49,2010,Heisei,22,34374,16865,17509
31 ,Tottori,50_ 54,2010,Heisei,22,37999,18744,19255
31 ,Tottori,55_ 59,2010,Heisei,22,43804,21931,21873
31 ,Tottori,60_ 64,2010,Heisei,22,47101,23358,23743
31 ,Tottori,65_ 69,2010,Heisei,22,35865,16992,18873
31 ,Tottori,70_ 74,2010,Heisei,22,32654,14380,18274
31 ,Tottori,75_ 79,2010,Heisei,22,32261,13347,18914
31 ,Tottori,80_ 84,2010,Heisei,22,26916,9914,17002
31 ,Tottori,over_85,2010,Heisei,22,25918,6754,19164
31 ,Tottori,total,2015,Heisei,27,573441,273705,299736
31 ,Tottori,0_ 4,2015,Heisei,27,22989,11656,11333
31 ,Tottori,5_ 9,2015,Heisei,27,24473,12571,11902
31 ,Tottori,10_ 14,2015,Heisei,27,26223,13312,12911
31 ,Tottori,15_ 19,2015,Heisei,27,26385,13918,12467
31 ,Tottori,20_ 24,2015,Heisei,27,22602,11702,10900
31 ,Tottori,25_ 29,2015,Heisei,27,25632,12969,12663
31 ,Tottori,30_ 34,2015,Heisei,27,30529,15335,15194
31 ,Tottori,35_ 39,2015,Heisei,27,35151,17771,17380
31 ,Tottori,40_ 44,2015,Heisei,27,38266,19221,19045
31 ,Tottori,45_ 49,2015,Heisei,27,32796,16234,16562
31 ,Tottori,50_ 54,2015,Heisei,27,34046,16672,17374
31 ,Tottori,55_ 59,2015,Heisei,27,37706,18514,19192
31 ,Tottori,60_ 64,2015,Heisei,27,43188,21426,21762
31 ,Tottori,65_ 69,2015,Heisei,27,45580,22270,23310
31 ,Tottori,70_ 74,2015,Heisei,27,33713,15539,18174
31 ,Tottori,75_ 79,2015,Heisei,27,29848,12549,17299
31 ,Tottori,80_ 84,2015,Heisei,27,27465,10389,17076
31 ,Tottori,over_85,2015,Heisei,27,32486,9162,23324
32 ,Shimane,total,1920,Taisho,9,714712,354959,359753
32 ,Shimane,0_ 4,1920,Taisho,9,86068,43470,42598
32 ,Shimane,5_ 9,1920,Taisho,9,80334,40793,39541
32 ,Shimane,10_ 14,1920,Taisho,9,70740,36323,34417
32 ,Shimane,15_ 19,1920,Taisho,9,55561,28104,27457
32 ,Shimane,20_ 24,1920,Taisho,9,51216,25581,25635
32 ,Shimane,25_ 29,1920,Taisho,9,44504,22099,22405
32 ,Shimane,30_ 34,1920,Taisho,9,43811,21691,22120
32 ,Shimane,35_ 39,1920,Taisho,9,44640,21757,22883
32 ,Shimane,40_ 44,1920,Taisho,9,45487,22430,23057
32 ,Shimane,45_ 49,1920,Taisho,9,40161,19679,20482
32 ,Shimane,50_ 54,1920,Taisho,9,36038,17847,18191
32 ,Shimane,55_ 59,1920,Taisho,9,29988,14856,15132
32 ,Shimane,60_ 64,1920,Taisho,9,29527,14325,15202
32 ,Shimane,65_ 69,1920,Taisho,9,23842,11531,12311
32 ,Shimane,70_ 74,1920,Taisho,9,16918,7819,9099
32 ,Shimane,75_ 79,1920,Taisho,9,10077,4376,5701
32 ,Shimane,over_80,1920,Taisho,9,5800,2278,3522
32 ,Shimane,total,1925,Taisho,14,722402,359987,362415
32 ,Shimane,0_ 4,1925,Taisho,14,91973,46502,45471
32 ,Shimane,5_ 9,1925,Taisho,14,79615,40327,39288
32 ,Shimane,10_ 14,1925,Taisho,14,75114,38741,36373
32 ,Shimane,15_ 19,1925,Taisho,14,57799,29758,28041
32 ,Shimane,20_ 24,1925,Taisho,14,49753,24897,24856
32 ,Shimane,25_ 29,1925,Taisho,14,47332,23638,23694
32 ,Shimane,30_ 34,1925,Taisho,14,41938,21158,20780
32 ,Shimane,35_ 39,1925,Taisho,14,41725,20874,20851
32 ,Shimane,40_ 44,1925,Taisho,14,42094,20773,21321
32 ,Shimane,45_ 49,1925,Taisho,14,42866,21142,21724
32 ,Shimane,50_ 54,1925,Taisho,14,37201,18201,19000
32 ,Shimane,55_ 59,1925,Taisho,14,32448,15909,16539
32 ,Shimane,60_ 64,1925,Taisho,14,25957,12592,13365
32 ,Shimane,65_ 69,1925,Taisho,14,23488,10995,12493
32 ,Shimane,70_ 74,1925,Taisho,14,16833,7807,9026
32 ,Shimane,75_ 79,1925,Taisho,14,10132,4322,5810
32 ,Shimane,80_ 84,1925,Taisho,14,4583,1800,2783
32 ,Shimane,over_85,1925,Taisho,14,1551,551,1000
32 ,Shimane,total,1930,Showa,5,739507,368888,370619
32 ,Shimane,0_ 4,1930,Showa,5,93713,47320,46393
32 ,Shimane,5_ 9,1930,Showa,5,85908,43513,42395
32 ,Shimane,10_ 14,1930,Showa,5,75843,38585,37258
32 ,Shimane,15_ 19,1930,Showa,5,62415,31960,30455
32 ,Shimane,20_ 24,1930,Showa,5,53315,27066,26249
32 ,Shimane,25_ 29,1930,Showa,5,47362,24101,23261
32 ,Shimane,30_ 34,1930,Showa,5,45507,23104,22403
32 ,Shimane,35_ 39,1930,Showa,5,40487,20537,19950
32 ,Shimane,40_ 44,1930,Showa,5,39720,20001,19719
32 ,Shimane,45_ 49,1930,Showa,5,39882,19600,20282
32 ,Shimane,50_ 54,1930,Showa,5,39893,19627,20266
32 ,Shimane,55_ 59,1930,Showa,5,33515,16347,17168
32 ,Shimane,60_ 64,1930,Showa,5,28016,13435,14581
32 ,Shimane,65_ 69,1930,Showa,5,20712,9722,10990
32 ,Shimane,70_ 74,1930,Showa,5,16797,7408,9389
32 ,Shimane,75_ 79,1930,Showa,5,10108,4301,5807
32 ,Shimane,over_80,1930,Showa,5,6314,2261,4053
32 ,Shimane,total,1935,Showa,10,747119,373292,373827
32 ,Shimane,0_ 4,1935,Showa,10,96047,48965,47082
32 ,Shimane,5_ 9,1935,Showa,10,87903,44378,43525
32 ,Shimane,10_ 14,1935,Showa,10,81245,41728,39517
32 ,Shimane,15_ 19,1935,Showa,10,58696,30220,28476
32 ,Shimane,20_ 24,1935,Showa,10,53380,26547,26833
32 ,Shimane,25_ 29,1935,Showa,10,48551,24207,24344
32 ,Shimane,30_ 34,1935,Showa,10,45270,23087,22183
32 ,Shimane,35_ 39,1935,Showa,10,43421,22227,21194
32 ,Shimane,40_ 44,1935,Showa,10,38379,19655,18724
32 ,Shimane,45_ 49,1935,Showa,10,37538,18956,18582
32 ,Shimane,50_ 54,1935,Showa,10,37140,18231,18909
32 ,Shimane,55_ 59,1935,Showa,10,36006,17460,18546
32 ,Shimane,60_ 64,1935,Showa,10,29124,13859,15265
32 ,Shimane,65_ 69,1935,Showa,10,22418,10322,12096
32 ,Shimane,70_ 74,1935,Showa,10,15034,6739,8295
32 ,Shimane,75_ 79,1935,Showa,10,10254,4263,5991
32 ,Shimane,over_80,1935,Showa,10,6713,2448,4265
32 ,Shimane,total,1940,Showa,15,740817,367780,373037
32 ,Shimane,0_ 4,1940,Showa,15,88554,44760,43794
32 ,Shimane,5_ 9,1940,Showa,15,88782,45146,43636
32 ,Shimane,10_ 14,1940,Showa,15,83230,42216,41014
32 ,Shimane,15_ 19,1940,Showa,15,61438,30921,30517
32 ,Shimane,20_ 24,1940,Showa,15,53399,27545,25854
32 ,Shimane,25_ 29,1940,Showa,15,48219,23601,24618
32 ,Shimane,30_ 34,1940,Showa,15,44506,21652,22854
32 ,Shimane,35_ 39,1940,Showa,15,42053,21283,20770
32 ,Shimane,40_ 44,1940,Showa,15,40545,20569,19976
32 ,Shimane,45_ 49,1940,Showa,15,35950,18200,17750
32 ,Shimane,50_ 54,1940,Showa,15,34675,17406,17269
32 ,Shimane,55_ 59,1940,Showa,15,33442,16128,17314
32 ,Shimane,60_ 64,1940,Showa,15,31017,14658,16359
32 ,Shimane,65_ 69,1940,Showa,15,23374,10677,12697
32 ,Shimane,70_ 74,1940,Showa,15,16029,6903,9126
32 ,Shimane,75_ 79,1940,Showa,15,9052,3744,5308
32 ,Shimane,80_ 84,1940,Showa,15,4725,1779,2946
32 ,Shimane,over_85,1940,Showa,15,1825,591,1234
32 ,Shimane,total,1945,Showa,20,860275,395360,464915
32 ,Shimane,1_ 5,1945,Showa,20,112056,56933,55123
32 ,Shimane,6_ 10,1945,Showa,20,102957,52025,50932
32 ,Shimane,11_ 15,1945,Showa,20,103299,52503,50796
32 ,Shimane,16_ 20,1945,Showa,20,83948,39516,44432
32 ,Shimane,21_ 25,1945,Showa,20,58803,19709,39094
32 ,Shimane,26_ 30,1945,Showa,20,49499,16674,32825
32 ,Shimane,31_ 35,1945,Showa,20,48120,17164,30956
32 ,Shimane,36_ 40,1945,Showa,20,45142,17996,27146
32 ,Shimane,41_ 45,1945,Showa,20,46267,22813,23454
32 ,Shimane,46_ 50,1945,Showa,20,44318,22438,21880
32 ,Shimane,51_ 55,1945,Showa,20,37859,19138,18721
32 ,Shimane,56_ 60,1945,Showa,20,35009,17336,17673
32 ,Shimane,61_ 65,1945,Showa,20,31147,14649,16498
32 ,Shimane,66_ 70,1945,Showa,20,26677,12052,14625
32 ,Shimane,71_ 75,1945,Showa,20,18567,8074,10493
32 ,Shimane,76_ 80,1945,Showa,20,10193,4034,6159
32 ,Shimane,81_ 85,1945,Showa,20,4508,1683,2825
32 ,Shimane,86以上,1945,Showa,20,1906,623,1283
32 ,Shimane,total,1950,Showa,25,912551,444355,468196
32 ,Shimane,0_ 4,1950,Showa,25,124079,63528,60551
32 ,Shimane,5_ 9,1950,Showa,25,104285,52899,51386
32 ,Shimane,10_ 14,1950,Showa,25,95500,48289,47211
32 ,Shimane,15_ 19,1950,Showa,25,85722,44732,40990
32 ,Shimane,20_ 24,1950,Showa,25,73378,34963,38415
32 ,Shimane,25_ 29,1950,Showa,25,62869,28391,34478
32 ,Shimane,30_ 34,1950,Showa,25,53652,23945,29707
32 ,Shimane,35_ 39,1950,Showa,25,51532,23083,28449
32 ,Shimane,40_ 44,1950,Showa,25,46432,21520,24912
32 ,Shimane,45_ 49,1950,Showa,25,44003,22123,21880
32 ,Shimane,50_ 54,1950,Showa,25,40842,20759,20083
32 ,Shimane,55_ 59,1950,Showa,25,34466,17291,17175
32 ,Shimane,60_ 64,1950,Showa,25,30791,14976,15815
32 ,Shimane,65_ 69,1950,Showa,25,25780,11761,14019
32 ,Shimane,70_ 74,1950,Showa,25,19876,8591,11285
32 ,Shimane,75_ 79,1950,Showa,25,11768,4811,6957
32 ,Shimane,over_80,1950,Showa,25,7557,2688,4869
32 ,Shimane,total,1955,Showa,30,929066,456730,472336
32 ,Shimane,0_ 4,1955,Showa,30,95321,48955,46366
32 ,Shimane,5_ 9,1955,Showa,30,119435,61159,58276
32 ,Shimane,10_ 14,1955,Showa,30,101415,51396,50019
32 ,Shimane,15_ 19,1955,Showa,30,77344,40549,36795
32 ,Shimane,20_ 24,1955,Showa,30,75171,37908,37263
32 ,Shimane,25_ 29,1955,Showa,30,71152,34779,36373
32 ,Shimane,30_ 34,1955,Showa,30,61115,28133,32982
32 ,Shimane,35_ 39,1955,Showa,30,51992,23434,28558
32 ,Shimane,40_ 44,1955,Showa,30,49687,22521,27166
32 ,Shimane,45_ 49,1955,Showa,30,44725,20955,23770
32 ,Shimane,50_ 54,1955,Showa,30,42018,21266,20752
32 ,Shimane,55_ 59,1955,Showa,30,38323,19509,18814
32 ,Shimane,60_ 64,1955,Showa,30,31203,15524,15679
32 ,Shimane,65_ 69,1955,Showa,30,26254,12502,13752
32 ,Shimane,70_ 74,1955,Showa,30,20551,9073,11478
32 ,Shimane,75_ 79,1955,Showa,30,13837,5663,8174
32 ,Shimane,80_ 84,1955,Showa,30,6760,2543,4217
32 ,Shimane,over_85,1955,Showa,30,2754,856,1898
32 ,Shimane,total,1960,Showa,35,888886,432481,456405
32 ,Shimane,0_ 4,1960,Showa,35,72500,37060,35440
32 ,Shimane,5_ 9,1960,Showa,35,93089,47713,45376
32 ,Shimane,10_ 14,1960,Showa,35,117007,59904,57103
32 ,Shimane,15_ 19,1960,Showa,35,67581,35546,32035
32 ,Shimane,20_ 24,1960,Showa,35,56643,26502,30141
32 ,Shimane,25_ 29,1960,Showa,35,68036,33057,34979
32 ,Shimane,30_ 34,1960,Showa,35,67490,32700,34790
32 ,Shimane,35_ 39,1960,Showa,35,58492,26719,31773
32 ,Shimane,40_ 44,1960,Showa,35,49741,22195,27546
32 ,Shimane,45_ 49,1960,Showa,35,47261,21224,26037
32 ,Shimane,50_ 54,1960,Showa,35,42272,19672,22600
32 ,Shimane,55_ 59,1960,Showa,35,39304,19666,19638
32 ,Shimane,60_ 64,1960,Showa,35,34753,17356,17397
32 ,Shimane,65_ 69,1960,Showa,35,27132,13148,13984
32 ,Shimane,70_ 74,1960,Showa,35,21147,9719,11428
32 ,Shimane,75_ 79,1960,Showa,35,14698,6106,8592
32 ,Shimane,80_ 84,1960,Showa,35,8107,3039,5068
32 ,Shimane,over_85,1960,Showa,35,3633,1155,2478
32 ,Shimane,total,1965,Showa,40,821620,393670,427950
32 ,Shimane,0_ 4,1965,Showa,40,59331,30124,29207
32 ,Shimane,5_ 9,1965,Showa,40,69219,35235,33984
32 ,Shimane,10_ 14,1965,Showa,40,89853,45944,43909
32 ,Shimane,15_ 19,1965,Showa,40,78566,40773,37793
32 ,Shimane,20_ 24,1965,Showa,40,45483,19953,25530
32 ,Shimane,25_ 29,1965,Showa,40,50893,23361,27532
32 ,Shimane,30_ 34,1965,Showa,40,62934,30438,32496
32 ,Shimane,35_ 39,1965,Showa,40,63692,30475,33217
32 ,Shimane,40_ 44,1965,Showa,40,55702,25211,30491
32 ,Shimane,45_ 49,1965,Showa,40,47133,20906,26227
32 ,Shimane,50_ 54,1965,Showa,40,44142,19677,24465
32 ,Shimane,55_ 59,1965,Showa,40,39213,18070,21143
32 ,Shimane,60_ 64,1965,Showa,40,35528,17538,17990
32 ,Shimane,65_ 69,1965,Showa,40,30124,14684,15440
32 ,Shimane,70_ 74,1965,Showa,40,21975,10201,11774
32 ,Shimane,75_ 79,1965,Showa,40,15177,6570,8607
32 ,Shimane,80_ 84,1965,Showa,40,8282,3123,5159
32 ,Shimane,over_85,1965,Showa,40,4373,1387,2986
32 ,Shimane,total,1970,Showa,45,773575,367658,405917
32 ,Shimane,0_ 4,1970,Showa,45,52296,26992,25304
32 ,Shimane,5_ 9,1970,Showa,45,58285,29593,28692
32 ,Shimane,10_ 14,1970,Showa,45,67876,34572,33304
32 ,Shimane,15_ 19,1970,Showa,45,62425,31966,30459
32 ,Shimane,20_ 24,1970,Showa,45,51575,23072,28503
32 ,Shimane,25_ 29,1970,Showa,45,45640,21206,24434
32 ,Shimane,30_ 34,1970,Showa,45,49761,23329,26432
32 ,Shimane,35_ 39,1970,Showa,45,61111,29538,31573
32 ,Shimane,40_ 44,1970,Showa,45,61693,29487,32206
32 ,Shimane,45_ 49,1970,Showa,45,53451,24102,29349
32 ,Shimane,50_ 54,1970,Showa,45,44959,19867,25092
32 ,Shimane,55_ 59,1970,Showa,45,41425,18359,23066
32 ,Shimane,60_ 64,1970,Showa,45,36133,16345,19788
32 ,Shimane,65_ 69,1970,Showa,45,31598,15202,16396
32 ,Shimane,70_ 74,1970,Showa,45,25041,11732,13309
32 ,Shimane,75_ 79,1970,Showa,45,16108,7070,9038
32 ,Shimane,80_ 84,1970,Showa,45,9194,3635,5559
32 ,Shimane,over_85,1970,Showa,45,5004,1591,3413
32 ,Shimane,total,1975,Showa,50,768886,367060,401826
32 ,Shimane,0_ 4,1975,Showa,50,56482,28913,27569
32 ,Shimane,5_ 9,1975,Showa,50,53313,27570,25743
32 ,Shimane,10_ 14,1975,Showa,50,58277,29611,28666
32 ,Shimane,15_ 19,1975,Showa,50,53285,27283,26002
32 ,Shimane,20_ 24,1975,Showa,50,42692,19995,22697
32 ,Shimane,25_ 29,1975,Showa,50,56957,28264,28693
32 ,Shimane,30_ 34,1975,Showa,50,47266,22777,24489
32 ,Shimane,35_ 39,1975,Showa,50,49946,23689,26257
32 ,Shimane,40_ 44,1975,Showa,50,60487,29262,31225
32 ,Shimane,45_ 49,1975,Showa,50,60291,28700,31591
32 ,Shimane,50_ 54,1975,Showa,50,51718,23204,28514
32 ,Shimane,55_ 59,1975,Showa,50,43043,18869,24174
32 ,Shimane,60_ 64,1975,Showa,50,39256,17169,22087
32 ,Shimane,65_ 69,1975,Showa,50,33120,14564,18556
32 ,Shimane,70_ 74,1975,Showa,50,27176,12526,14650
32 ,Shimane,75_ 79,1975,Showa,50,19337,8492,10845
32 ,Shimane,80_ 84,1975,Showa,50,10376,4202,6174
32 ,Shimane,over_85,1975,Showa,50,5822,1945,3877
32 ,Shimane,total,1980,Showa,55,784795,377499,407296
32 ,Shimane,0_ 4,1980,Showa,55,53087,27385,25702
32 ,Shimane,5_ 9,1980,Showa,55,59654,30553,29101
32 ,Shimane,10_ 14,1980,Showa,55,54569,28186,26383
32 ,Shimane,15_ 19,1980,Showa,55,48697,25135,23562
32 ,Shimane,20_ 24,1980,Showa,55,37811,18243,19568
32 ,Shimane,25_ 29,1980,Showa,55,51193,25786,25407
32 ,Shimane,30_ 34,1980,Showa,55,61418,31564,29854
32 ,Shimane,35_ 39,1980,Showa,55,49154,24040,25114
32 ,Shimane,40_ 44,1980,Showa,55,50386,24059,26327
32 ,Shimane,45_ 49,1980,Showa,55,59996,29007,30989
32 ,Shimane,50_ 54,1980,Showa,55,59418,28161,31257
32 ,Shimane,55_ 59,1980,Showa,55,50488,22474,28014
32 ,Shimane,60_ 64,1980,Showa,55,41377,17908,23469
32 ,Shimane,65_ 69,1980,Showa,55,36658,15715,20943
32 ,Shimane,70_ 74,1980,Showa,55,29092,12286,16806
32 ,Shimane,75_ 79,1980,Showa,55,21625,9319,12306
32 ,Shimane,80_ 84,1980,Showa,55,13047,5216,7831
32 ,Shimane,over_85,1980,Showa,55,7057,2415,4642
32 ,Shimane,total,1985,Showa,60,794629,382893,411736
32 ,Shimane,0_ 4,1985,Showa,60,47830,24386,23444
32 ,Shimane,5_ 9,1985,Showa,60,54546,28201,26345
32 ,Shimane,10_ 14,1985,Showa,60,60441,30918,29523
32 ,Shimane,15_ 19,1985,Showa,60,48045,25054,22991
32 ,Shimane,20_ 24,1985,Showa,60,35181,16929,18252
32 ,Shimane,25_ 29,1985,Showa,60,44215,22025,22190
32 ,Shimane,30_ 34,1985,Showa,60,53603,27591,26012
32 ,Shimane,35_ 39,1985,Showa,60,63029,32622,30407
32 ,Shimane,40_ 44,1985,Showa,60,49564,24404,25160
32 ,Shimane,45_ 49,1985,Showa,60,50151,24007,26144
32 ,Shimane,50_ 54,1985,Showa,60,59192,28481,30711
32 ,Shimane,55_ 59,1985,Showa,60,58171,27353,30818
32 ,Shimane,60_ 64,1985,Showa,60,48903,21512,27391
32 ,Shimane,65_ 69,1985,Showa,60,39022,16573,22449
32 ,Shimane,70_ 74,1985,Showa,60,33163,13704,19459
32 ,Shimane,75_ 79,1985,Showa,60,24400,9661,14739
32 ,Shimane,80_ 84,1985,Showa,60,15301,6052,9249
32 ,Shimane,over_85,1985,Showa,60,9858,3412,6446
32 ,Shimane,total,1990,Heisei,2,781021,373618,407403
32 ,Shimane,0_ 4,1990,Heisei,2,40947,20977,19970
32 ,Shimane,5_ 9,1990,Heisei,2,48131,24639,23492
32 ,Shimane,10_ 14,1990,Heisei,2,54806,28257,26549
32 ,Shimane,15_ 19,1990,Heisei,2,52708,27228,25480
32 ,Shimane,20_ 24,1990,Heisei,2,32550,15488,17062
32 ,Shimane,25_ 29,1990,Heisei,2,38009,18216,19793
32 ,Shimane,30_ 34,1990,Heisei,2,44392,22218,22174
32 ,Shimane,35_ 39,1990,Heisei,2,53337,27369,25968
32 ,Shimane,40_ 44,1990,Heisei,2,62386,32126,30260
32 ,Shimane,45_ 49,1990,Heisei,2,48378,23579,24799
32 ,Shimane,50_ 54,1990,Heisei,2,48737,23021,25716
32 ,Shimane,55_ 59,1990,Heisei,2,57542,27306,30236
32 ,Shimane,60_ 64,1990,Heisei,2,56214,25946,30268
32 ,Shimane,65_ 69,1990,Heisei,2,46331,19928,26403
32 ,Shimane,70_ 74,1990,Heisei,2,35830,14712,21118
32 ,Shimane,75_ 79,1990,Heisei,2,28549,11113,17436
32 ,Shimane,80_ 84,1990,Heisei,2,18381,6626,11755
32 ,Shimane,over_85,1990,Heisei,2,12970,4322,8648
32 ,Shimane,total,1995,Heisei,7,771441,368789,402652
32 ,Shimane,0_ 4,1995,Heisei,7,35861,18236,17625
32 ,Shimane,5_ 9,1995,Heisei,7,41917,21451,20466
32 ,Shimane,10_ 14,1995,Heisei,7,48625,24878,23747
32 ,Shimane,15_ 19,1995,Heisei,7,48567,25516,23051
32 ,Shimane,20_ 24,1995,Heisei,7,38208,18771,19437
32 ,Shimane,25_ 29,1995,Heisei,7,37048,18209,18839
32 ,Shimane,30_ 34,1995,Heisei,7,39807,19505,20302
32 ,Shimane,35_ 39,1995,Heisei,7,45572,23022,22550
32 ,Shimane,40_ 44,1995,Heisei,7,54008,27881,26127
32 ,Shimane,45_ 49,1995,Heisei,7,62274,32180,30094
32 ,Shimane,50_ 54,1995,Heisei,7,48122,23428,24694
32 ,Shimane,55_ 59,1995,Heisei,7,48259,22606,25653
32 ,Shimane,60_ 64,1995,Heisei,7,56054,26263,29791
32 ,Shimane,65_ 69,1995,Heisei,7,53504,24064,29440
32 ,Shimane,70_ 74,1995,Heisei,7,43066,17826,25240
32 ,Shimane,75_ 79,1995,Heisei,7,31222,11967,19255
32 ,Shimane,80_ 84,1995,Heisei,7,22105,7846,14259
32 ,Shimane,over_85,1995,Heisei,7,17143,5086,12057
32 ,Shimane,total,2000,Heisei,12,761503,363994,397509
32 ,Shimane,0_ 4,2000,Heisei,12,33163,16988,16175
32 ,Shimane,5_ 9,2000,Heisei,12,36572,18639,17933
32 ,Shimane,10_ 14,2000,Heisei,12,42247,21578,20669
32 ,Shimane,15_ 19,2000,Heisei,12,43466,22559,20907
32 ,Shimane,20_ 24,2000,Heisei,12,36684,18551,18133
32 ,Shimane,25_ 29,2000,Heisei,12,43666,21946,21720
32 ,Shimane,30_ 34,2000,Heisei,12,38900,19467,19433
32 ,Shimane,35_ 39,2000,Heisei,12,40832,20191,20641
32 ,Shimane,40_ 44,2000,Heisei,12,45952,23251,22701
32 ,Shimane,45_ 49,2000,Heisei,12,53778,27785,25993
32 ,Shimane,50_ 54,2000,Heisei,12,61617,31695,29922
32 ,Shimane,55_ 59,2000,Heisei,12,47627,22898,24729
32 ,Shimane,60_ 64,2000,Heisei,12,47581,22001,25580
32 ,Shimane,65_ 69,2000,Heisei,12,53627,24587,29040
32 ,Shimane,70_ 74,2000,Heisei,12,49719,21568,28151
32 ,Shimane,75_ 79,2000,Heisei,12,38230,14860,23370
32 ,Shimane,80_ 84,2000,Heisei,12,25056,8713,16343
32 ,Shimane,over_85,2000,Heisei,12,22399,6471,15928
32 ,Shimane,total,2005,Heisei,17,742223,353703,388520
32 ,Shimane,0_ 4,2005,Heisei,17,30716,15710,15006
32 ,Shimane,5_ 9,2005,Heisei,17,33298,17062,16236
32 ,Shimane,10_ 14,2005,Heisei,17,36528,18632,17896
32 ,Shimane,15_ 19,2005,Heisei,17,37868,19788,18080
32 ,Shimane,20_ 24,2005,Heisei,17,32425,16239,16186
32 ,Shimane,25_ 29,2005,Heisei,17,39132,19844,19288
32 ,Shimane,30_ 34,2005,Heisei,17,44281,22314,21967
32 ,Shimane,35_ 39,2005,Heisei,17,38634,19318,19316
32 ,Shimane,40_ 44,2005,Heisei,17,40429,19921,20508
32 ,Shimane,45_ 49,2005,Heisei,17,45315,22860,22455
32 ,Shimane,50_ 54,2005,Heisei,17,53199,27270,25929
32 ,Shimane,55_ 59,2005,Heisei,17,61086,31116,29970
32 ,Shimane,60_ 64,2005,Heisei,17,47102,22475,24627
32 ,Shimane,65_ 69,2005,Heisei,17,45996,20961,25035
32 ,Shimane,70_ 74,2005,Heisei,17,50243,22301,27942
32 ,Shimane,75_ 79,2005,Heisei,17,44457,18203,26254
32 ,Shimane,80_ 84,2005,Heisei,17,31556,11153,20403
32 ,Shimane,over_85,2005,Heisei,17,28851,7857,20994
32 ,Shimane,total,2010,Heisei,22,717397,342991,374406
32 ,Shimane,0_ 4,2010,Heisei,22,28425,14519,13906
32 ,Shimane,5_ 9,2010,Heisei,22,30802,15734,15068
32 ,Shimane,10_ 14,2010,Heisei,22,32991,16892,16099
32 ,Shimane,15_ 19,2010,Heisei,22,32899,17111,15788
32 ,Shimane,20_ 24,2010,Heisei,22,26948,13464,13484
32 ,Shimane,25_ 29,2010,Heisei,22,33126,16779,16347
32 ,Shimane,30_ 34,2010,Heisei,22,39645,20414,19231
32 ,Shimane,35_ 39,2010,Heisei,22,44443,22758,21685
32 ,Shimane,40_ 44,2010,Heisei,22,38770,19583,19187
32 ,Shimane,45_ 49,2010,Heisei,22,40234,20000,20234
32 ,Shimane,50_ 54,2010,Heisei,22,45061,22854,22207
32 ,Shimane,55_ 59,2010,Heisei,22,52610,26896,25714
32 ,Shimane,60_ 64,2010,Heisei,22,60417,30526,29891
32 ,Shimane,65_ 69,2010,Heisei,22,45463,21343,24120
32 ,Shimane,70_ 74,2010,Heisei,22,43199,19121,24078
32 ,Shimane,75_ 79,2010,Heisei,22,45225,19063,26162
32 ,Shimane,80_ 84,2010,Heisei,22,36979,13795,23184
32 ,Shimane,over_85,2010,Heisei,22,36532,9955,26577
32 ,Shimane,total,2015,Heisei,27,694352,333112,361240
32 ,Shimane,0_ 4,2015,Heisei,27,26929,13880,13049
32 ,Shimane,5_ 9,2015,Heisei,27,28598,14625,13973
32 ,Shimane,10_ 14,2015,Heisei,27,30529,15610,14919
32 ,Shimane,15_ 19,2015,Heisei,27,31126,16385,14741
32 ,Shimane,20_ 24,2015,Heisei,27,24854,12763,12091
32 ,Shimane,25_ 29,2015,Heisei,27,28673,14645,14028
32 ,Shimane,30_ 34,2015,Heisei,27,33915,17238,16677
32 ,Shimane,35_ 39,2015,Heisei,27,39702,20397,19305
32 ,Shimane,40_ 44,2015,Heisei,27,44224,22510,21714
32 ,Shimane,45_ 49,2015,Heisei,27,38299,19288,19011
32 ,Shimane,50_ 54,2015,Heisei,27,39816,19752,20064
32 ,Shimane,55_ 59,2015,Heisei,27,44427,22360,22067
32 ,Shimane,60_ 64,2015,Heisei,27,51841,26151,25690
32 ,Shimane,65_ 69,2015,Heisei,27,58378,29027,29351
32 ,Shimane,70_ 74,2015,Heisei,27,42872,19641,23231
32 ,Shimane,75_ 79,2015,Heisei,27,39199,16655,22544
32 ,Shimane,80_ 84,2015,Heisei,27,38046,14805,23241
32 ,Shimane,over_85,2015,Heisei,27,44153,12395,31758
33 ,Okayama,total,1920,Taisho,9,1217698,605316,612382
33 ,Okayama,0_ 4,1920,Taisho,9,142591,72274,70317
33 ,Okayama,5_ 9,1920,Taisho,9,140210,71185,69025
33 ,Okayama,10_ 14,1920,Taisho,9,131252,66078,65174
33 ,Okayama,15_ 19,1920,Taisho,9,114942,55352,59590
33 ,Okayama,20_ 24,1920,Taisho,9,95378,46680,48698
33 ,Okayama,25_ 29,1920,Taisho,9,75450,38050,37400
33 ,Okayama,30_ 34,1920,Taisho,9,70276,34953,35323
33 ,Okayama,35_ 39,1920,Taisho,9,74453,36583,37870
33 ,Okayama,40_ 44,1920,Taisho,9,74799,37308,37491
33 ,Okayama,45_ 49,1920,Taisho,9,65289,32878,32411
33 ,Okayama,50_ 54,1920,Taisho,9,58100,29374,28726
33 ,Okayama,55_ 59,1920,Taisho,9,48595,24394,24201
33 ,Okayama,60_ 64,1920,Taisho,9,45601,22870,22731
33 ,Okayama,65_ 69,1920,Taisho,9,36121,17467,18654
33 ,Okayama,70_ 74,1920,Taisho,9,24161,11355,12806
33 ,Okayama,75_ 79,1920,Taisho,9,13450,5790,7660
33 ,Okayama,over_80,1920,Taisho,9,7030,2725,4305
33 ,Okayama,total,1925,Taisho,14,1238447,613619,624828
33 ,Okayama,0_ 4,1925,Taisho,14,152663,76987,75676
33 ,Okayama,5_ 9,1925,Taisho,14,133918,67772,66146
33 ,Okayama,10_ 14,1925,Taisho,14,136473,68370,68103
33 ,Okayama,15_ 19,1925,Taisho,14,117647,56917,60730
33 ,Okayama,20_ 24,1925,Taisho,14,95239,45475,49764
33 ,Okayama,25_ 29,1925,Taisho,14,86744,43401,43343
33 ,Okayama,30_ 34,1925,Taisho,14,70562,36008,34554
33 ,Okayama,35_ 39,1925,Taisho,14,66671,33434,33237
33 ,Okayama,40_ 44,1925,Taisho,14,70402,34976,35426
33 ,Okayama,45_ 49,1925,Taisho,14,70374,35190,35184
33 ,Okayama,50_ 54,1925,Taisho,14,60802,30486,30316
33 ,Okayama,55_ 59,1925,Taisho,14,52054,26114,25940
33 ,Okayama,60_ 64,1925,Taisho,14,41681,20531,21150
33 ,Okayama,65_ 69,1925,Taisho,14,35920,17365,18555
33 ,Okayama,70_ 74,1925,Taisho,14,25459,11650,13809
33 ,Okayama,75_ 79,1925,Taisho,14,14111,6061,8050
33 ,Okayama,80_ 84,1925,Taisho,14,5995,2320,3675
33 ,Okayama,over_85,1925,Taisho,14,1732,562,1170
33 ,Okayama,total,1930,Showa,5,1283962,637965,645997
33 ,Okayama,0_ 4,1930,Showa,5,160218,81045,79173
33 ,Okayama,5_ 9,1930,Showa,5,143919,72566,71353
33 ,Okayama,10_ 14,1930,Showa,5,129942,65316,64626
33 ,Okayama,15_ 19,1930,Showa,5,123230,59835,63395
33 ,Okayama,20_ 24,1930,Showa,5,100616,48810,51806
33 ,Okayama,25_ 29,1930,Showa,5,91875,45942,45933
33 ,Okayama,30_ 34,1930,Showa,5,84115,42905,41210
33 ,Okayama,35_ 39,1930,Showa,5,68443,35265,33178
33 ,Okayama,40_ 44,1930,Showa,5,64068,32419,31649
33 ,Okayama,45_ 49,1930,Showa,5,67216,33381,33835
33 ,Okayama,50_ 54,1930,Showa,5,65452,32719,32733
33 ,Okayama,55_ 59,1930,Showa,5,55319,27499,27820
33 ,Okayama,60_ 64,1930,Showa,5,45622,22437,23185
33 ,Okayama,65_ 69,1930,Showa,5,33731,16113,17618
33 ,Okayama,70_ 74,1930,Showa,5,26023,11995,14028
33 ,Okayama,75_ 79,1930,Showa,5,15372,6498,8874
33 ,Okayama,over_80,1930,Showa,5,8801,3220,5581
33 ,Okayama,total,1935,Showa,10,1332647,658773,673874
33 ,Okayama,0_ 4,1935,Showa,10,163709,82889,80820
33 ,Okayama,5_ 9,1935,Showa,10,153078,77412,75666
33 ,Okayama,10_ 14,1935,Showa,10,142559,70741,71818
33 ,Okayama,15_ 19,1935,Showa,10,118699,55569,63130
33 ,Okayama,20_ 24,1935,Showa,10,104618,49250,55368
33 ,Okayama,25_ 29,1935,Showa,10,95192,48067,47125
33 ,Okayama,30_ 34,1935,Showa,10,88018,44301,43717
33 ,Okayama,35_ 39,1935,Showa,10,81070,41599,39471
33 ,Okayama,40_ 44,1935,Showa,10,65783,33998,31785
33 ,Okayama,45_ 49,1935,Showa,10,61028,31038,29990
33 ,Okayama,50_ 54,1935,Showa,10,62747,31123,31624
33 ,Okayama,55_ 59,1935,Showa,10,60079,29795,30284
33 ,Okayama,60_ 64,1935,Showa,10,48430,23735,24695
33 ,Okayama,65_ 69,1935,Showa,10,37154,17681,19473
33 ,Okayama,70_ 74,1935,Showa,10,24692,11240,13452
33 ,Okayama,75_ 79,1935,Showa,10,15829,6801,9028
33 ,Okayama,over_80,1935,Showa,10,9962,3534,6428
33 ,Okayama,total,1940,Showa,15,1329012,650998,678014
33 ,Okayama,0_ 4,1940,Showa,15,147551,74810,72741
33 ,Okayama,5_ 9,1940,Showa,15,154545,78248,76297
33 ,Okayama,10_ 14,1940,Showa,15,149204,74368,74836
33 ,Okayama,15_ 19,1940,Showa,15,122521,55258,67263
33 ,Okayama,20_ 24,1940,Showa,15,98709,47767,50942
33 ,Okayama,25_ 29,1940,Showa,15,92753,44751,48002
33 ,Okayama,30_ 34,1940,Showa,15,86856,42855,44001
33 ,Okayama,35_ 39,1940,Showa,15,82134,40609,41525
33 ,Okayama,40_ 44,1940,Showa,15,76249,38703,37546
33 ,Okayama,45_ 49,1940,Showa,15,61696,31522,30174
33 ,Okayama,50_ 54,1940,Showa,15,56569,28405,28164
33 ,Okayama,55_ 59,1940,Showa,15,56699,27770,28929
33 ,Okayama,60_ 64,1940,Showa,15,52537,25388,27149
33 ,Okayama,65_ 69,1940,Showa,15,39428,18635,20793
33 ,Okayama,70_ 74,1940,Showa,15,26842,12037,14805
33 ,Okayama,75_ 79,1940,Showa,15,14846,6265,8581
33 ,Okayama,80_ 84,1940,Showa,15,7076,2729,4347
33 ,Okayama,over_85,1940,Showa,15,2777,865,1912
33 ,Okayama,total,1945,Showa,20,1564626,728314,836312
33 ,Okayama,1_ 5,1945,Showa,20,200401,101711,98690
33 ,Okayama,6_ 10,1945,Showa,20,176434,89190,87244
33 ,Okayama,11_ 15,1945,Showa,20,180600,91384,89216
33 ,Okayama,16_ 20,1945,Showa,20,155282,73491,81791
33 ,Okayama,21_ 25,1945,Showa,20,109425,39012,70413
33 ,Okayama,26_ 30,1945,Showa,20,91223,31237,59986
33 ,Okayama,31_ 35,1945,Showa,20,98668,39729,58939
33 ,Okayama,36_ 40,1945,Showa,20,95267,42489,52778
33 ,Okayama,41_ 45,1945,Showa,20,90834,44002,46832
33 ,Okayama,46_ 50,1945,Showa,20,83621,42001,41620
33 ,Okayama,51_ 55,1945,Showa,20,65754,33638,32116
33 ,Okayama,56_ 60,1945,Showa,20,58557,28987,29570
33 ,Okayama,61_ 65,1945,Showa,20,53588,25361,28227
33 ,Okayama,66_ 70,1945,Showa,20,46546,21436,25110
33 ,Okayama,71_ 75,1945,Showa,20,31892,14152,17740
33 ,Okayama,76_ 80,1945,Showa,20,16868,6943,9925
33 ,Okayama,81_ 85,1945,Showa,20,7101,2708,4393
33 ,Okayama,86以上,1945,Showa,20,2565,843,1722
33 ,Okayama,total,1950,Showa,25,1661099,804357,856742
33 ,Okayama,0_ 4,1950,Showa,25,210515,107422,103093
33 ,Okayama,5_ 9,1950,Showa,25,187860,95241,92619
33 ,Okayama,10_ 14,1950,Showa,25,163669,82839,80830
33 ,Okayama,15_ 19,1950,Showa,25,168321,81814,86507
33 ,Okayama,20_ 24,1950,Showa,25,141509,66920,74589
33 ,Okayama,25_ 29,1950,Showa,25,113551,50620,62931
33 ,Okayama,30_ 34,1950,Showa,25,97622,42833,54789
33 ,Okayama,35_ 39,1950,Showa,25,101827,47226,54601
33 ,Okayama,40_ 44,1950,Showa,25,92987,44713,48274
33 ,Okayama,45_ 49,1950,Showa,25,86454,42644,43810
33 ,Okayama,50_ 54,1950,Showa,25,76687,39006,37681
33 ,Okayama,55_ 59,1950,Showa,25,59710,30236,29474
33 ,Okayama,60_ 64,1950,Showa,25,51096,24996,26100
33 ,Okayama,65_ 69,1950,Showa,25,44388,20512,23876
33 ,Okayama,70_ 74,1950,Showa,25,34115,15058,19057
33 ,Okayama,75_ 79,1950,Showa,25,19668,8183,11485
33 ,Okayama,over_80,1950,Showa,25,11055,4066,6989
33 ,Okayama,total,1955,Showa,30,1689800,815837,873963
33 ,Okayama,0_ 4,1955,Showa,30,153923,78553,75370
33 ,Okayama,5_ 9,1955,Showa,30,203314,103577,99737
33 ,Okayama,10_ 14,1955,Showa,30,183168,92912,90256
33 ,Okayama,15_ 19,1955,Showa,30,154281,73033,81248
33 ,Okayama,20_ 24,1955,Showa,30,145615,67979,77636
33 ,Okayama,25_ 29,1955,Showa,30,133410,65160,68250
33 ,Okayama,30_ 34,1955,Showa,30,109364,49111,60253
33 ,Okayama,35_ 39,1955,Showa,30,93791,41219,52572
33 ,Okayama,40_ 44,1955,Showa,30,97610,45224,52386
33 ,Okayama,45_ 49,1955,Showa,30,89030,42898,46132
33 ,Okayama,50_ 54,1955,Showa,30,82276,40553,41723
33 ,Okayama,55_ 59,1955,Showa,30,72159,36418,35741
33 ,Okayama,60_ 64,1955,Showa,30,53946,27058,26888
33 ,Okayama,65_ 69,1955,Showa,30,43759,20997,22762
33 ,Okayama,70_ 74,1955,Showa,30,35267,15629,19638
33 ,Okayama,75_ 79,1955,Showa,30,23739,9913,13826
33 ,Okayama,80_ 84,1955,Showa,30,11088,4283,6805
33 ,Okayama,over_85,1955,Showa,30,4048,1314,2734
33 ,Okayama,total,1960,Showa,35,1670454,797748,872706
33 ,Okayama,0_ 4,1960,Showa,35,129789,66092,63697
33 ,Okayama,5_ 9,1960,Showa,35,150830,76882,73948
33 ,Okayama,10_ 14,1960,Showa,35,199522,101499,98023
33 ,Okayama,15_ 19,1960,Showa,35,164463,74036,90427
33 ,Okayama,20_ 24,1960,Showa,35,122114,53884,68230
33 ,Okayama,25_ 29,1960,Showa,35,132107,64201,67906
33 ,Okayama,30_ 34,1960,Showa,35,128404,63277,65127
33 ,Okayama,35_ 39,1960,Showa,35,105490,47255,58235
33 ,Okayama,40_ 44,1960,Showa,35,90342,39643,50699
33 ,Okayama,45_ 49,1960,Showa,35,93309,43167,50142
33 ,Okayama,50_ 54,1960,Showa,35,84792,40624,44168
33 ,Okayama,55_ 59,1960,Showa,35,77331,37902,39429
33 ,Okayama,60_ 64,1960,Showa,35,65952,32830,33122
33 ,Okayama,65_ 69,1960,Showa,35,47045,22972,24073
33 ,Okayama,70_ 74,1960,Showa,35,35482,16282,19200
33 ,Okayama,75_ 79,1960,Showa,35,24578,10265,14313
33 ,Okayama,80_ 84,1960,Showa,35,13298,5078,8220
33 ,Okayama,over_85,1960,Showa,35,5606,1859,3747
33 ,Okayama,total,1965,Showa,40,1645135,781418,863717
33 ,Okayama,0_ 4,1965,Showa,40,118847,60782,58065
33 ,Okayama,5_ 9,1965,Showa,40,128538,65154,63384
33 ,Okayama,10_ 14,1965,Showa,40,149194,75580,73614
33 ,Okayama,15_ 19,1965,Showa,40,181575,83203,98372
33 ,Okayama,20_ 24,1965,Showa,40,123471,53144,70327
33 ,Okayama,25_ 29,1965,Showa,40,113784,54086,59698
33 ,Okayama,30_ 34,1965,Showa,40,129168,63491,65677
33 ,Okayama,35_ 39,1965,Showa,40,126403,62349,64054
33 ,Okayama,40_ 44,1965,Showa,40,102892,46236,56656
33 ,Okayama,45_ 49,1965,Showa,40,87483,38365,49118
33 ,Okayama,50_ 54,1965,Showa,40,89297,41191,48106
33 ,Okayama,55_ 59,1965,Showa,40,80130,38357,41773
33 ,Okayama,60_ 64,1965,Showa,40,70912,34361,36551
33 ,Okayama,65_ 69,1965,Showa,40,58370,28297,30073
33 ,Okayama,70_ 74,1965,Showa,40,38698,18134,20564
33 ,Okayama,75_ 79,1965,Showa,40,25509,11092,14417
33 ,Okayama,80_ 84,1965,Showa,40,13745,5240,8505
33 ,Okayama,over_85,1965,Showa,40,7119,2356,4763
33 ,Okayama,total,1970,Showa,45,1707026,819359,887667
33 ,Okayama,0_ 4,1970,Showa,45,128908,66319,62589
33 ,Okayama,5_ 9,1970,Showa,45,124697,63889,60808
33 ,Okayama,10_ 14,1970,Showa,45,131362,66765,64597
33 ,Okayama,15_ 19,1970,Showa,45,141651,66972,74679
33 ,Okayama,20_ 24,1970,Showa,45,151539,68662,82877
33 ,Okayama,25_ 29,1970,Showa,45,131894,64378,67516
33 ,Okayama,30_ 34,1970,Showa,45,121507,59485,62022
33 ,Okayama,35_ 39,1970,Showa,45,134003,66588,67415
33 ,Okayama,40_ 44,1970,Showa,45,126120,62961,63159
33 ,Okayama,45_ 49,1970,Showa,45,103075,46433,56642
33 ,Okayama,50_ 54,1970,Showa,45,85986,37821,48165
33 ,Okayama,55_ 59,1970,Showa,45,84828,39163,45665
33 ,Okayama,60_ 64,1970,Showa,45,75203,35333,39870
33 ,Okayama,65_ 69,1970,Showa,45,64373,30160,34213
33 ,Okayama,70_ 74,1970,Showa,45,49395,22928,26467
33 ,Okayama,75_ 79,1970,Showa,45,28877,12669,16208
33 ,Okayama,80_ 84,1970,Showa,45,15676,6212,9464
33 ,Okayama,over_85,1970,Showa,45,7932,2621,5311
33 ,Okayama,total,1975,Showa,50,1814305,878132,936173
33 ,Okayama,0_ 4,1975,Showa,50,155651,79989,75662
33 ,Okayama,5_ 9,1975,Showa,50,133999,68972,65027
33 ,Okayama,10_ 14,1975,Showa,50,127250,65355,61895
33 ,Okayama,15_ 19,1975,Showa,50,127628,61963,65665
33 ,Okayama,20_ 24,1975,Showa,50,123413,57933,65480
33 ,Okayama,25_ 29,1975,Showa,50,160239,79190,81049
33 ,Okayama,30_ 34,1975,Showa,50,139402,69364,70038
33 ,Okayama,35_ 39,1975,Showa,50,124943,61607,63336
33 ,Okayama,40_ 44,1975,Showa,50,134964,67107,67857
33 ,Okayama,45_ 49,1975,Showa,50,126759,62974,63785
33 ,Okayama,50_ 54,1975,Showa,50,100882,45347,55535
33 ,Okayama,55_ 59,1975,Showa,50,83232,36184,47048
33 ,Okayama,60_ 64,1975,Showa,50,82391,37237,45154
33 ,Okayama,65_ 69,1975,Showa,50,70035,31899,38136
33 ,Okayama,70_ 74,1975,Showa,50,56081,25216,30865
33 ,Okayama,75_ 79,1975,Showa,50,38684,16855,21829
33 ,Okayama,80_ 84,1975,Showa,50,18757,7497,11260
33 ,Okayama,over_85,1975,Showa,50,9732,3280,6452
33 ,Okayama,total,1980,Showa,55,1871023,905477,965546
33 ,Okayama,0_ 4,1980,Showa,55,131906,68042,63864
33 ,Okayama,5_ 9,1980,Showa,55,157467,80823,76644
33 ,Okayama,10_ 14,1980,Showa,55,134881,69540,65341
33 ,Okayama,15_ 19,1980,Showa,55,123622,61180,62442
33 ,Okayama,20_ 24,1980,Showa,55,108780,50534,58246
33 ,Okayama,25_ 29,1980,Showa,55,128761,63802,64959
33 ,Okayama,30_ 34,1980,Showa,55,162622,81180,81442
33 ,Okayama,35_ 39,1980,Showa,55,140121,69739,70382
33 ,Okayama,40_ 44,1980,Showa,55,124046,60928,63118
33 ,Okayama,45_ 49,1980,Showa,55,132828,65647,67181
33 ,Okayama,50_ 54,1980,Showa,55,124175,61126,63049
33 ,Okayama,55_ 59,1980,Showa,55,98203,43505,54698
33 ,Okayama,60_ 64,1980,Showa,55,80077,34131,45946
33 ,Okayama,65_ 69,1980,Showa,55,76968,34017,42951
33 ,Okayama,70_ 74,1980,Showa,55,62325,27339,34986
33 ,Okayama,75_ 79,1980,Showa,55,45046,18945,26101
33 ,Okayama,80_ 84,1980,Showa,55,26291,10470,15821
33 ,Okayama,over_85,1980,Showa,55,12676,4397,8279
33 ,Okayama,total,1985,Showa,60,1916906,926238,990668
33 ,Okayama,0_ 4,1985,Showa,60,117195,59884,57311
33 ,Okayama,5_ 9,1985,Showa,60,133274,68734,64540
33 ,Okayama,10_ 14,1985,Showa,60,158747,81628,77119
33 ,Okayama,15_ 19,1985,Showa,60,132105,66027,66078
33 ,Okayama,20_ 24,1985,Showa,60,108765,51243,57522
33 ,Okayama,25_ 29,1985,Showa,60,113741,55669,58072
33 ,Okayama,30_ 34,1985,Showa,60,130529,65316,65213
33 ,Okayama,35_ 39,1985,Showa,60,163956,81946,82010
33 ,Okayama,40_ 44,1985,Showa,60,139742,69421,70321
33 ,Okayama,45_ 49,1985,Showa,60,122436,60088,62348
33 ,Okayama,50_ 54,1985,Showa,60,130275,63968,66307
33 ,Okayama,55_ 59,1985,Showa,60,121176,58978,62198
33 ,Okayama,60_ 64,1985,Showa,60,95133,41548,53585
33 ,Okayama,65_ 69,1985,Showa,60,75702,31473,44229
33 ,Okayama,70_ 74,1985,Showa,60,70037,29694,40343
33 ,Okayama,75_ 79,1985,Showa,60,52359,21570,30789
33 ,Okayama,80_ 84,1985,Showa,60,32365,12352,20013
33 ,Okayama,over_85,1985,Showa,60,19092,6528,12564
33 ,Okayama,total,1990,Heisei,2,1925877,926721,999156
33 ,Okayama,0_ 4,1990,Heisei,2,101593,51876,49717
33 ,Okayama,5_ 9,1990,Heisei,2,117709,60256,57453
33 ,Okayama,10_ 14,1990,Heisei,2,133889,69168,64721
33 ,Okayama,15_ 19,1990,Heisei,2,154589,77393,77196
33 ,Okayama,20_ 24,1990,Heisei,2,114601,54000,60601
33 ,Okayama,25_ 29,1990,Heisei,2,108201,52671,55530
33 ,Okayama,30_ 34,1990,Heisei,2,113536,56010,57526
33 ,Okayama,35_ 39,1990,Heisei,2,130406,65315,65091
33 ,Okayama,40_ 44,1990,Heisei,2,162805,81286,81519
33 ,Okayama,45_ 49,1990,Heisei,2,137707,68169,69538
33 ,Okayama,50_ 54,1990,Heisei,2,120055,58455,61600
33 ,Okayama,55_ 59,1990,Heisei,2,127086,61625,65461
33 ,Okayama,60_ 64,1990,Heisei,2,117235,56128,61107
33 ,Okayama,65_ 69,1990,Heisei,2,90521,38724,51797
33 ,Okayama,70_ 74,1990,Heisei,2,69822,28050,41772
33 ,Okayama,75_ 79,1990,Heisei,2,60014,24022,35992
33 ,Okayama,80_ 84,1990,Heisei,2,39309,14728,24581
33 ,Okayama,over_85,1990,Heisei,2,26098,8393,17705
33 ,Okayama,total,1995,Heisei,7,1950750,938439,1012311
33 ,Okayama,0_ 4,1995,Heisei,7,93020,47825,45195
33 ,Okayama,5_ 9,1995,Heisei,7,103743,53018,50725
33 ,Okayama,10_ 14,1995,Heisei,7,119139,60932,58207
33 ,Okayama,15_ 19,1995,Heisei,7,133721,67588,66133
33 ,Okayama,20_ 24,1995,Heisei,7,141873,69235,72638
33 ,Okayama,25_ 29,1995,Heisei,7,117346,57006,60340
33 ,Okayama,30_ 34,1995,Heisei,7,110507,54463,56044
33 ,Okayama,35_ 39,1995,Heisei,7,116030,57470,58560
33 ,Okayama,40_ 44,1995,Heisei,7,131627,66217,65410
33 ,Okayama,45_ 49,1995,Heisei,7,163087,81549,81538
33 ,Okayama,50_ 54,1995,Heisei,7,136868,67558,69310
33 ,Okayama,55_ 59,1995,Heisei,7,118937,57469,61468
33 ,Okayama,60_ 64,1995,Heisei,7,124243,59562,64681
33 ,Okayama,65_ 69,1995,Heisei,7,112315,52520,59795
33 ,Okayama,70_ 74,1995,Heisei,7,84197,34674,49523
33 ,Okayama,75_ 79,1995,Heisei,7,60969,23017,37952
33 ,Okayama,80_ 84,1995,Heisei,7,46557,16830,29727
33 ,Okayama,over_85,1995,Heisei,7,35275,10758,24517
33 ,Okayama,total,2000,Heisei,12,1950828,936044,1014784
33 ,Okayama,0_ 4,2000,Heisei,12,93322,47716,45606
33 ,Okayama,5_ 9,2000,Heisei,12,93905,48198,45707
33 ,Okayama,10_ 14,2000,Heisei,12,104119,53186,50933
33 ,Okayama,15_ 19,2000,Heisei,12,118069,59468,58601
33 ,Okayama,20_ 24,2000,Heisei,12,121924,60459,61465
33 ,Okayama,25_ 29,2000,Heisei,12,140244,69358,70886
33 ,Okayama,30_ 34,2000,Heisei,12,117500,57591,59909
33 ,Okayama,35_ 39,2000,Heisei,12,110698,54466,56232
33 ,Okayama,40_ 44,2000,Heisei,12,115459,57112,58347
33 ,Okayama,45_ 49,2000,Heisei,12,129976,65219,64757
33 ,Okayama,50_ 54,2000,Heisei,12,160238,79461,80777
33 ,Okayama,55_ 59,2000,Heisei,12,134459,65678,68781
33 ,Okayama,60_ 64,2000,Heisei,12,116555,55618,60937
33 ,Okayama,65_ 69,2000,Heisei,12,118480,55373,63107
33 ,Okayama,70_ 74,2000,Heisei,12,103876,46864,57012
33 ,Okayama,75_ 79,2000,Heisei,12,75014,29316,45698
33 ,Okayama,80_ 84,2000,Heisei,12,49222,16845,32377
33 ,Okayama,over_85,2000,Heisei,12,47066,13660,33406
33 ,Okayama,total,2005,Heisei,17,1957264,938600,1018664
33 ,Okayama,0_ 4,2005,Heisei,17,87937,45123,42814
33 ,Okayama,5_ 9,2005,Heisei,17,93923,48080,45843
33 ,Okayama,10_ 14,2005,Heisei,17,93883,48208,45675
33 ,Okayama,15_ 19,2005,Heisei,17,104570,52668,51902
33 ,Okayama,20_ 24,2005,Heisei,17,109702,54173,55529
33 ,Okayama,25_ 29,2005,Heisei,17,117947,58884,59063
33 ,Okayama,30_ 34,2005,Heisei,17,140282,69840,70442
33 ,Okayama,35_ 39,2005,Heisei,17,117501,57717,59784
33 ,Okayama,40_ 44,2005,Heisei,17,110791,54583,56208
33 ,Okayama,45_ 49,2005,Heisei,17,114772,56544,58228
33 ,Okayama,50_ 54,2005,Heisei,17,128849,64246,64603
33 ,Okayama,55_ 59,2005,Heisei,17,158662,78031,80631
33 ,Okayama,60_ 64,2005,Heisei,17,133242,64590,68652
33 ,Okayama,65_ 69,2005,Heisei,17,112886,53247,59639
33 ,Okayama,70_ 74,2005,Heisei,17,111753,50786,60967
33 ,Okayama,75_ 79,2005,Heisei,17,93509,40032,53477
33 ,Okayama,80_ 84,2005,Heisei,17,62314,22364,39950
33 ,Okayama,over_85,2005,Heisei,17,57592,15511,42081
33 ,Okayama,total,2010,Heisei,22,1945276,933168,1012108
33 ,Okayama,0_ 4,2010,Heisei,22,82489,42646,39843
33 ,Okayama,5_ 9,2010,Heisei,22,88502,45455,43047
33 ,Okayama,10_ 14,2010,Heisei,22,93862,48085,45777
33 ,Okayama,15_ 19,2010,Heisei,22,94662,48116,46546
33 ,Okayama,20_ 24,2010,Heisei,22,97478,47468,50010
33 ,Okayama,25_ 29,2010,Heisei,22,104518,51784,52734
33 ,Okayama,30_ 34,2010,Heisei,22,117606,59019,58587
33 ,Okayama,35_ 39,2010,Heisei,22,140449,70216,70233
33 ,Okayama,40_ 44,2010,Heisei,22,117230,57798,59432
33 ,Okayama,45_ 49,2010,Heisei,22,109577,53880,55697
33 ,Okayama,50_ 54,2010,Heisei,22,113512,55778,57734
33 ,Okayama,55_ 59,2010,Heisei,22,127211,62951,64260
33 ,Okayama,60_ 64,2010,Heisei,22,156250,76194,80056
33 ,Okayama,65_ 69,2010,Heisei,22,128664,61423,67241
33 ,Okayama,70_ 74,2010,Heisei,22,106181,48662,57519
33 ,Okayama,75_ 79,2010,Heisei,22,100233,43254,56979
33 ,Okayama,80_ 84,2010,Heisei,22,77672,30246,47426
33 ,Okayama,over_85,2010,Heisei,22,71968,19419,52549
33 ,Okayama,total,2015,Heisei,27,1921525,922226,999299
33 ,Okayama,0_ 4,2015,Heisei,27,77254,39685,37569
33 ,Okayama,5_ 9,2015,Heisei,27,82492,42759,39733
33 ,Okayama,10_ 14,2015,Heisei,27,88144,45316,42828
33 ,Okayama,15_ 19,2015,Heisei,27,95478,48551,46927
33 ,Okayama,20_ 24,2015,Heisei,27,90711,44920,45791
33 ,Okayama,25_ 29,2015,Heisei,27,93212,46322,46890
33 ,Okayama,30_ 34,2015,Heisei,27,102843,51114,51729
33 ,Okayama,35_ 39,2015,Heisei,27,116575,58462,58113
33 ,Okayama,40_ 44,2015,Heisei,27,139261,69762,69499
33 ,Okayama,45_ 49,2015,Heisei,27,115516,56907,58609
33 ,Okayama,50_ 54,2015,Heisei,27,108079,53106,54973
33 ,Okayama,55_ 59,2015,Heisei,27,111640,54451,57189
33 ,Okayama,60_ 64,2015,Heisei,27,124825,61242,63583
33 ,Okayama,65_ 69,2015,Heisei,27,150704,72456,78248
33 ,Okayama,70_ 74,2015,Heisei,27,120955,56282,64673
33 ,Okayama,75_ 79,2015,Heisei,27,95875,42143,53732
33 ,Okayama,80_ 84,2015,Heisei,27,83927,33437,50490
33 ,Okayama,over_85,2015,Heisei,27,89415,26307,63108
34 ,Hiroshima,total,1920,Taisho,9,1541905,775080,766825
34 ,Hiroshima,0_ 4,1920,Taisho,9,201613,101909,99704
34 ,Hiroshima,5_ 9,1920,Taisho,9,191705,97500,94205
34 ,Hiroshima,10_ 14,1920,Taisho,9,170786,87741,83045
34 ,Hiroshima,15_ 19,1920,Taisho,9,139156,71268,67888
34 ,Hiroshima,20_ 24,1920,Taisho,9,128335,68432,59903
34 ,Hiroshima,25_ 29,1920,Taisho,9,99682,50981,48701
34 ,Hiroshima,30_ 34,1920,Taisho,9,90665,45290,45375
34 ,Hiroshima,35_ 39,1920,Taisho,9,91664,45056,46608
34 ,Hiroshima,40_ 44,1920,Taisho,9,85798,42110,43688
34 ,Hiroshima,45_ 49,1920,Taisho,9,72831,35447,37384
34 ,Hiroshima,50_ 54,1920,Taisho,9,65824,32253,33571
34 ,Hiroshima,55_ 59,1920,Taisho,9,53190,26112,27078
34 ,Hiroshima,60_ 64,1920,Taisho,9,53060,25943,27117
34 ,Hiroshima,65_ 69,1920,Taisho,9,41844,20069,21775
34 ,Hiroshima,70_ 74,1920,Taisho,9,30339,14160,16179
34 ,Hiroshima,75_ 79,1920,Taisho,9,16312,7282,9030
34 ,Hiroshima,over_80,1920,Taisho,9,9101,3527,5574
34 ,Hiroshima,total,1925,Taisho,14,1617680,818266,799414
34 ,Hiroshima,0_ 4,1925,Taisho,14,217747,109766,107981
34 ,Hiroshima,5_ 9,1925,Taisho,14,189928,96278,93650
34 ,Hiroshima,10_ 14,1925,Taisho,14,184376,94357,90019
34 ,Hiroshima,15_ 19,1925,Taisho,14,150982,78487,72495
34 ,Hiroshima,20_ 24,1925,Taisho,14,134853,72686,62167
34 ,Hiroshima,25_ 29,1925,Taisho,14,115272,59986,55286
34 ,Hiroshima,30_ 34,1925,Taisho,14,94239,48671,45568
34 ,Hiroshima,35_ 39,1925,Taisho,14,86843,43827,43016
34 ,Hiroshima,40_ 44,1925,Taisho,14,87353,43467,43886
34 ,Hiroshima,45_ 49,1925,Taisho,14,81665,40230,41435
34 ,Hiroshima,50_ 54,1925,Taisho,14,68142,33316,34826
34 ,Hiroshima,55_ 59,1925,Taisho,14,59161,28849,30312
34 ,Hiroshima,60_ 64,1925,Taisho,14,46102,22274,23828
34 ,Hiroshima,65_ 69,1925,Taisho,14,42216,20234,21982
34 ,Hiroshima,70_ 74,1925,Taisho,14,30172,13840,16332
34 ,Hiroshima,75_ 79,1925,Taisho,14,18275,8036,10239
34 ,Hiroshima,80_ 84,1925,Taisho,14,7648,3064,4534
34 ,Hiroshima,over_85,1925,Taisho,14,2706,898,1808
34 ,Hiroshima,total,1930,Showa,5,1692136,856737,835399
34 ,Hiroshima,0_ 4,1930,Showa,5,223335,112829,110506
34 ,Hiroshima,5_ 9,1930,Showa,5,205016,103531,101485
34 ,Hiroshima,10_ 14,1930,Showa,5,182987,92797,90190
34 ,Hiroshima,15_ 19,1930,Showa,5,160652,83192,77460
34 ,Hiroshima,20_ 24,1930,Showa,5,148412,81633,66779
34 ,Hiroshima,25_ 29,1930,Showa,5,117315,60197,57118
34 ,Hiroshima,30_ 34,1930,Showa,5,107162,55006,52156
34 ,Hiroshima,35_ 39,1930,Showa,5,89887,46177,43710
34 ,Hiroshima,40_ 44,1930,Showa,5,83348,42325,41023
34 ,Hiroshima,45_ 49,1930,Showa,5,83256,41429,41827
34 ,Hiroshima,50_ 54,1930,Showa,5,76508,37693,38815
34 ,Hiroshima,55_ 59,1930,Showa,5,62181,30267,31914
34 ,Hiroshima,60_ 64,1930,Showa,5,52265,24886,27379
34 ,Hiroshima,65_ 69,1930,Showa,5,37577,17715,19862
34 ,Hiroshima,70_ 74,1930,Showa,5,31193,14255,16938
34 ,Hiroshima,75_ 79,1930,Showa,5,18748,8134,10614
34 ,Hiroshima,over_80,1930,Showa,5,12294,4671,7623
34 ,Hiroshima,total,1935,Showa,10,1804916,914185,890731
34 ,Hiroshima,0_ 4,1935,Showa,10,225897,114363,111534
34 ,Hiroshima,5_ 9,1935,Showa,10,217075,109633,107442
34 ,Hiroshima,10_ 14,1935,Showa,10,202496,102109,100387
34 ,Hiroshima,15_ 19,1935,Showa,10,165529,85105,80424
34 ,Hiroshima,20_ 24,1935,Showa,10,164600,89102,75498
34 ,Hiroshima,25_ 29,1935,Showa,10,132797,68923,63874
34 ,Hiroshima,30_ 34,1935,Showa,10,114426,58719,55707
34 ,Hiroshima,35_ 39,1935,Showa,10,105045,54183,50862
34 ,Hiroshima,40_ 44,1935,Showa,10,87198,45206,41992
34 ,Hiroshima,45_ 49,1935,Showa,10,80164,40738,39426
34 ,Hiroshima,50_ 54,1935,Showa,10,78394,38977,39417
34 ,Hiroshima,55_ 59,1935,Showa,10,70751,34398,36353
34 ,Hiroshima,60_ 64,1935,Showa,10,55643,26614,29029
34 ,Hiroshima,65_ 69,1935,Showa,10,43147,19816,23331
34 ,Hiroshima,70_ 74,1935,Showa,10,28175,12617,15558
34 ,Hiroshima,75_ 79,1935,Showa,10,19883,8540,11343
34 ,Hiroshima,over_80,1935,Showa,10,13696,5142,8554
34 ,Hiroshima,total,1940,Showa,15,1868440,936285,932155
34 ,Hiroshima,0_ 4,1940,Showa,15,211912,107450,104462
34 ,Hiroshima,5_ 9,1940,Showa,15,217013,109605,107408
34 ,Hiroshima,10_ 14,1940,Showa,15,213759,108152,105607
34 ,Hiroshima,15_ 19,1940,Showa,15,187752,95113,92639
34 ,Hiroshima,20_ 24,1940,Showa,15,154892,77319,77573
34 ,Hiroshima,25_ 29,1940,Showa,15,145824,74402,71422
34 ,Hiroshima,30_ 34,1940,Showa,15,125939,64486,61453
34 ,Hiroshima,35_ 39,1940,Showa,15,109725,55958,53767
34 ,Hiroshima,40_ 44,1940,Showa,15,100312,51599,48713
34 ,Hiroshima,45_ 49,1940,Showa,15,82670,42424,40246
34 ,Hiroshima,50_ 54,1940,Showa,15,74848,37584,37264
34 ,Hiroshima,55_ 59,1940,Showa,15,71621,34900,36721
34 ,Hiroshima,60_ 64,1940,Showa,15,62650,29728,32922
34 ,Hiroshima,65_ 69,1940,Showa,15,45939,21156,24783
34 ,Hiroshima,70_ 74,1940,Showa,15,32105,13896,18209
34 ,Hiroshima,75_ 79,1940,Showa,15,17560,7321,10239
34 ,Hiroshima,80_ 84,1940,Showa,15,9544,3691,5853
34 ,Hiroshima,over_85,1940,Showa,15,4234,1447,2787
34 ,Hiroshima,total,1945,Showa,20,1885471,878343,1007128
34 ,Hiroshima,1_ 5,1945,Showa,20,243101,123690,119411
34 ,Hiroshima,6_ 10,1945,Showa,20,214173,108814,105359
34 ,Hiroshima,11_ 15,1945,Showa,20,219945,111208,108737
34 ,Hiroshima,16_ 20,1945,Showa,20,197474,95296,102178
34 ,Hiroshima,21_ 25,1945,Showa,20,138402,49063,89339
34 ,Hiroshima,26_ 30,1945,Showa,20,120417,45480,74937
34 ,Hiroshima,31_ 35,1945,Showa,20,117766,46998,70768
34 ,Hiroshima,36_ 40,1945,Showa,20,109188,47209,61979
34 ,Hiroshima,41_ 45,1945,Showa,20,102719,49514,53205
34 ,Hiroshima,46_ 50,1945,Showa,20,95685,48088,47597
34 ,Hiroshima,51_ 55,1945,Showa,20,78248,39656,38592
34 ,Hiroshima,56_ 60,1945,Showa,20,69361,33940,35421
34 ,Hiroshima,61_ 65,1945,Showa,20,61628,29165,32463
34 ,Hiroshima,66_ 70,1945,Showa,20,51219,23039,28180
34 ,Hiroshima,71_ 75,1945,Showa,20,34465,14945,19520
34 ,Hiroshima,76_ 80,1945,Showa,20,19375,7751,11624
34 ,Hiroshima,81_ 85,1945,Showa,20,8460,3175,5285
34 ,Hiroshima,86以上,1945,Showa,20,3845,1312,2533
34 ,Hiroshima,total,1950,Showa,25,2081967,1015955,1066012
34 ,Hiroshima,0_ 4,1950,Showa,25,267503,136873,130630
34 ,Hiroshima,5_ 9,1950,Showa,25,237454,120762,116692
34 ,Hiroshima,10_ 14,1950,Showa,25,207172,105078,102094
34 ,Hiroshima,15_ 19,1950,Showa,25,203580,102423,101157
34 ,Hiroshima,20_ 24,1950,Showa,25,183593,88071,95522
34 ,Hiroshima,25_ 29,1950,Showa,25,155550,71486,84064
34 ,Hiroshima,30_ 34,1950,Showa,25,132606,60730,71876
34 ,Hiroshima,35_ 39,1950,Showa,25,129080,60724,68356
34 ,Hiroshima,40_ 44,1950,Showa,25,113264,54389,58875
34 ,Hiroshima,45_ 49,1950,Showa,25,99537,49030,50507
34 ,Hiroshima,50_ 54,1950,Showa,25,90140,45148,44992
34 ,Hiroshima,55_ 59,1950,Showa,25,72744,36444,36300
34 ,Hiroshima,60_ 64,1950,Showa,25,61836,29713,32123
34 ,Hiroshima,65_ 69,1950,Showa,25,51933,23840,28093
34 ,Hiroshima,70_ 74,1950,Showa,25,38850,16888,21962
34 ,Hiroshima,75_ 79,1950,Showa,25,22375,9163,13212
34 ,Hiroshima,over_80,1950,Showa,25,14625,5133,9492
34 ,Hiroshima,total,1955,Showa,30,2149044,1047184,1101860
34 ,Hiroshima,0_ 4,1955,Showa,30,202236,104159,98077
34 ,Hiroshima,5_ 9,1955,Showa,30,259899,132996,126903
34 ,Hiroshima,10_ 14,1955,Showa,30,233553,118763,114790
34 ,Hiroshima,15_ 19,1955,Showa,30,191024,94848,96176
34 ,Hiroshima,20_ 24,1955,Showa,30,183762,87642,96120
34 ,Hiroshima,25_ 29,1955,Showa,30,176739,85620,91119
34 ,Hiroshima,30_ 34,1955,Showa,30,151290,69793,81497
34 ,Hiroshima,35_ 39,1955,Showa,30,128602,58982,69620
34 ,Hiroshima,40_ 44,1955,Showa,30,124784,58736,66048
34 ,Hiroshima,45_ 49,1955,Showa,30,109172,52302,56870
34 ,Hiroshima,50_ 54,1955,Showa,30,94899,46605,48294
34 ,Hiroshima,55_ 59,1955,Showa,30,84810,42203,42607
34 ,Hiroshima,60_ 64,1955,Showa,30,66068,32659,33409
34 ,Hiroshima,65_ 69,1955,Showa,30,53649,25169,28480
34 ,Hiroshima,70_ 74,1955,Showa,30,41965,18590,23375
34 ,Hiroshima,75_ 79,1955,Showa,30,27647,11271,16376
34 ,Hiroshima,80_ 84,1955,Showa,30,13269,5059,8210
34 ,Hiroshima,over_85,1955,Showa,30,5654,1781,3873
34 ,Hiroshima,total,1960,Showa,35,2184043,1058829,1125214
34 ,Hiroshima,0_ 4,1960,Showa,35,171286,87524,83762
34 ,Hiroshima,5_ 9,1960,Showa,35,200899,103413,97486
34 ,Hiroshima,10_ 14,1960,Showa,35,258309,132047,126262
34 ,Hiroshima,15_ 19,1960,Showa,35,211293,103491,107802
34 ,Hiroshima,20_ 24,1960,Showa,35,167102,77926,89176
34 ,Hiroshima,25_ 29,1960,Showa,35,179123,86928,92195
34 ,Hiroshima,30_ 34,1960,Showa,35,174433,85205,89228
34 ,Hiroshima,35_ 39,1960,Showa,35,148666,68660,80006
34 ,Hiroshima,40_ 44,1960,Showa,35,125360,57484,67876
34 ,Hiroshima,45_ 49,1960,Showa,35,120707,56625,64082
34 ,Hiroshima,50_ 54,1960,Showa,35,104250,49547,54703
34 ,Hiroshima,55_ 59,1960,Showa,35,89732,43546,46186
34 ,Hiroshima,60_ 64,1960,Showa,35,77971,38097,39874
34 ,Hiroshima,65_ 69,1960,Showa,35,58074,27887,30187
34 ,Hiroshima,70_ 74,1960,Showa,35,43838,19779,24059
34 ,Hiroshima,75_ 79,1960,Showa,35,29803,12422,17381
34 ,Hiroshima,80_ 84,1960,Showa,35,15820,5869,9951
34 ,Hiroshima,over_85,1960,Showa,35,7377,2379,4998
34 ,Hiroshima,total,1965,Showa,40,2281146,1107878,1173268
34 ,Hiroshima,0_ 4,1965,Showa,40,175178,89311,85867
34 ,Hiroshima,5_ 9,1965,Showa,40,174321,88551,85770
34 ,Hiroshima,10_ 14,1965,Showa,40,203022,104038,98984
34 ,Hiroshima,15_ 19,1965,Showa,40,247178,124499,122679
34 ,Hiroshima,20_ 24,1965,Showa,40,193386,90551,102835
34 ,Hiroshima,25_ 29,1965,Showa,40,176866,86504,90362
34 ,Hiroshima,30_ 34,1965,Showa,40,185233,91409,93824
34 ,Hiroshima,35_ 39,1965,Showa,40,176842,86821,90021
34 ,Hiroshima,40_ 44,1965,Showa,40,148387,68681,79706
34 ,Hiroshima,45_ 49,1965,Showa,40,123826,56797,67029
34 ,Hiroshima,50_ 54,1965,Showa,40,117438,55058,62380
34 ,Hiroshima,55_ 59,1965,Showa,40,99932,47363,52569
34 ,Hiroshima,60_ 64,1965,Showa,40,83623,39924,43699
34 ,Hiroshima,65_ 69,1965,Showa,40,69605,33245,36360
34 ,Hiroshima,70_ 74,1965,Showa,40,48191,22232,25959
34 ,Hiroshima,75_ 79,1965,Showa,40,31931,13508,18423
34 ,Hiroshima,80_ 84,1965,Showa,40,17178,6520,10658
34 ,Hiroshima,over_85,1965,Showa,40,9009,2866,6143
34 ,Hiroshima,total,1970,Showa,45,2436135,1188270,1247865
34 ,Hiroshima,0_ 4,1970,Showa,45,200678,102958,97720
34 ,Hiroshima,5_ 9,1970,Showa,45,180533,92325,88208
34 ,Hiroshima,10_ 14,1970,Showa,45,177607,90460,87147
34 ,Hiroshima,15_ 19,1970,Showa,45,202397,103635,98762
34 ,Hiroshima,20_ 24,1970,Showa,45,237129,115093,122036
34 ,Hiroshima,25_ 29,1970,Showa,45,210408,103536,106872
34 ,Hiroshima,30_ 34,1970,Showa,45,186112,92497,93615
34 ,Hiroshima,35_ 39,1970,Showa,45,188647,93403,95244
34 ,Hiroshima,40_ 44,1970,Showa,45,176456,86668,89788
34 ,Hiroshima,45_ 49,1970,Showa,45,147435,68100,79335
34 ,Hiroshima,50_ 54,1970,Showa,45,121730,55640,66090
34 ,Hiroshima,55_ 59,1970,Showa,45,112610,52177,60433
34 ,Hiroshima,60_ 64,1970,Showa,45,93612,43464,50148
34 ,Hiroshima,65_ 69,1970,Showa,45,75453,34886,40567
34 ,Hiroshima,70_ 74,1970,Showa,45,59133,26940,32193
34 ,Hiroshima,75_ 79,1970,Showa,45,35947,15476,20471
34 ,Hiroshima,80_ 84,1970,Showa,45,19856,7687,12169
34 ,Hiroshima,over_85,1970,Showa,45,10392,3325,7067
34 ,Hiroshima,total,1975,Showa,50,2646324,1296677,1349647
34 ,Hiroshima,0_ 4,1975,Showa,50,244177,125100,119077
34 ,Hiroshima,5_ 9,1975,Showa,50,206058,105681,100377
34 ,Hiroshima,10_ 14,1975,Showa,50,182984,93528,89456
34 ,Hiroshima,15_ 19,1975,Showa,50,175933,89645,86288
34 ,Hiroshima,20_ 24,1975,Showa,50,194804,95749,99055
34 ,Hiroshima,25_ 29,1975,Showa,50,258623,129921,128702
34 ,Hiroshima,30_ 34,1975,Showa,50,220626,110119,110507
34 ,Hiroshima,35_ 39,1975,Showa,50,189816,94868,94948
34 ,Hiroshima,40_ 44,1975,Showa,50,190024,94361,95663
34 ,Hiroshima,45_ 49,1975,Showa,50,176781,86937,89844
34 ,Hiroshima,50_ 54,1975,Showa,50,144449,66160,78289
34 ,Hiroshima,55_ 59,1975,Showa,50,118019,53302,64717
34 ,Hiroshima,60_ 64,1975,Showa,50,108231,49412,58819
34 ,Hiroshima,65_ 69,1975,Showa,50,86817,39114,47703
34 ,Hiroshima,70_ 74,1975,Showa,50,65926,29167,36759
34 ,Hiroshima,75_ 79,1975,Showa,50,46328,19807,26521
34 ,Hiroshima,80_ 84,1975,Showa,50,23429,9258,14171
34 ,Hiroshima,over_85,1975,Showa,50,12515,4054,8461
34 ,Hiroshima,total,1980,Showa,55,2739161,1336806,1402355
34 ,Hiroshima,0_ 4,1980,Showa,55,201603,103278,98325
34 ,Hiroshima,5_ 9,1980,Showa,55,240992,123070,117922
34 ,Hiroshima,10_ 14,1980,Showa,55,204559,104909,99650
34 ,Hiroshima,15_ 19,1980,Showa,55,177369,90501,86868
34 ,Hiroshima,20_ 24,1980,Showa,55,162833,78086,84747
34 ,Hiroshima,25_ 29,1980,Showa,55,202499,100784,101715
34 ,Hiroshima,30_ 34,1980,Showa,55,256308,129034,127274
34 ,Hiroshima,35_ 39,1980,Showa,55,217651,108264,109387
34 ,Hiroshima,40_ 44,1980,Showa,55,186043,92667,93376
34 ,Hiroshima,45_ 49,1980,Showa,55,185396,91271,94125
34 ,Hiroshima,50_ 54,1980,Showa,55,171443,83267,88176
34 ,Hiroshima,55_ 59,1980,Showa,55,139839,63205,76634
34 ,Hiroshima,60_ 64,1980,Showa,55,112484,49851,62633
34 ,Hiroshima,65_ 69,1980,Showa,55,100678,44590,56088
34 ,Hiroshima,70_ 74,1980,Showa,55,77094,33284,43810
34 ,Hiroshima,75_ 79,1980,Showa,55,53247,22058,31189
34 ,Hiroshima,80_ 84,1980,Showa,55,31738,12432,19306
34 ,Hiroshima,over_85,1980,Showa,55,16375,5558,10817
34 ,Hiroshima,total,1985,Showa,60,2819200,1373853,1445347
34 ,Hiroshima,0_ 4,1985,Showa,60,173882,89237,84645
34 ,Hiroshima,5_ 9,1985,Showa,60,201324,103105,98219
34 ,Hiroshima,10_ 14,1985,Showa,60,239953,122473,117480
34 ,Hiroshima,15_ 19,1985,Showa,60,199980,102149,97831
34 ,Hiroshima,20_ 24,1985,Showa,60,167218,81026,86192
34 ,Hiroshima,25_ 29,1985,Showa,60,172891,85402,87489
34 ,Hiroshima,30_ 34,1985,Showa,60,204377,102424,101953
34 ,Hiroshima,35_ 39,1985,Showa,60,255125,128261,126864
34 ,Hiroshima,40_ 44,1985,Showa,60,215566,107470,108096
34 ,Hiroshima,45_ 49,1985,Showa,60,182806,90714,92092
34 ,Hiroshima,50_ 54,1985,Showa,60,181000,88323,92677
34 ,Hiroshima,55_ 59,1985,Showa,60,166357,79688,86669
34 ,Hiroshima,60_ 64,1985,Showa,60,134523,59751,74772
34 ,Hiroshima,65_ 69,1985,Showa,60,105777,45654,60123
34 ,Hiroshima,70_ 74,1985,Showa,60,90849,38821,52028
34 ,Hiroshima,75_ 79,1985,Showa,60,64375,26186,38189
34 ,Hiroshima,80_ 84,1985,Showa,60,38487,14615,23872
34 ,Hiroshima,over_85,1985,Showa,60,23967,8059,15908
34 ,Hiroshima,total,1990,Heisei,2,2849847,1385297,1464550
34 ,Hiroshima,0_ 4,1990,Heisei,2,151920,77993,73927
34 ,Hiroshima,5_ 9,1990,Heisei,2,173639,89190,84449
34 ,Hiroshima,10_ 14,1990,Heisei,2,199697,102090,97607
34 ,Hiroshima,15_ 19,1990,Heisei,2,232518,118628,113890
34 ,Hiroshima,20_ 24,1990,Heisei,2,181088,87444,93644
34 ,Hiroshima,25_ 29,1990,Heisei,2,170332,83658,86674
34 ,Hiroshima,30_ 34,1990,Heisei,2,173349,85984,87365
34 ,Hiroshima,35_ 39,1990,Heisei,2,203176,101704,101472
34 ,Hiroshima,40_ 44,1990,Heisei,2,251916,126913,125003
34 ,Hiroshima,45_ 49,1990,Heisei,2,210799,104804,105995
34 ,Hiroshima,50_ 54,1990,Heisei,2,178311,87894,90417
34 ,Hiroshima,55_ 59,1990,Heisei,2,175435,84426,91009
34 ,Hiroshima,60_ 64,1990,Heisei,2,159894,75346,84548
34 ,Hiroshima,65_ 69,1990,Heisei,2,127011,55053,71958
34 ,Hiroshima,70_ 74,1990,Heisei,2,96651,40237,56414
34 ,Hiroshima,75_ 79,1990,Heisei,2,77864,31413,46451
34 ,Hiroshima,80_ 84,1990,Heisei,2,48059,17825,30234
34 ,Hiroshima,over_85,1990,Heisei,2,31892,10264,21628
34 ,Hiroshima,total,1995,Heisei,7,2881748,1398986,1482762
34 ,Hiroshima,0_ 4,1995,Heisei,7,140187,71893,68294
34 ,Hiroshima,5_ 9,1995,Heisei,7,153167,78638,74529
34 ,Hiroshima,10_ 14,1995,Heisei,7,173199,88859,84340
34 ,Hiroshima,15_ 19,1995,Heisei,7,196703,101031,95672
34 ,Hiroshima,20_ 24,1995,Heisei,7,219666,109181,110485
34 ,Hiroshima,25_ 29,1995,Heisei,7,187755,92393,95362
34 ,Hiroshima,30_ 34,1995,Heisei,7,173685,86177,87508
34 ,Hiroshima,35_ 39,1995,Heisei,7,174550,86796,87754
34 ,Hiroshima,40_ 44,1995,Heisei,7,202692,101817,100875
34 ,Hiroshima,45_ 49,1995,Heisei,7,249788,125897,123891
34 ,Hiroshima,50_ 54,1995,Heisei,7,207564,102777,104787
34 ,Hiroshima,55_ 59,1995,Heisei,7,174792,85345,89447
34 ,Hiroshima,60_ 64,1995,Heisei,7,169073,79921,89152
34 ,Hiroshima,65_ 69,1995,Heisei,7,151478,69524,81954
34 ,Hiroshima,70_ 74,1995,Heisei,7,117019,48830,68189
34 ,Hiroshima,75_ 79,1995,Heisei,7,83714,32795,50919
34 ,Hiroshima,80_ 84,1995,Heisei,7,60280,22017,38263
34 ,Hiroshima,over_85,1995,Heisei,7,44006,13415,30591
34 ,Hiroshima,total,2000,Heisei,12,2878915,1392496,1486419
34 ,Hiroshima,0_ 4,2000,Heisei,12,136417,69772,66645
34 ,Hiroshima,5_ 9,2000,Heisei,12,139877,71795,68082
34 ,Hiroshima,10_ 14,2000,Heisei,12,151741,77779,73962
34 ,Hiroshima,15_ 19,2000,Heisei,12,168437,86345,82092
34 ,Hiroshima,20_ 24,2000,Heisei,12,180130,90315,89815
34 ,Hiroshima,25_ 29,2000,Heisei,12,219160,108849,110311
34 ,Hiroshima,30_ 34,2000,Heisei,12,187859,92957,94902
34 ,Hiroshima,35_ 39,2000,Heisei,12,172696,85617,87079
34 ,Hiroshima,40_ 44,2000,Heisei,12,173356,86255,87101
34 ,Hiroshima,45_ 49,2000,Heisei,12,199186,99789,99397
34 ,Hiroshima,50_ 54,2000,Heisei,12,244064,122055,122009
34 ,Hiroshima,55_ 59,2000,Heisei,12,202467,99123,103344
34 ,Hiroshima,60_ 64,2000,Heisei,12,169441,81578,87863
34 ,Hiroshima,65_ 69,2000,Heisei,12,160414,74018,86396
34 ,Hiroshima,70_ 74,2000,Heisei,12,139522,61692,77830
34 ,Hiroshima,75_ 79,2000,Heisei,12,103078,40555,62523
34 ,Hiroshima,80_ 84,2000,Heisei,12,67233,24028,43205
34 ,Hiroshima,over_85,2000,Heisei,12,61290,18227,43063
34 ,Hiroshima,total,2005,Heisei,17,2876642,1390190,1486452
34 ,Hiroshima,0_ 4,2005,Heisei,17,129202,66342,62860
34 ,Hiroshima,5_ 9,2005,Heisei,17,136046,69648,66398
34 ,Hiroshima,10_ 14,2005,Heisei,17,138023,70855,67168
34 ,Hiroshima,15_ 19,2005,Heisei,17,149006,76909,72097
34 ,Hiroshima,20_ 24,2005,Heisei,17,155737,78931,76806
34 ,Hiroshima,25_ 29,2005,Heisei,17,177558,88834,88724
34 ,Hiroshima,30_ 34,2005,Heisei,17,217147,108414,108733
34 ,Hiroshima,35_ 39,2005,Heisei,17,185916,92119,93797
34 ,Hiroshima,40_ 44,2005,Heisei,17,170667,84743,85924
34 ,Hiroshima,45_ 49,2005,Heisei,17,170264,84428,85836
34 ,Hiroshima,50_ 54,2005,Heisei,17,195731,97517,98214
34 ,Hiroshima,55_ 59,2005,Heisei,17,238977,118374,120603
34 ,Hiroshima,60_ 64,2005,Heisei,17,197846,95867,101979
34 ,Hiroshima,65_ 69,2005,Heisei,17,162463,76935,85528
34 ,Hiroshima,70_ 74,2005,Heisei,17,149553,66721,82832
34 ,Hiroshima,75_ 79,2005,Heisei,17,124544,52141,72403
34 ,Hiroshima,80_ 84,2005,Heisei,17,85416,30858,54558
34 ,Hiroshima,over_85,2005,Heisei,17,78569,22180,56389
34 ,Hiroshima,total,2010,Heisei,22,2860750,1380671,1480079
34 ,Hiroshima,0_ 4,2010,Heisei,22,124114,63559,60555
34 ,Hiroshima,5_ 9,2010,Heisei,22,128360,65900,62460
34 ,Hiroshima,10_ 14,2010,Heisei,22,134336,68717,65619
34 ,Hiroshima,15_ 19,2010,Heisei,22,136168,70151,66017
34 ,Hiroshima,20_ 24,2010,Heisei,22,137098,69684,67414
34 ,Hiroshima,25_ 29,2010,Heisei,22,153042,77217,75825
34 ,Hiroshima,30_ 34,2010,Heisei,22,178636,89808,88828
34 ,Hiroshima,35_ 39,2010,Heisei,22,216329,108188,108141
34 ,Hiroshima,40_ 44,2010,Heisei,22,184012,91510,92502
34 ,Hiroshima,45_ 49,2010,Heisei,22,168328,83426,84902
34 ,Hiroshima,50_ 54,2010,Heisei,22,167126,82409,84717
34 ,Hiroshima,55_ 59,2010,Heisei,22,191535,94642,96893
34 ,Hiroshima,60_ 64,2010,Heisei,22,232762,113986,118776
34 ,Hiroshima,65_ 69,2010,Heisei,22,189386,90135,99251
34 ,Hiroshima,70_ 74,2010,Heisei,22,151666,69745,81921
34 ,Hiroshima,75_ 79,2010,Heisei,22,133626,56550,77076
34 ,Hiroshima,80_ 84,2010,Heisei,22,103132,39509,63623
34 ,Hiroshima,over_85,2010,Heisei,22,98850,27730,71120
34 ,Hiroshima,total,2015,Heisei,27,2843990,1376211,1467779
34 ,Hiroshima,0_ 4,2015,Heisei,27,120165,61293,58872
34 ,Hiroshima,5_ 9,2015,Heisei,27,125907,64418,61489
34 ,Hiroshima,10_ 14,2015,Heisei,27,129818,66613,63205
34 ,Hiroshima,15_ 19,2015,Heisei,27,135576,69783,65793
34 ,Hiroshima,20_ 24,2015,Heisei,27,129284,66079,63205
34 ,Hiroshima,25_ 29,2015,Heisei,27,140338,71845,68493
34 ,Hiroshima,30_ 34,2015,Heisei,27,156820,79528,77292
34 ,Hiroshima,35_ 39,2015,Heisei,27,180347,90654,89693
34 ,Hiroshima,40_ 44,2015,Heisei,27,217511,109134,108377
34 ,Hiroshima,45_ 49,2015,Heisei,27,183918,91623,92295
34 ,Hiroshima,50_ 54,2015,Heisei,27,166620,82494,84126
34 ,Hiroshima,55_ 59,2015,Heisei,27,164669,80851,83818
34 ,Hiroshima,60_ 64,2015,Heisei,27,187439,91717,95722
34 ,Hiroshima,65_ 69,2015,Heisei,27,224342,108390,115952
34 ,Hiroshima,70_ 74,2015,Heisei,27,178236,82663,95573
34 ,Hiroshima,75_ 79,2015,Heisei,27,137259,60555,76704
34 ,Hiroshima,80_ 84,2015,Heisei,27,112617,44181,68436
34 ,Hiroshima,over_85,2015,Heisei,27,121986,35847,86139
35 ,Yamaguchi,total,1920,Taisho,9,1041013,521041,519972
35 ,Yamaguchi,0_ 4,1920,Taisho,9,129281,64920,64361
35 ,Yamaguchi,5_ 9,1920,Taisho,9,123474,62750,60724
35 ,Yamaguchi,10_ 14,1920,Taisho,9,110988,56775,54213
35 ,Yamaguchi,15_ 19,1920,Taisho,9,90534,46244,44290
35 ,Yamaguchi,20_ 24,1920,Taisho,9,78151,38886,39265
35 ,Yamaguchi,25_ 29,1920,Taisho,9,68124,34862,33262
35 ,Yamaguchi,30_ 34,1920,Taisho,9,63746,32443,31303
35 ,Yamaguchi,35_ 39,1920,Taisho,9,62019,31283,30736
35 ,Yamaguchi,40_ 44,1920,Taisho,9,61361,30718,30643
35 ,Yamaguchi,45_ 49,1920,Taisho,9,55382,27450,27932
35 ,Yamaguchi,50_ 54,1920,Taisho,9,48317,23797,24520
35 ,Yamaguchi,55_ 59,1920,Taisho,9,41072,20095,20977
35 ,Yamaguchi,60_ 64,1920,Taisho,9,38372,18838,19534
35 ,Yamaguchi,65_ 69,1920,Taisho,9,29933,14270,15663
35 ,Yamaguchi,70_ 74,1920,Taisho,9,21792,9978,11814
35 ,Yamaguchi,75_ 79,1920,Taisho,9,11850,5139,6711
35 ,Yamaguchi,over_80,1920,Taisho,9,6617,2593,4024
35 ,Yamaguchi,total,1925,Taisho,14,1094544,552793,541751
35 ,Yamaguchi,0_ 4,1925,Taisho,14,141073,71155,69918
35 ,Yamaguchi,5_ 9,1925,Taisho,14,122695,61895,60800
35 ,Yamaguchi,10_ 14,1925,Taisho,14,121124,62119,59005
35 ,Yamaguchi,15_ 19,1925,Taisho,14,100147,52010,48137
35 ,Yamaguchi,20_ 24,1925,Taisho,14,82072,41686,40386
35 ,Yamaguchi,25_ 29,1925,Taisho,14,77532,40326,37206
35 ,Yamaguchi,30_ 34,1925,Taisho,14,66587,35061,31526
35 ,Yamaguchi,35_ 39,1925,Taisho,14,62511,32380,30131
35 ,Yamaguchi,40_ 44,1925,Taisho,14,59579,30361,29218
35 ,Yamaguchi,45_ 49,1925,Taisho,14,58869,29641,29228
35 ,Yamaguchi,50_ 54,1925,Taisho,14,51999,25725,26274
35 ,Yamaguchi,55_ 59,1925,Taisho,14,43935,21410,22525
35 ,Yamaguchi,60_ 64,1925,Taisho,14,35419,16969,18450
35 ,Yamaguchi,65_ 69,1925,Taisho,14,30238,14449,15789
35 ,Yamaguchi,70_ 74,1925,Taisho,14,21075,9569,11506
35 ,Yamaguchi,75_ 79,1925,Taisho,14,12531,5342,7189
35 ,Yamaguchi,80_ 84,1925,Taisho,14,5370,2110,3260
35 ,Yamaguchi,over_85,1925,Taisho,14,1788,585,1203
35 ,Yamaguchi,total,1930,Showa,5,1135637,571642,563995
35 ,Yamaguchi,0_ 4,1930,Showa,5,148057,74714,73343
35 ,Yamaguchi,5_ 9,1930,Showa,5,132766,66937,65829
35 ,Yamaguchi,10_ 14,1930,Showa,5,118957,60291,58666
35 ,Yamaguchi,15_ 19,1930,Showa,5,107015,54871,52144
35 ,Yamaguchi,20_ 24,1930,Showa,5,87594,44068,43526
35 ,Yamaguchi,25_ 29,1930,Showa,5,78182,40072,38110
35 ,Yamaguchi,30_ 34,1930,Showa,5,73887,38598,35289
35 ,Yamaguchi,35_ 39,1930,Showa,5,63773,33449,30324
35 ,Yamaguchi,40_ 44,1930,Showa,5,58923,30449,28474
35 ,Yamaguchi,45_ 49,1930,Showa,5,56130,28412,27718
35 ,Yamaguchi,50_ 54,1930,Showa,5,54569,27244,27325
35 ,Yamaguchi,55_ 59,1930,Showa,5,47222,23026,24196
35 ,Yamaguchi,60_ 64,1930,Showa,5,38118,18157,19961
35 ,Yamaguchi,65_ 69,1930,Showa,5,28551,13264,15287
35 ,Yamaguchi,70_ 74,1930,Showa,5,21608,9845,11763
35 ,Yamaguchi,75_ 79,1930,Showa,5,12549,5361,7188
35 ,Yamaguchi,over_80,1930,Showa,5,7736,2884,4852
35 ,Yamaguchi,total,1935,Showa,10,1190542,598434,592108
35 ,Yamaguchi,0_ 4,1935,Showa,10,152583,77077,75506
35 ,Yamaguchi,5_ 9,1935,Showa,10,142130,72020,70110
35 ,Yamaguchi,10_ 14,1935,Showa,10,130764,66380,64384
35 ,Yamaguchi,15_ 19,1935,Showa,10,104576,52712,51864
35 ,Yamaguchi,20_ 24,1935,Showa,10,94137,46173,47964
35 ,Yamaguchi,25_ 29,1935,Showa,10,85090,43587,41503
35 ,Yamaguchi,30_ 34,1935,Showa,10,76352,39747,36605
35 ,Yamaguchi,35_ 39,1935,Showa,10,71851,37801,34050
35 ,Yamaguchi,40_ 44,1935,Showa,10,60493,31683,28810
35 ,Yamaguchi,45_ 49,1935,Showa,10,56046,28911,27135
35 ,Yamaguchi,50_ 54,1935,Showa,10,52428,26313,26115
35 ,Yamaguchi,55_ 59,1935,Showa,10,49808,24542,25266
35 ,Yamaguchi,60_ 64,1935,Showa,10,41521,19667,21854
35 ,Yamaguchi,65_ 69,1935,Showa,10,30788,14135,16653
35 ,Yamaguchi,70_ 74,1935,Showa,10,20786,9161,11625
35 ,Yamaguchi,75_ 79,1935,Showa,10,13036,5520,7516
35 ,Yamaguchi,over_80,1935,Showa,10,8153,3005,5148
35 ,Yamaguchi,total,1940,Showa,15,1293630,657785,635845
35 ,Yamaguchi,0_ 4,1940,Showa,15,141392,71851,69541
35 ,Yamaguchi,5_ 9,1940,Showa,15,151922,76912,75010
35 ,Yamaguchi,10_ 14,1940,Showa,15,155788,79163,76625
35 ,Yamaguchi,15_ 19,1940,Showa,15,124183,63179,61004
35 ,Yamaguchi,20_ 24,1940,Showa,15,103175,52966,50209
35 ,Yamaguchi,25_ 29,1940,Showa,15,98792,51479,47313
35 ,Yamaguchi,30_ 34,1940,Showa,15,88262,46591,41671
35 ,Yamaguchi,35_ 39,1940,Showa,15,77907,41352,36555
35 ,Yamaguchi,40_ 44,1940,Showa,15,71775,38432,33343
35 ,Yamaguchi,45_ 49,1940,Showa,15,58953,31027,27926
35 ,Yamaguchi,50_ 54,1940,Showa,15,53273,27301,25972
35 ,Yamaguchi,55_ 59,1940,Showa,15,48138,23778,24360
35 ,Yamaguchi,60_ 64,1940,Showa,15,43825,20890,22935
35 ,Yamaguchi,65_ 69,1940,Showa,15,33810,15374,18436
35 ,Yamaguchi,70_ 74,1940,Showa,15,22261,9632,12629
35 ,Yamaguchi,75_ 79,1940,Showa,15,12123,4983,7140
35 ,Yamaguchi,80_ 84,1940,Showa,15,5804,2198,3606
35 ,Yamaguchi,over_85,1940,Showa,15,2246,676,1570
35 ,Yamaguchi,total,1945,Showa,20,1356491,638167,718324
35 ,Yamaguchi,1_ 5,1945,Showa,20,173706,88429,85277
35 ,Yamaguchi,6_ 10,1945,Showa,20,156101,79266,76835
35 ,Yamaguchi,11_ 15,1945,Showa,20,159323,80694,78629
35 ,Yamaguchi,16_ 20,1945,Showa,20,142745,70691,72054
35 ,Yamaguchi,21_ 25,1945,Showa,20,100101,36938,63163
35 ,Yamaguchi,26_ 30,1945,Showa,20,84364,31583,52781
35 ,Yamaguchi,31_ 35,1945,Showa,20,82277,32361,49916
35 ,Yamaguchi,36_ 40,1945,Showa,20,77260,33040,44220
35 ,Yamaguchi,41_ 45,1945,Showa,20,75459,37409,38050
35 ,Yamaguchi,46_ 50,1945,Showa,20,70327,36368,33959
35 ,Yamaguchi,51_ 55,1945,Showa,20,57905,29708,28197
35 ,Yamaguchi,56_ 60,1945,Showa,20,51336,25647,25689
35 ,Yamaguchi,61_ 65,1945,Showa,20,43418,20692,22726
35 ,Yamaguchi,66_ 70,1945,Showa,20,36059,16399,19660
35 ,Yamaguchi,71_ 75,1945,Showa,20,25300,10794,14506
35 ,Yamaguchi,76_ 80,1945,Showa,20,13234,5367,7867
35 ,Yamaguchi,81_ 85,1945,Showa,20,5587,2101,3486
35 ,Yamaguchi,86以上,1945,Showa,20,1989,680,1309
35 ,Yamaguchi,total,1950,Showa,25,1540882,760220,780662
35 ,Yamaguchi,0_ 4,1950,Showa,25,209646,106714,102932
35 ,Yamaguchi,5_ 9,1950,Showa,25,173598,88279,85319
35 ,Yamaguchi,10_ 14,1950,Showa,25,153741,78050,75691
35 ,Yamaguchi,15_ 19,1950,Showa,25,151361,77895,73466
35 ,Yamaguchi,20_ 24,1950,Showa,25,136283,68306,67977
35 ,Yamaguchi,25_ 29,1950,Showa,25,113406,52396,61010
35 ,Yamaguchi,30_ 34,1950,Showa,25,96648,44467,52181
35 ,Yamaguchi,35_ 39,1950,Showa,25,93635,43829,49806
35 ,Yamaguchi,40_ 44,1950,Showa,25,83326,40363,42963
35 ,Yamaguchi,45_ 49,1950,Showa,25,74414,37610,36804
35 ,Yamaguchi,50_ 54,1950,Showa,25,66564,34222,32342
35 ,Yamaguchi,55_ 59,1950,Showa,25,54522,27695,26827
35 ,Yamaguchi,60_ 64,1950,Showa,25,45712,22318,23394
35 ,Yamaguchi,65_ 69,1950,Showa,25,36047,16675,19372
35 ,Yamaguchi,70_ 74,1950,Showa,25,27097,11846,15251
35 ,Yamaguchi,75_ 79,1950,Showa,25,15958,6339,9619
35 ,Yamaguchi,over_80,1950,Showa,25,8904,3203,5701
35 ,Yamaguchi,total,1955,Showa,30,1609839,792546,817293
35 ,Yamaguchi,0_ 4,1955,Showa,30,163740,84104,79636
35 ,Yamaguchi,5_ 9,1955,Showa,30,204531,104166,100365
35 ,Yamaguchi,10_ 14,1955,Showa,30,170718,86683,84035
35 ,Yamaguchi,15_ 19,1955,Showa,30,142973,72785,70188
35 ,Yamaguchi,20_ 24,1955,Showa,30,140314,69026,71288
35 ,Yamaguchi,25_ 29,1955,Showa,30,131896,65347,66549
35 ,Yamaguchi,30_ 34,1955,Showa,30,110847,51203,59644
35 ,Yamaguchi,35_ 39,1955,Showa,30,93740,42925,50815
35 ,Yamaguchi,40_ 44,1955,Showa,30,90468,42600,47868
35 ,Yamaguchi,45_ 49,1955,Showa,30,79730,38531,41199
35 ,Yamaguchi,50_ 54,1955,Showa,30,70499,35462,35037
35 ,Yamaguchi,55_ 59,1955,Showa,30,62180,31663,30517
35 ,Yamaguchi,60_ 64,1955,Showa,30,49179,24427,24752
35 ,Yamaguchi,65_ 69,1955,Showa,30,39118,18739,20379
35 ,Yamaguchi,70_ 74,1955,Showa,30,28738,12720,16018
35 ,Yamaguchi,75_ 79,1955,Showa,30,18823,7725,11098
35 ,Yamaguchi,80_ 84,1955,Showa,30,9048,3333,5715
35 ,Yamaguchi,over_85,1955,Showa,30,3281,1099,2182
35 ,Yamaguchi,total,1960,Showa,35,1602207,780439,821768
35 ,Yamaguchi,0_ 4,1960,Showa,35,129720,66283,63437
35 ,Yamaguchi,5_ 9,1960,Showa,35,160091,82151,77940
35 ,Yamaguchi,10_ 14,1960,Showa,35,200644,102053,98591
35 ,Yamaguchi,15_ 19,1960,Showa,35,143425,71907,71518
35 ,Yamaguchi,20_ 24,1960,Showa,35,121018,56855,64163
35 ,Yamaguchi,25_ 29,1960,Showa,35,132472,64151,68321
35 ,Yamaguchi,30_ 34,1960,Showa,35,126574,62363,64211
35 ,Yamaguchi,35_ 39,1960,Showa,35,106699,48884,57815
35 ,Yamaguchi,40_ 44,1960,Showa,35,89712,40892,48820
35 ,Yamaguchi,45_ 49,1960,Showa,35,86226,40148,46078
35 ,Yamaguchi,50_ 54,1960,Showa,35,75085,35932,39153
35 ,Yamaguchi,55_ 59,1960,Showa,35,65421,32311,33110
35 ,Yamaguchi,60_ 64,1960,Showa,35,56325,27933,28392
35 ,Yamaguchi,65_ 69,1960,Showa,35,42592,20570,22022
35 ,Yamaguchi,70_ 74,1960,Showa,35,31452,14401,17051
35 ,Yamaguchi,75_ 79,1960,Showa,35,19824,8218,11606
35 ,Yamaguchi,80_ 84,1960,Showa,35,10458,3942,6516
35 ,Yamaguchi,over_85,1960,Showa,35,4469,1445,3024
35 ,Yamaguchi,total,1965,Showa,40,1543573,740934,802639
35 ,Yamaguchi,0_ 4,1965,Showa,40,116486,59236,57250
35 ,Yamaguchi,5_ 9,1965,Showa,40,124034,62836,61198
35 ,Yamaguchi,10_ 14,1965,Showa,40,153440,78135,75305
35 ,Yamaguchi,15_ 19,1965,Showa,40,163589,81590,81999
35 ,Yamaguchi,20_ 24,1965,Showa,40,113217,50406,62811
35 ,Yamaguchi,25_ 29,1965,Showa,40,111683,51827,59856
35 ,Yamaguchi,30_ 34,1965,Showa,40,124751,60299,64452
35 ,Yamaguchi,35_ 39,1965,Showa,40,120050,58845,61205
35 ,Yamaguchi,40_ 44,1965,Showa,40,100894,45838,55056
35 ,Yamaguchi,45_ 49,1965,Showa,40,84922,38402,46520
35 ,Yamaguchi,50_ 54,1965,Showa,40,80647,37219,43428
35 ,Yamaguchi,55_ 59,1965,Showa,40,69338,32846,36492
35 ,Yamaguchi,60_ 64,1965,Showa,40,58893,28705,30188
35 ,Yamaguchi,65_ 69,1965,Showa,40,48921,23558,25363
35 ,Yamaguchi,70_ 74,1965,Showa,40,34309,15841,18468
35 ,Yamaguchi,75_ 79,1965,Showa,40,22051,9512,12539
35 ,Yamaguchi,80_ 84,1965,Showa,40,11001,4131,6870
35 ,Yamaguchi,over_85,1965,Showa,40,5347,1708,3639
35 ,Yamaguchi,total,1970,Showa,45,1511448,719147,792301
35 ,Yamaguchi,0_ 4,1970,Showa,45,114798,58422,56376
35 ,Yamaguchi,5_ 9,1970,Showa,45,113196,57858,55338
35 ,Yamaguchi,10_ 14,1970,Showa,45,120368,61220,59148
35 ,Yamaguchi,15_ 19,1970,Showa,45,125618,62615,63003
35 ,Yamaguchi,20_ 24,1970,Showa,45,127695,56122,71573
35 ,Yamaguchi,25_ 29,1970,Showa,45,112630,52705,59925
35 ,Yamaguchi,30_ 34,1970,Showa,45,108513,51388,57125
35 ,Yamaguchi,35_ 39,1970,Showa,45,120694,58436,62258
35 ,Yamaguchi,40_ 44,1970,Showa,45,113812,55666,58146
35 ,Yamaguchi,45_ 49,1970,Showa,45,97162,43791,53371
35 ,Yamaguchi,50_ 54,1970,Showa,45,80996,36210,44786
35 ,Yamaguchi,55_ 59,1970,Showa,45,74903,34146,40757
35 ,Yamaguchi,60_ 64,1970,Showa,45,63816,29447,34369
35 ,Yamaguchi,65_ 69,1970,Showa,45,52116,24411,27705
35 ,Yamaguchi,70_ 74,1970,Showa,45,40710,18659,22051
35 ,Yamaguchi,75_ 79,1970,Showa,45,25052,10886,14166
35 ,Yamaguchi,80_ 84,1970,Showa,45,13236,5131,8105
35 ,Yamaguchi,over_85,1970,Showa,45,6133,2034,4099
35 ,Yamaguchi,total,1975,Showa,50,1555218,743833,811385
35 ,Yamaguchi,0_ 4,1975,Showa,50,127651,65630,62021
35 ,Yamaguchi,5_ 9,1975,Showa,50,115509,58845,56664
35 ,Yamaguchi,10_ 14,1975,Showa,50,112497,57511,54986
35 ,Yamaguchi,15_ 19,1975,Showa,50,105455,52807,52648
35 ,Yamaguchi,20_ 24,1975,Showa,50,103871,48150,55721
35 ,Yamaguchi,25_ 29,1975,Showa,50,133481,64134,69347
35 ,Yamaguchi,30_ 34,1975,Showa,50,115023,55496,59527
35 ,Yamaguchi,35_ 39,1975,Showa,50,108802,51924,56878
35 ,Yamaguchi,40_ 44,1975,Showa,50,119230,57824,61406
35 ,Yamaguchi,45_ 49,1975,Showa,50,112437,54826,57611
35 ,Yamaguchi,50_ 54,1975,Showa,50,93695,41952,51743
35 ,Yamaguchi,55_ 59,1975,Showa,50,77507,34220,43287
35 ,Yamaguchi,60_ 64,1975,Showa,50,71790,32148,39642
35 ,Yamaguchi,65_ 69,1975,Showa,50,58472,26155,32317
35 ,Yamaguchi,70_ 74,1975,Showa,50,44847,20025,24822
35 ,Yamaguchi,75_ 79,1975,Showa,50,30967,13167,17800
35 ,Yamaguchi,80_ 84,1975,Showa,50,15919,6299,9620
35 ,Yamaguchi,over_85,1975,Showa,50,7837,2573,5264
35 ,Yamaguchi,total,1980,Showa,55,1587079,759255,827824
35 ,Yamaguchi,0_ 4,1980,Showa,55,108570,55650,52920
35 ,Yamaguchi,5_ 9,1980,Showa,55,129724,66704,63020
35 ,Yamaguchi,10_ 14,1980,Showa,55,116110,59109,57001
35 ,Yamaguchi,15_ 19,1980,Showa,55,101102,51140,49962
35 ,Yamaguchi,20_ 24,1980,Showa,55,86391,39674,46717
35 ,Yamaguchi,25_ 29,1980,Showa,55,109394,53540,55854
35 ,Yamaguchi,30_ 34,1980,Showa,55,135938,66691,69247
35 ,Yamaguchi,35_ 39,1980,Showa,55,115480,55869,59611
35 ,Yamaguchi,40_ 44,1980,Showa,55,108013,51503,56510
35 ,Yamaguchi,45_ 49,1980,Showa,55,116974,56521,60453
35 ,Yamaguchi,50_ 54,1980,Showa,55,109913,53103,56810
35 ,Yamaguchi,55_ 59,1980,Showa,55,90937,40217,50720
35 ,Yamaguchi,60_ 64,1980,Showa,55,73995,32220,41775
35 ,Yamaguchi,65_ 69,1980,Showa,55,66208,28924,37284
35 ,Yamaguchi,70_ 74,1980,Showa,55,51253,21835,29418
35 ,Yamaguchi,75_ 79,1980,Showa,55,35615,14855,20760
35 ,Yamaguchi,80_ 84,1980,Showa,55,20601,7969,12632
35 ,Yamaguchi,over_85,1980,Showa,55,10483,3498,6985
35 ,Yamaguchi,total,1985,Showa,60,1601627,763803,837824
35 ,Yamaguchi,0_ 4,1985,Showa,60,93505,47670,45835
35 ,Yamaguchi,5_ 9,1985,Showa,60,109857,56240,53617
35 ,Yamaguchi,10_ 14,1985,Showa,60,130561,67167,63394
35 ,Yamaguchi,15_ 19,1985,Showa,60,107065,54049,53016
35 ,Yamaguchi,20_ 24,1985,Showa,60,81492,37829,43663
35 ,Yamaguchi,25_ 29,1985,Showa,60,89412,42807,46605
35 ,Yamaguchi,30_ 34,1985,Showa,60,110238,54650,55588
35 ,Yamaguchi,35_ 39,1985,Showa,60,136792,67166,69626
35 ,Yamaguchi,40_ 44,1985,Showa,60,115185,55752,59433
35 ,Yamaguchi,45_ 49,1985,Showa,60,106479,50687,55792
35 ,Yamaguchi,50_ 54,1985,Showa,60,114546,54808,59738
35 ,Yamaguchi,55_ 59,1985,Showa,60,106627,50894,55733
35 ,Yamaguchi,60_ 64,1985,Showa,60,87600,38119,49481
35 ,Yamaguchi,65_ 69,1985,Showa,60,69421,29482,39939
35 ,Yamaguchi,70_ 74,1985,Showa,60,59498,24918,34580
35 ,Yamaguchi,75_ 79,1985,Showa,60,42579,16998,25581
35 ,Yamaguchi,80_ 84,1985,Showa,60,25416,9553,15863
35 ,Yamaguchi,over_85,1985,Showa,60,15323,4997,10326
35 ,Yamaguchi,total,1990,Heisei,2,1572616,744844,827772
35 ,Yamaguchi,0_ 4,1990,Heisei,2,76522,39206,37316
35 ,Yamaguchi,5_ 9,1990,Heisei,2,93088,47435,45653
35 ,Yamaguchi,10_ 14,1990,Heisei,2,108952,55874,53078
35 ,Yamaguchi,15_ 19,1990,Heisei,2,118620,60231,58389
35 ,Yamaguchi,20_ 24,1990,Heisei,2,83493,38890,44603
35 ,Yamaguchi,25_ 29,1990,Heisei,2,79968,37779,42189
35 ,Yamaguchi,30_ 34,1990,Heisei,2,87442,42277,45165
35 ,Yamaguchi,35_ 39,1990,Heisei,2,108786,53830,54956
35 ,Yamaguchi,40_ 44,1990,Heisei,2,134505,65854,68651
35 ,Yamaguchi,45_ 49,1990,Heisei,2,112430,54127,58303
35 ,Yamaguchi,50_ 54,1990,Heisei,2,103737,48750,54987
35 ,Yamaguchi,55_ 59,1990,Heisei,2,111162,52350,58812
35 ,Yamaguchi,60_ 64,1990,Heisei,2,102767,48308,54459
35 ,Yamaguchi,65_ 69,1990,Heisei,2,82614,35092,47522
35 ,Yamaguchi,70_ 74,1990,Heisei,2,63412,25872,37540
35 ,Yamaguchi,75_ 79,1990,Heisei,2,50769,19916,30853
35 ,Yamaguchi,80_ 84,1990,Heisei,2,31600,11362,20238
35 ,Yamaguchi,over_85,1990,Heisei,2,21093,6570,14523
35 ,Yamaguchi,total,1995,Heisei,7,1555543,736555,818988
35 ,Yamaguchi,0_ 4,1995,Heisei,7,68477,35223,33254
35 ,Yamaguchi,5_ 9,1995,Heisei,7,78163,40110,38053
35 ,Yamaguchi,10_ 14,1995,Heisei,7,93829,47761,46068
35 ,Yamaguchi,15_ 19,1995,Heisei,7,102240,52492,49748
35 ,Yamaguchi,20_ 24,1995,Heisei,7,98430,49028,49402
35 ,Yamaguchi,25_ 29,1995,Heisei,7,83675,39408,44267
35 ,Yamaguchi,30_ 34,1995,Heisei,7,80800,39050,41750
35 ,Yamaguchi,35_ 39,1995,Heisei,7,88903,43219,45684
35 ,Yamaguchi,40_ 44,1995,Heisei,7,109314,54323,54991
35 ,Yamaguchi,45_ 49,1995,Heisei,7,134110,65911,68199
35 ,Yamaguchi,50_ 54,1995,Heisei,7,111144,53179,57965
35 ,Yamaguchi,55_ 59,1995,Heisei,7,102328,47668,54660
35 ,Yamaguchi,60_ 64,1995,Heisei,7,107895,50131,57764
35 ,Yamaguchi,65_ 69,1995,Heisei,7,97473,44743,52730
35 ,Yamaguchi,70_ 74,1995,Heisei,7,75998,31049,44949
35 ,Yamaguchi,75_ 79,1995,Heisei,7,54577,20880,33697
35 ,Yamaguchi,80_ 84,1995,Heisei,7,39108,13799,25309
35 ,Yamaguchi,over_85,1995,Heisei,7,28546,8228,20318
35 ,Yamaguchi,total,2000,Heisei,12,1527964,722683,805281
35 ,Yamaguchi,0_ 4,2000,Heisei,12,65698,33686,32012
35 ,Yamaguchi,5_ 9,2000,Heisei,12,69409,35754,33655
35 ,Yamaguchi,10_ 14,2000,Heisei,12,78471,40226,38245
35 ,Yamaguchi,15_ 19,2000,Heisei,12,86694,44484,42210
35 ,Yamaguchi,20_ 24,2000,Heisei,12,83410,42068,41342
35 ,Yamaguchi,25_ 29,2000,Heisei,12,98150,48721,49429
35 ,Yamaguchi,30_ 34,2000,Heisei,12,84568,40619,43949
35 ,Yamaguchi,35_ 39,2000,Heisei,12,81481,39550,41931
35 ,Yamaguchi,40_ 44,2000,Heisei,12,89093,43496,45597
35 ,Yamaguchi,45_ 49,2000,Heisei,12,108176,53652,54524
35 ,Yamaguchi,50_ 54,2000,Heisei,12,132411,64725,67686
35 ,Yamaguchi,55_ 59,2000,Heisei,12,109521,51903,57618
35 ,Yamaguchi,60_ 64,2000,Heisei,12,100627,46491,54136
35 ,Yamaguchi,65_ 69,2000,Heisei,12,102490,46548,55942
35 ,Yamaguchi,70_ 74,2000,Heisei,12,89583,39585,49998
35 ,Yamaguchi,75_ 79,2000,Heisei,12,66425,25441,40984
35 ,Yamaguchi,80_ 84,2000,Heisei,12,42896,14791,28105
35 ,Yamaguchi,over_85,2000,Heisei,12,38442,10670,27772
35 ,Yamaguchi,total,2005,Heisei,17,1492606,703721,788885
35 ,Yamaguchi,0_ 4,2005,Heisei,17,61157,31086,30071
35 ,Yamaguchi,5_ 9,2005,Heisei,17,66264,34001,32263
35 ,Yamaguchi,10_ 14,2005,Heisei,17,69308,35697,33611
35 ,Yamaguchi,15_ 19,2005,Heisei,17,73098,37779,35319
35 ,Yamaguchi,20_ 24,2005,Heisei,17,71789,36143,35646
35 ,Yamaguchi,25_ 29,2005,Heisei,17,80982,40082,40900
35 ,Yamaguchi,30_ 34,2005,Heisei,17,96885,48448,48437
35 ,Yamaguchi,35_ 39,2005,Heisei,17,84043,40410,43633
35 ,Yamaguchi,40_ 44,2005,Heisei,17,80727,39139,41588
35 ,Yamaguchi,45_ 49,2005,Heisei,17,87816,42708,45108
35 ,Yamaguchi,50_ 54,2005,Heisei,17,106719,52605,54114
35 ,Yamaguchi,55_ 59,2005,Heisei,17,130578,63184,67394
35 ,Yamaguchi,60_ 64,2005,Heisei,17,107894,50754,57140
35 ,Yamaguchi,65_ 69,2005,Heisei,17,96504,43811,52693
35 ,Yamaguchi,70_ 74,2005,Heisei,17,95117,41733,53384
35 ,Yamaguchi,75_ 79,2005,Heisei,17,79548,33179,46369
35 ,Yamaguchi,80_ 84,2005,Heisei,17,54203,18897,35306
35 ,Yamaguchi,over_85,2005,Heisei,17,47974,12779,35195
35 ,Yamaguchi,total,2010,Heisei,22,1451338,684176,767162
35 ,Yamaguchi,0_ 4,2010,Heisei,22,56579,28886,27693
35 ,Yamaguchi,5_ 9,2010,Heisei,22,61505,31306,30199
35 ,Yamaguchi,10_ 14,2010,Heisei,22,65965,33818,32147
35 ,Yamaguchi,15_ 19,2010,Heisei,22,65331,33728,31603
35 ,Yamaguchi,20_ 24,2010,Heisei,22,61443,31310,30133
35 ,Yamaguchi,25_ 29,2010,Heisei,22,69179,34536,34643
35 ,Yamaguchi,30_ 34,2010,Heisei,22,80819,40350,40469
35 ,Yamaguchi,35_ 39,2010,Heisei,22,96865,48615,48250
35 ,Yamaguchi,40_ 44,2010,Heisei,22,83557,40260,43297
35 ,Yamaguchi,45_ 49,2010,Heisei,22,79825,38736,41089
35 ,Yamaguchi,50_ 54,2010,Heisei,22,86793,42095,44698
35 ,Yamaguchi,55_ 59,2010,Heisei,22,105300,51434,53866
35 ,Yamaguchi,60_ 64,2010,Heisei,22,128844,61944,66900
35 ,Yamaguchi,65_ 69,2010,Heisei,22,103800,48102,55698
35 ,Yamaguchi,70_ 74,2010,Heisei,22,90112,39798,50314
35 ,Yamaguchi,75_ 79,2010,Heisei,22,84828,35219,49609
35 ,Yamaguchi,80_ 84,2010,Heisei,22,64965,24753,40212
35 ,Yamaguchi,over_85,2010,Heisei,22,60989,16081,44908
35 ,Yamaguchi,total,2015,Heisei,27,1404729,665008,739721
35 ,Yamaguchi,0_ 4,2015,Heisei,27,52092,26760,25332
35 ,Yamaguchi,5_ 9,2015,Heisei,27,56723,28984,27739
35 ,Yamaguchi,10_ 14,2015,Heisei,27,61207,31254,29953
35 ,Yamaguchi,15_ 19,2015,Heisei,27,63772,33001,30771
35 ,Yamaguchi,20_ 24,2015,Heisei,27,56419,29435,26984
35 ,Yamaguchi,25_ 29,2015,Heisei,27,59734,30712,29022
35 ,Yamaguchi,30_ 34,2015,Heisei,27,69356,34766,34590
35 ,Yamaguchi,35_ 39,2015,Heisei,27,80970,40501,40469
35 ,Yamaguchi,40_ 44,2015,Heisei,27,96600,48496,48104
35 ,Yamaguchi,45_ 49,2015,Heisei,27,82865,40040,42825
35 ,Yamaguchi,50_ 54,2015,Heisei,27,78911,38271,40640
35 ,Yamaguchi,55_ 59,2015,Heisei,27,85893,41351,44542
35 ,Yamaguchi,60_ 64,2015,Heisei,27,103910,50542,53368
35 ,Yamaguchi,65_ 69,2015,Heisei,27,124489,59131,65358
35 ,Yamaguchi,70_ 74,2015,Heisei,27,97453,44034,53419
35 ,Yamaguchi,75_ 79,2015,Heisei,27,81201,34378,46823
35 ,Yamaguchi,80_ 84,2015,Heisei,27,70469,27004,43465
35 ,Yamaguchi,over_85,2015,Heisei,27,74250,21181,53069
36 ,Tokushima,total,1920,Taisho,9,670212,331768,338444
36 ,Tokushima,0_ 4,1920,Taisho,9,89496,45221,44275
36 ,Tokushima,5_ 9,1920,Taisho,9,85131,43294,41837
36 ,Tokushima,10_ 14,1920,Taisho,9,73837,37099,36738
36 ,Tokushima,15_ 19,1920,Taisho,9,57961,28504,29457
36 ,Tokushima,20_ 24,1920,Taisho,9,45567,21571,23996
36 ,Tokushima,25_ 29,1920,Taisho,9,37356,18681,18675
36 ,Tokushima,30_ 34,1920,Taisho,9,38425,19045,19380
36 ,Tokushima,35_ 39,1920,Taisho,9,38346,18788,19558
36 ,Tokushima,40_ 44,1920,Taisho,9,37718,18649,19069
36 ,Tokushima,45_ 49,1920,Taisho,9,35627,17798,17829
36 ,Tokushima,50_ 54,1920,Taisho,9,29032,14550,14482
36 ,Tokushima,55_ 59,1920,Taisho,9,25752,12786,12966
36 ,Tokushima,60_ 64,1920,Taisho,9,26696,13247,13449
36 ,Tokushima,65_ 69,1920,Taisho,9,20194,9744,10450
36 ,Tokushima,70_ 74,1920,Taisho,9,14924,6936,7988
36 ,Tokushima,75_ 79,1920,Taisho,9,8865,3887,4978
36 ,Tokushima,over_80,1920,Taisho,9,5285,1968,3317
36 ,Tokushima,total,1925,Taisho,14,689814,344550,345264
36 ,Tokushima,0_ 4,1925,Taisho,14,94404,47708,46696
36 ,Tokushima,5_ 9,1925,Taisho,14,82945,42002,40943
36 ,Tokushima,10_ 14,1925,Taisho,14,79400,40215,39185
36 ,Tokushima,15_ 19,1925,Taisho,14,60099,29663,30436
36 ,Tokushima,20_ 24,1925,Taisho,14,50706,25404,25302
36 ,Tokushima,25_ 29,1925,Taisho,14,44617,22879,21738
36 ,Tokushima,30_ 34,1925,Taisho,14,35769,18299,17470
36 ,Tokushima,35_ 39,1925,Taisho,14,36598,18429,18169
36 ,Tokushima,40_ 44,1925,Taisho,14,35974,17945,18029
36 ,Tokushima,45_ 49,1925,Taisho,14,35648,17718,17930
36 ,Tokushima,50_ 54,1925,Taisho,14,33013,16466,16547
36 ,Tokushima,55_ 59,1925,Taisho,14,26010,12935,13075
36 ,Tokushima,60_ 64,1925,Taisho,14,22487,11016,11471
36 ,Tokushima,65_ 69,1925,Taisho,14,21512,10403,11109
36 ,Tokushima,70_ 74,1925,Taisho,14,15120,7030,8090
36 ,Tokushima,75_ 79,1925,Taisho,14,9334,4111,5223
36 ,Tokushima,80_ 84,1925,Taisho,14,4449,1761,2688
36 ,Tokushima,over_85,1925,Taisho,14,1729,566,1163
36 ,Tokushima,total,1930,Showa,5,716544,356958,359586
36 ,Tokushima,0_ 4,1930,Showa,5,100875,50877,49998
36 ,Tokushima,5_ 9,1930,Showa,5,88794,45029,43765
36 ,Tokushima,10_ 14,1930,Showa,5,77740,39154,38586
36 ,Tokushima,15_ 19,1930,Showa,5,65454,32058,33396
36 ,Tokushima,20_ 24,1930,Showa,5,52674,25941,26733
36 ,Tokushima,25_ 29,1930,Showa,5,47632,24079,23553
36 ,Tokushima,30_ 34,1930,Showa,5,42344,21877,20467
36 ,Tokushima,35_ 39,1930,Showa,5,34070,17394,16676
36 ,Tokushima,40_ 44,1930,Showa,5,34933,17660,17273
36 ,Tokushima,45_ 49,1930,Showa,5,34038,16880,17158
36 ,Tokushima,50_ 54,1930,Showa,5,33249,16484,16765
36 ,Tokushima,55_ 59,1930,Showa,5,29923,14808,15115
36 ,Tokushima,60_ 64,1930,Showa,5,23039,11349,11690
36 ,Tokushima,65_ 69,1930,Showa,5,18601,8859,9742
36 ,Tokushima,70_ 74,1930,Showa,5,16501,7639,8862
36 ,Tokushima,75_ 79,1930,Showa,5,9625,4148,5477
36 ,Tokushima,over_80,1930,Showa,5,7052,2722,4330
36 ,Tokushima,total,1935,Showa,10,728748,362042,366706
36 ,Tokushima,0_ 4,1935,Showa,10,100318,50568,49750
36 ,Tokushima,5_ 9,1935,Showa,10,94772,47874,46898
36 ,Tokushima,10_ 14,1935,Showa,10,82534,41478,41056
36 ,Tokushima,15_ 19,1935,Showa,10,58478,28521,29957
36 ,Tokushima,20_ 24,1935,Showa,10,53357,25604,27753
36 ,Tokushima,25_ 29,1935,Showa,10,48644,24308,24336
36 ,Tokushima,30_ 34,1935,Showa,10,45164,22967,22197
36 ,Tokushima,35_ 39,1935,Showa,10,40553,21035,19518
36 ,Tokushima,40_ 44,1935,Showa,10,32217,16572,15645
36 ,Tokushima,45_ 49,1935,Showa,10,33046,16684,16362
36 ,Tokushima,50_ 54,1935,Showa,10,31527,15546,15981
36 ,Tokushima,55_ 59,1935,Showa,10,30245,14873,15372
36 ,Tokushima,60_ 64,1935,Showa,10,26491,12889,13602
36 ,Tokushima,65_ 69,1935,Showa,10,19203,9156,10047
36 ,Tokushima,70_ 74,1935,Showa,10,14105,6454,7651
36 ,Tokushima,75_ 79,1935,Showa,10,10627,4665,5962
36 ,Tokushima,over_80,1935,Showa,10,7467,2848,4619
36 ,Tokushima,total,1940,Showa,15,718645,354378,364267
36 ,Tokushima,0_ 4,1940,Showa,15,91501,46179,45322
36 ,Tokushima,5_ 9,1940,Showa,15,93355,47188,46167
36 ,Tokushima,10_ 14,1940,Showa,15,87605,43774,43831
36 ,Tokushima,15_ 19,1940,Showa,15,59232,27647,31585
36 ,Tokushima,20_ 24,1940,Showa,15,50312,25959,24353
36 ,Tokushima,25_ 29,1940,Showa,15,46274,22136,24138
36 ,Tokushima,30_ 34,1940,Showa,15,43503,21187,22316
36 ,Tokushima,35_ 39,1940,Showa,15,41589,20722,20867
36 ,Tokushima,40_ 44,1940,Showa,15,37192,19047,18145
36 ,Tokushima,45_ 49,1940,Showa,15,29747,15057,14690
36 ,Tokushima,50_ 54,1940,Showa,15,30367,15163,15204
36 ,Tokushima,55_ 59,1940,Showa,15,28640,13948,14692
36 ,Tokushima,60_ 64,1940,Showa,15,26342,12691,13651
36 ,Tokushima,65_ 69,1940,Showa,15,21774,10202,11572
36 ,Tokushima,70_ 74,1940,Showa,15,14484,6655,7829
36 ,Tokushima,75_ 79,1940,Showa,15,9010,3868,5142
36 ,Tokushima,80_ 84,1940,Showa,15,5394,2160,3234
36 ,Tokushima,over_85,1940,Showa,15,2324,795,1529
36 ,Tokushima,total,1945,Showa,20,835763,386052,449711
36 ,Tokushima,1_ 5,1945,Showa,20,107467,54295,53172
36 ,Tokushima,6_ 10,1945,Showa,20,103635,52288,51347
36 ,Tokushima,11_ 15,1945,Showa,20,105626,53114,52512
36 ,Tokushima,16_ 20,1945,Showa,20,88308,41585,46723
36 ,Tokushima,21_ 25,1945,Showa,20,59931,21636,38295
36 ,Tokushima,26_ 30,1945,Showa,20,45245,14006,31239
36 ,Tokushima,31_ 35,1945,Showa,20,47064,17106,29958
36 ,Tokushima,36_ 40,1945,Showa,20,46072,19797,26275
36 ,Tokushima,41_ 45,1945,Showa,20,45553,22436,23117
36 ,Tokushima,46_ 50,1945,Showa,20,40109,20500,19609
36 ,Tokushima,51_ 55,1945,Showa,20,31428,15885,15543
36 ,Tokushima,56_ 60,1945,Showa,20,30508,15152,15356
36 ,Tokushima,61_ 65,1945,Showa,20,27104,12932,14172
36 ,Tokushima,66_ 70,1945,Showa,20,23602,10901,12701
36 ,Tokushima,71_ 75,1945,Showa,20,17612,7813,9799
36 ,Tokushima,76_ 80,1945,Showa,20,9694,4101,5593
36 ,Tokushima,81_ 85,1945,Showa,20,4572,1756,2816
36 ,Tokushima,86以上,1945,Showa,20,2233,749,1484
36 ,Tokushima,total,1950,Showa,25,878511,427684,450827
36 ,Tokushima,0_ 4,1950,Showa,25,120439,61471,58968
36 ,Tokushima,5_ 9,1950,Showa,25,100586,50812,49774
36 ,Tokushima,10_ 14,1950,Showa,25,98069,49501,48568
36 ,Tokushima,15_ 19,1950,Showa,25,89347,45052,44295
36 ,Tokushima,20_ 24,1950,Showa,25,75427,36264,39163
36 ,Tokushima,25_ 29,1950,Showa,25,58759,26681,32078
36 ,Tokushima,30_ 34,1950,Showa,25,49137,21753,27384
36 ,Tokushima,35_ 39,1950,Showa,25,49039,21763,27276
36 ,Tokushima,40_ 44,1950,Showa,25,45311,21587,23724
36 ,Tokushima,45_ 49,1950,Showa,25,42332,21183,21149
36 ,Tokushima,50_ 54,1950,Showa,25,36523,18716,17807
36 ,Tokushima,55_ 59,1950,Showa,25,28356,14204,14152
36 ,Tokushima,60_ 64,1950,Showa,25,26939,13085,13854
36 ,Tokushima,65_ 69,1950,Showa,25,21988,10254,11734
36 ,Tokushima,70_ 74,1950,Showa,25,17617,7882,9735
36 ,Tokushima,75_ 79,1950,Showa,25,11363,4782,6581
36 ,Tokushima,over_80,1950,Showa,25,7098,2623,4475
36 ,Tokushima,total,1955,Showa,30,878109,427204,450905
36 ,Tokushima,0_ 4,1955,Showa,30,93978,48113,45865
36 ,Tokushima,5_ 9,1955,Showa,30,114630,58476,56154
36 ,Tokushima,10_ 14,1955,Showa,30,96733,48829,47904
36 ,Tokushima,15_ 19,1955,Showa,30,78184,38556,39628
36 ,Tokushima,20_ 24,1955,Showa,30,72518,34672,37846
36 ,Tokushima,25_ 29,1955,Showa,30,69584,33947,35637
36 ,Tokushima,30_ 34,1955,Showa,30,55443,25365,30078
36 ,Tokushima,35_ 39,1955,Showa,30,46580,20743,25837
36 ,Tokushima,40_ 44,1955,Showa,30,46452,20680,25772
36 ,Tokushima,45_ 49,1955,Showa,30,42896,20422,22474
36 ,Tokushima,50_ 54,1955,Showa,30,39657,19897,19760
36 ,Tokushima,55_ 59,1955,Showa,30,34040,17421,16619
36 ,Tokushima,60_ 64,1955,Showa,30,25452,12622,12830
36 ,Tokushima,65_ 69,1955,Showa,30,22959,10971,11988
36 ,Tokushima,70_ 74,1955,Showa,30,17436,7838,9598
36 ,Tokushima,75_ 79,1955,Showa,30,12341,5217,7124
36 ,Tokushima,80_ 84,1955,Showa,30,6485,2557,3928
36 ,Tokushima,over_85,1955,Showa,30,2738,878,1860
36 ,Tokushima,total,1960,Showa,35,847274,408300,438974
36 ,Tokushima,0_ 4,1960,Showa,35,70834,36135,34699
36 ,Tokushima,5_ 9,1960,Showa,35,92043,47031,45012
36 ,Tokushima,10_ 14,1960,Showa,35,112397,57344,55053
36 ,Tokushima,15_ 19,1960,Showa,35,68040,32760,35280
36 ,Tokushima,20_ 24,1960,Showa,35,58221,26179,32042
36 ,Tokushima,25_ 29,1960,Showa,35,65698,31839,33859
36 ,Tokushima,30_ 34,1960,Showa,35,66046,32045,34001
36 ,Tokushima,35_ 39,1960,Showa,35,53258,24179,29079
36 ,Tokushima,40_ 44,1960,Showa,35,44773,19811,24962
36 ,Tokushima,45_ 49,1960,Showa,35,44037,19506,24531
36 ,Tokushima,50_ 54,1960,Showa,35,40558,19116,21442
36 ,Tokushima,55_ 59,1960,Showa,35,37168,18394,18774
36 ,Tokushima,60_ 64,1960,Showa,35,30934,15584,15350
36 ,Tokushima,65_ 69,1960,Showa,35,22010,10625,11385
36 ,Tokushima,70_ 74,1960,Showa,35,18428,8542,9886
36 ,Tokushima,75_ 79,1960,Showa,35,12220,5236,6984
36 ,Tokushima,80_ 84,1960,Showa,35,7090,2759,4331
36 ,Tokushima,over_85,1960,Showa,35,3519,1215,2304
36 ,Tokushima,total,1965,Showa,40,815115,389795,425320
36 ,Tokushima,0_ 4,1965,Showa,40,59661,30295,29366
36 ,Tokushima,5_ 9,1965,Showa,40,69785,35286,34499
36 ,Tokushima,10_ 14,1965,Showa,40,89833,45581,44252
36 ,Tokushima,15_ 19,1965,Showa,40,85323,41563,43760
36 ,Tokushima,20_ 24,1965,Showa,40,52054,22508,29546
36 ,Tokushima,25_ 29,1965,Showa,40,54264,25816,28448
36 ,Tokushima,30_ 34,1965,Showa,40,63664,31250,32414
36 ,Tokushima,35_ 39,1965,Showa,40,64429,31232,33197
36 ,Tokushima,40_ 44,1965,Showa,40,51528,23350,28178
36 ,Tokushima,45_ 49,1965,Showa,40,42989,18990,23999
36 ,Tokushima,50_ 54,1965,Showa,40,41871,18479,23392
36 ,Tokushima,55_ 59,1965,Showa,40,37817,17830,19987
36 ,Tokushima,60_ 64,1965,Showa,40,33678,16490,17188
36 ,Tokushima,65_ 69,1965,Showa,40,26901,13266,13635
36 ,Tokushima,70_ 74,1965,Showa,40,17731,8247,9484
36 ,Tokushima,75_ 79,1965,Showa,40,12970,5693,7277
36 ,Tokushima,80_ 84,1965,Showa,40,6795,2638,4157
36 ,Tokushima,over_85,1965,Showa,40,3822,1281,2541
36 ,Tokushima,total,1970,Showa,45,791111,376729,414382
36 ,Tokushima,0_ 4,1970,Showa,45,54773,28073,26700
36 ,Tokushima,5_ 9,1970,Showa,45,60082,30652,29430
36 ,Tokushima,10_ 14,1970,Showa,45,69023,35023,34000
36 ,Tokushima,15_ 19,1970,Showa,45,69258,33385,35873
36 ,Tokushima,20_ 24,1970,Showa,45,64563,28988,35575
36 ,Tokushima,25_ 29,1970,Showa,45,52088,24831,27257
36 ,Tokushima,30_ 34,1970,Showa,45,54189,26198,27991
36 ,Tokushima,35_ 39,1970,Showa,45,62903,30940,31963
36 ,Tokushima,40_ 44,1970,Showa,45,62404,30192,32212
36 ,Tokushima,45_ 49,1970,Showa,45,50256,22677,27579
36 ,Tokushima,50_ 54,1970,Showa,45,41215,18078,23137
36 ,Tokushima,55_ 59,1970,Showa,45,39318,17212,22106
36 ,Tokushima,60_ 64,1970,Showa,45,34974,16120,18854
36 ,Tokushima,65_ 69,1970,Showa,45,29714,14089,15625
36 ,Tokushima,70_ 74,1970,Showa,45,22003,10318,11685
36 ,Tokushima,75_ 79,1970,Showa,45,12757,5559,7198
36 ,Tokushima,80_ 84,1970,Showa,45,7697,3113,4584
36 ,Tokushima,over_85,1970,Showa,45,3894,1281,2613
36 ,Tokushima,total,1975,Showa,50,805166,384812,420354
36 ,Tokushima,0_ 4,1975,Showa,50,60664,30865,29799
36 ,Tokushima,5_ 9,1975,Showa,50,56463,28975,27488
36 ,Tokushima,10_ 14,1975,Showa,50,60428,30856,29572
36 ,Tokushima,15_ 19,1975,Showa,50,58693,28399,30294
36 ,Tokushima,20_ 24,1975,Showa,50,55736,25171,30565
36 ,Tokushima,25_ 29,1975,Showa,50,67719,33793,33926
36 ,Tokushima,30_ 34,1975,Showa,50,54026,26481,27545
36 ,Tokushima,35_ 39,1975,Showa,50,54914,26701,28213
36 ,Tokushima,40_ 44,1975,Showa,50,62348,30613,31735
36 ,Tokushima,45_ 49,1975,Showa,50,61695,29817,31878
36 ,Tokushima,50_ 54,1975,Showa,50,48621,21786,26835
36 ,Tokushima,55_ 59,1975,Showa,50,39694,17290,22404
36 ,Tokushima,60_ 64,1975,Showa,50,37603,16195,21408
36 ,Tokushima,65_ 69,1975,Showa,50,32034,14385,17649
36 ,Tokushima,70_ 74,1975,Showa,50,25270,11456,13814
36 ,Tokushima,75_ 79,1975,Showa,50,16634,7276,9358
36 ,Tokushima,80_ 84,1975,Showa,50,7935,3146,4789
36 ,Tokushima,over_85,1975,Showa,50,4632,1577,3055
36 ,Tokushima,total,1980,Showa,55,825261,395994,429267
36 ,Tokushima,0_ 4,1980,Showa,55,54955,28357,26598
36 ,Tokushima,5_ 9,1980,Showa,55,62854,31911,30943
36 ,Tokushima,10_ 14,1980,Showa,55,57486,29480,28006
36 ,Tokushima,15_ 19,1980,Showa,55,55133,26912,28221
36 ,Tokushima,20_ 24,1980,Showa,55,47921,21848,26073
36 ,Tokushima,25_ 29,1980,Showa,55,60494,29769,30725
36 ,Tokushima,30_ 34,1980,Showa,55,70227,35925,34302
36 ,Tokushima,35_ 39,1980,Showa,55,55024,27197,27827
36 ,Tokushima,40_ 44,1980,Showa,55,54867,26696,28171
36 ,Tokushima,45_ 49,1980,Showa,55,61521,30011,31510
36 ,Tokushima,50_ 54,1980,Showa,55,60483,28989,31494
36 ,Tokushima,55_ 59,1980,Showa,55,47199,20975,26224
36 ,Tokushima,60_ 64,1980,Showa,55,37910,16330,21580
36 ,Tokushima,65_ 69,1980,Showa,55,34741,14659,20082
36 ,Tokushima,70_ 74,1980,Showa,55,28111,12107,16004
36 ,Tokushima,75_ 79,1980,Showa,55,19737,8432,11305
36 ,Tokushima,80_ 84,1980,Showa,55,10979,4388,6591
36 ,Tokushima,over_85,1980,Showa,55,5336,1861,3475
36 ,Tokushima,total,1985,Showa,60,834889,399689,435200
36 ,Tokushima,0_ 4,1985,Showa,60,50416,25737,24679
36 ,Tokushima,5_ 9,1985,Showa,60,56047,28843,27204
36 ,Tokushima,10_ 14,1985,Showa,60,63599,32392,31207
36 ,Tokushima,15_ 19,1985,Showa,60,53340,26423,26917
36 ,Tokushima,20_ 24,1985,Showa,60,44506,20093,24413
36 ,Tokushima,25_ 29,1985,Showa,60,50606,24511,26095
36 ,Tokushima,30_ 34,1985,Showa,60,61595,30854,30741
36 ,Tokushima,35_ 39,1985,Showa,60,70621,36055,34566
36 ,Tokushima,40_ 44,1985,Showa,60,54855,27099,27756
36 ,Tokushima,45_ 49,1985,Showa,60,53993,26144,27849
36 ,Tokushima,50_ 54,1985,Showa,60,60146,29047,31099
36 ,Tokushima,55_ 59,1985,Showa,60,58725,27814,30911
36 ,Tokushima,60_ 64,1985,Showa,60,45471,19912,25559
36 ,Tokushima,65_ 69,1985,Showa,60,35601,15010,20591
36 ,Tokushima,70_ 74,1985,Showa,60,31047,12560,18487
36 ,Tokushima,75_ 79,1985,Showa,60,22969,9277,13692
36 ,Tokushima,80_ 84,1985,Showa,60,13679,5256,8423
36 ,Tokushima,over_85,1985,Showa,60,7625,2629,4996
36 ,Tokushima,total,1990,Heisei,2,831598,395906,435692
36 ,Tokushima,0_ 4,1990,Heisei,2,42594,21860,20734
36 ,Tokushima,5_ 9,1990,Heisei,2,50812,25913,24899
36 ,Tokushima,10_ 14,1990,Heisei,2,56364,29021,27343
36 ,Tokushima,15_ 19,1990,Heisei,2,58943,28820,30123
36 ,Tokushima,20_ 24,1990,Heisei,2,43424,19788,23636
36 ,Tokushima,25_ 29,1990,Heisei,2,44982,21306,23676
36 ,Tokushima,30_ 34,1990,Heisei,2,50339,24636,25703
36 ,Tokushima,35_ 39,1990,Heisei,2,61305,30547,30758
36 ,Tokushima,40_ 44,1990,Heisei,2,70166,35789,34377
36 ,Tokushima,45_ 49,1990,Heisei,2,53803,26482,27321
36 ,Tokushima,50_ 54,1990,Heisei,2,52534,25210,27324
36 ,Tokushima,55_ 59,1990,Heisei,2,58651,28023,30628
36 ,Tokushima,60_ 64,1990,Heisei,2,56920,26637,30283
36 ,Tokushima,65_ 69,1990,Heisei,2,42983,18347,24636
36 ,Tokushima,70_ 74,1990,Heisei,2,32369,13108,19261
36 ,Tokushima,75_ 79,1990,Heisei,2,26387,9973,16414
36 ,Tokushima,80_ 84,1990,Heisei,2,16694,6062,10632
36 ,Tokushima,over_85,1990,Heisei,2,10672,3442,7230
36 ,Tokushima,total,1995,Heisei,7,832427,395636,436791
36 ,Tokushima,0_ 4,1995,Heisei,7,37335,19200,18135
36 ,Tokushima,5_ 9,1995,Heisei,7,43765,22515,21250
36 ,Tokushima,10_ 14,1995,Heisei,7,51395,26213,25182
36 ,Tokushima,15_ 19,1995,Heisei,7,53401,26717,26684
36 ,Tokushima,20_ 24,1995,Heisei,7,50708,23561,27147
36 ,Tokushima,25_ 29,1995,Heisei,7,45183,21553,23630
36 ,Tokushima,30_ 34,1995,Heisei,7,46665,22406,24259
36 ,Tokushima,35_ 39,1995,Heisei,7,51464,25362,26102
36 ,Tokushima,40_ 44,1995,Heisei,7,61865,30946,30919
36 ,Tokushima,45_ 49,1995,Heisei,7,70021,35771,34250
36 ,Tokushima,50_ 54,1995,Heisei,7,53568,26287,27281
36 ,Tokushima,55_ 59,1995,Heisei,7,51879,24790,27089
36 ,Tokushima,60_ 64,1995,Heisei,7,57191,26991,30200
36 ,Tokushima,65_ 69,1995,Heisei,7,54169,24772,29397
36 ,Tokushima,70_ 74,1995,Heisei,7,39826,16324,23502
36 ,Tokushima,75_ 79,1995,Heisei,7,27966,10624,17342
36 ,Tokushima,80_ 84,1995,Heisei,7,20522,6923,13599
36 ,Tokushima,over_85,1995,Heisei,7,14978,4391,10587
36 ,Tokushima,total,2000,Heisei,12,824108,391718,432390
36 ,Tokushima,0_ 4,2000,Heisei,12,35389,18006,17383
36 ,Tokushima,5_ 9,2000,Heisei,12,37946,19559,18387
36 ,Tokushima,10_ 14,2000,Heisei,12,43882,22591,21291
36 ,Tokushima,15_ 19,2000,Heisei,12,47903,24015,23888
36 ,Tokushima,20_ 24,2000,Heisei,12,46482,22816,23666
36 ,Tokushima,25_ 29,2000,Heisei,12,52335,25230,27105
36 ,Tokushima,30_ 34,2000,Heisei,12,46299,22354,23945
36 ,Tokushima,35_ 39,2000,Heisei,12,47217,22774,24443
36 ,Tokushima,40_ 44,2000,Heisei,12,51426,25355,26071
36 ,Tokushima,45_ 49,2000,Heisei,12,61270,30704,30566
36 ,Tokushima,50_ 54,2000,Heisei,12,69141,35130,34011
36 ,Tokushima,55_ 59,2000,Heisei,12,52668,25572,27096
36 ,Tokushima,60_ 64,2000,Heisei,12,50983,23993,26990
36 ,Tokushima,65_ 69,2000,Heisei,12,54225,25012,29213
36 ,Tokushima,70_ 74,2000,Heisei,12,49695,21774,27921
36 ,Tokushima,75_ 79,2000,Heisei,12,34871,13576,21295
36 ,Tokushima,80_ 84,2000,Heisei,12,22022,7626,14396
36 ,Tokushima,over_85,2000,Heisei,12,19824,5357,14467
36 ,Tokushima,total,2005,Heisei,17,809950,384635,425315
36 ,Tokushima,0_ 4,2005,Heisei,17,32295,16539,15756
36 ,Tokushima,5_ 9,2005,Heisei,17,35760,18235,17525
36 ,Tokushima,10_ 14,2005,Heisei,17,37759,19485,18274
36 ,Tokushima,15_ 19,2005,Heisei,17,41239,21014,20225
36 ,Tokushima,20_ 24,2005,Heisei,17,42530,20943,21587
36 ,Tokushima,25_ 29,2005,Heisei,17,45707,22818,22889
36 ,Tokushima,30_ 34,2005,Heisei,17,52723,25624,27099
36 ,Tokushima,35_ 39,2005,Heisei,17,46125,22421,23704
36 ,Tokushima,40_ 44,2005,Heisei,17,46547,22426,24121
36 ,Tokushima,45_ 49,2005,Heisei,17,50863,24988,25875
36 ,Tokushima,50_ 54,2005,Heisei,17,60529,30168,30361
36 ,Tokushima,55_ 59,2005,Heisei,17,68375,34498,33877
36 ,Tokushima,60_ 64,2005,Heisei,17,52004,25068,26936
36 ,Tokushima,65_ 69,2005,Heisei,17,49010,22737,26273
36 ,Tokushima,70_ 74,2005,Heisei,17,50684,22561,28123
36 ,Tokushima,75_ 79,2005,Heisei,17,44280,18325,25955
36 ,Tokushima,80_ 84,2005,Heisei,17,28475,10069,18406
36 ,Tokushima,over_85,2005,Heisei,17,24864,6609,18255
36 ,Tokushima,total,2010,Heisei,22,785491,372710,412781
36 ,Tokushima,0_ 4,2010,Heisei,22,28937,14761,14176
36 ,Tokushima,5_ 9,2010,Heisei,22,32242,16559,15683
36 ,Tokushima,10_ 14,2010,Heisei,22,35417,18000,17417
36 ,Tokushima,15_ 19,2010,Heisei,22,35137,17981,17156
36 ,Tokushima,20_ 24,2010,Heisei,22,33817,16803,17014
36 ,Tokushima,25_ 29,2010,Heisei,22,38911,19453,19458
36 ,Tokushima,30_ 34,2010,Heisei,22,44930,22417,22513
36 ,Tokushima,35_ 39,2010,Heisei,22,51567,25218,26349
36 ,Tokushima,40_ 44,2010,Heisei,22,45344,22055,23289
36 ,Tokushima,45_ 49,2010,Heisei,22,45700,22005,23695
36 ,Tokushima,50_ 54,2010,Heisei,22,49971,24402,25569
36 ,Tokushima,55_ 59,2010,Heisei,22,59395,29356,30039
36 ,Tokushima,60_ 64,2010,Heisei,22,67016,33542,33474
36 ,Tokushima,65_ 69,2010,Heisei,22,50082,23792,26290
36 ,Tokushima,70_ 74,2010,Heisei,22,45802,20645,25157
36 ,Tokushima,75_ 79,2010,Heisei,22,45512,19280,26232
36 ,Tokushima,80_ 84,2010,Heisei,22,36544,13706,22838
36 ,Tokushima,over_85,2010,Heisei,22,31986,8674,23312
36 ,Tokushima,total,2015,Heisei,27,755733,359790,395943
36 ,Tokushima,0_ 4,2015,Heisei,27,26654,13776,12878
36 ,Tokushima,5_ 9,2015,Heisei,27,28615,14662,13953
36 ,Tokushima,10_ 14,2015,Heisei,27,31761,16266,15495
36 ,Tokushima,15_ 19,2015,Heisei,27,33699,17041,16658
36 ,Tokushima,20_ 24,2015,Heisei,27,30057,15187,14870
36 ,Tokushima,25_ 29,2015,Heisei,27,32963,16585,16378
36 ,Tokushima,30_ 34,2015,Heisei,27,38542,19308,19234
36 ,Tokushima,35_ 39,2015,Heisei,27,44249,22106,22143
36 ,Tokushima,40_ 44,2015,Heisei,27,51133,25043,26090
36 ,Tokushima,45_ 49,2015,Heisei,27,44613,21749,22864
36 ,Tokushima,50_ 54,2015,Heisei,27,45084,21742,23342
36 ,Tokushima,55_ 59,2015,Heisei,27,49262,23985,25277
36 ,Tokushima,60_ 64,2015,Heisei,27,58457,28729,29728
36 ,Tokushima,65_ 69,2015,Heisei,27,64808,31924,32884
36 ,Tokushima,70_ 74,2015,Heisei,27,46877,21911,24966
36 ,Tokushima,75_ 79,2015,Heisei,27,41319,17985,23334
36 ,Tokushima,80_ 84,2015,Heisei,27,37701,14825,22876
36 ,Tokushima,over_85,2015,Heisei,27,40209,11523,28686
37 ,Kagawa,total,1920,Taisho,9,677852,336195,341657
37 ,Kagawa,0_ 4,1920,Taisho,9,94482,47642,46840
37 ,Kagawa,5_ 9,1920,Taisho,9,91200,46128,45072
37 ,Kagawa,10_ 14,1920,Taisho,9,78113,39680,38433
37 ,Kagawa,15_ 19,1920,Taisho,9,58366,29197,29169
37 ,Kagawa,20_ 24,1920,Taisho,9,48037,22793,25244
37 ,Kagawa,25_ 29,1920,Taisho,9,39696,19388,20308
37 ,Kagawa,30_ 34,1920,Taisho,9,40189,19835,20354
37 ,Kagawa,35_ 39,1920,Taisho,9,40411,19826,20585
37 ,Kagawa,40_ 44,1920,Taisho,9,38184,19083,19101
37 ,Kagawa,45_ 49,1920,Taisho,9,32989,16315,16674
37 ,Kagawa,50_ 54,1920,Taisho,9,29083,14457,14626
37 ,Kagawa,55_ 59,1920,Taisho,9,23466,11572,11894
37 ,Kagawa,60_ 64,1920,Taisho,9,23933,11860,12073
37 ,Kagawa,65_ 69,1920,Taisho,9,18383,8968,9415
37 ,Kagawa,70_ 74,1920,Taisho,9,12186,5658,6528
37 ,Kagawa,75_ 79,1920,Taisho,9,6129,2647,3482
37 ,Kagawa,over_80,1920,Taisho,9,3005,1146,1859
37 ,Kagawa,total,1925,Taisho,14,700308,351911,348397
37 ,Kagawa,0_ 4,1925,Taisho,14,97266,48963,48303
37 ,Kagawa,5_ 9,1925,Taisho,14,87136,44051,43085
37 ,Kagawa,10_ 14,1925,Taisho,14,85367,43751,41616
37 ,Kagawa,15_ 19,1925,Taisho,14,62160,32202,29958
37 ,Kagawa,20_ 24,1925,Taisho,14,51847,26781,25066
37 ,Kagawa,25_ 29,1925,Taisho,14,45814,22649,23165
37 ,Kagawa,30_ 34,1925,Taisho,14,37906,18945,18961
37 ,Kagawa,35_ 39,1925,Taisho,14,38701,19472,19229
37 ,Kagawa,40_ 44,1925,Taisho,14,38404,19259,19145
37 ,Kagawa,45_ 49,1925,Taisho,14,36373,18363,18010
37 ,Kagawa,50_ 54,1925,Taisho,14,30840,15337,15503
37 ,Kagawa,55_ 59,1925,Taisho,14,26073,12990,13083
37 ,Kagawa,60_ 64,1925,Taisho,14,20038,9763,10275
37 ,Kagawa,65_ 69,1925,Taisho,14,18876,9075,9801
37 ,Kagawa,70_ 74,1925,Taisho,14,12907,5976,6931
37 ,Kagawa,75_ 79,1925,Taisho,14,7095,3069,4026
37 ,Kagawa,80_ 84,1925,Taisho,14,2698,1020,1678
37 ,Kagawa,over_85,1925,Taisho,14,807,245,562
37 ,Kagawa,total,1930,Showa,5,732816,368442,364374
37 ,Kagawa,0_ 4,1930,Showa,5,102266,51797,50469
37 ,Kagawa,5_ 9,1930,Showa,5,91701,46312,45389
37 ,Kagawa,10_ 14,1930,Showa,5,82467,41995,40472
37 ,Kagawa,15_ 19,1930,Showa,5,69697,36214,33483
37 ,Kagawa,20_ 24,1930,Showa,5,57217,29354,27863
37 ,Kagawa,25_ 29,1930,Showa,5,47979,24171,23808
37 ,Kagawa,30_ 34,1930,Showa,5,44083,22015,22068
37 ,Kagawa,35_ 39,1930,Showa,5,36564,18389,18175
37 ,Kagawa,40_ 44,1930,Showa,5,37037,18791,18246
37 ,Kagawa,45_ 49,1930,Showa,5,36725,18336,18389
37 ,Kagawa,50_ 54,1930,Showa,5,33908,17098,16810
37 ,Kagawa,55_ 59,1930,Showa,5,27957,13815,14142
37 ,Kagawa,60_ 64,1930,Showa,5,22773,11035,11738
37 ,Kagawa,65_ 69,1930,Showa,5,16332,7668,8664
37 ,Kagawa,70_ 74,1930,Showa,5,13828,6341,7487
37 ,Kagawa,75_ 79,1930,Showa,5,7894,3443,4451
37 ,Kagawa,over_80,1930,Showa,5,4388,1668,2720
37 ,Kagawa,total,1935,Showa,10,748656,373522,375134
37 ,Kagawa,0_ 4,1935,Showa,10,100240,50466,49774
37 ,Kagawa,5_ 9,1935,Showa,10,96355,48855,47500
37 ,Kagawa,10_ 14,1935,Showa,10,86910,43877,43033
37 ,Kagawa,15_ 19,1935,Showa,10,63834,32125,31709
37 ,Kagawa,20_ 24,1935,Showa,10,58818,29345,29473
37 ,Kagawa,25_ 29,1935,Showa,10,50987,25301,25686
37 ,Kagawa,30_ 34,1935,Showa,10,45284,22838,22446
37 ,Kagawa,35_ 39,1935,Showa,10,41946,20886,21060
37 ,Kagawa,40_ 44,1935,Showa,10,34675,17470,17205
37 ,Kagawa,45_ 49,1935,Showa,10,35043,17788,17255
37 ,Kagawa,50_ 54,1935,Showa,10,34217,17120,17097
37 ,Kagawa,55_ 59,1935,Showa,10,31051,15493,15558
37 ,Kagawa,60_ 64,1935,Showa,10,24842,12118,12724
37 ,Kagawa,65_ 69,1935,Showa,10,18654,8758,9896
37 ,Kagawa,70_ 74,1935,Showa,10,12072,5437,6635
37 ,Kagawa,75_ 79,1935,Showa,10,8541,3720,4821
37 ,Kagawa,over_80,1935,Showa,10,5187,1925,3262
37 ,Kagawa,total,1940,Showa,15,730247,359080,371167
37 ,Kagawa,0_ 4,1940,Showa,15,87274,43938,43336
37 ,Kagawa,5_ 9,1940,Showa,15,93433,47084,46349
37 ,Kagawa,10_ 14,1940,Showa,15,90163,45389,44774
37 ,Kagawa,15_ 19,1940,Showa,15,61806,29255,32551
37 ,Kagawa,20_ 24,1940,Showa,15,53419,27303,26116
37 ,Kagawa,25_ 29,1940,Showa,15,49800,23721,26079
37 ,Kagawa,30_ 34,1940,Showa,15,45589,22097,23492
37 ,Kagawa,35_ 39,1940,Showa,15,41521,20398,21123
37 ,Kagawa,40_ 44,1940,Showa,15,38569,18945,19624
37 ,Kagawa,45_ 49,1940,Showa,15,31980,15825,16155
37 ,Kagawa,50_ 54,1940,Showa,15,32302,16159,16143
37 ,Kagawa,55_ 59,1940,Showa,15,30978,15281,15697
37 ,Kagawa,60_ 64,1940,Showa,15,27079,13120,13959
37 ,Kagawa,65_ 69,1940,Showa,15,20154,9490,10664
37 ,Kagawa,70_ 74,1940,Showa,15,13492,5998,7494
37 ,Kagawa,75_ 79,1940,Showa,15,7405,3102,4303
37 ,Kagawa,80_ 84,1940,Showa,15,3856,1531,2325
37 ,Kagawa,over_85,1940,Showa,15,1424,442,982
37 ,Kagawa,total,1945,Showa,20,863700,396235,467465
37 ,Kagawa,1_ 5,1945,Showa,20,110229,55842,54387
37 ,Kagawa,6_ 10,1945,Showa,20,101892,51181,50711
37 ,Kagawa,11_ 15,1945,Showa,20,107465,54030,53435
37 ,Kagawa,16_ 20,1945,Showa,20,90125,42643,47482
37 ,Kagawa,21_ 25,1945,Showa,20,62419,22104,40315
37 ,Kagawa,26_ 30,1945,Showa,20,49297,15269,34028
37 ,Kagawa,31_ 35,1945,Showa,20,52661,19693,32968
37 ,Kagawa,36_ 40,1945,Showa,20,49170,20628,28542
37 ,Kagawa,41_ 45,1945,Showa,20,46543,22452,24091
37 ,Kagawa,46_ 50,1945,Showa,20,42552,20910,21642
37 ,Kagawa,51_ 55,1945,Showa,20,34166,16991,17175
37 ,Kagawa,56_ 60,1945,Showa,20,33338,16488,16850
37 ,Kagawa,61_ 65,1945,Showa,20,29715,14333,15382
37 ,Kagawa,66_ 70,1945,Showa,20,24138,11205,12933
37 ,Kagawa,71_ 75,1945,Showa,20,16107,7081,9026
37 ,Kagawa,76_ 80,1945,Showa,20,8776,3565,5211
37 ,Kagawa,81_ 85,1945,Showa,20,3674,1365,2309
37 ,Kagawa,86以上,1945,Showa,20,1433,455,978
37 ,Kagawa,total,1950,Showa,25,946022,457980,488042
37 ,Kagawa,0_ 4,1950,Showa,25,128231,65485,62746
37 ,Kagawa,5_ 9,1950,Showa,25,106389,53975,52414
37 ,Kagawa,10_ 14,1950,Showa,25,98198,49404,48794
37 ,Kagawa,15_ 19,1950,Showa,25,96685,48203,48482
37 ,Kagawa,20_ 24,1950,Showa,25,82262,39337,42925
37 ,Kagawa,25_ 29,1950,Showa,25,66228,29615,36613
37 ,Kagawa,30_ 34,1950,Showa,25,56280,24733,31547
37 ,Kagawa,35_ 39,1950,Showa,25,56577,25535,31042
37 ,Kagawa,40_ 44,1950,Showa,25,50521,23872,26649
37 ,Kagawa,45_ 49,1950,Showa,25,44726,22169,22557
37 ,Kagawa,50_ 54,1950,Showa,25,39835,19801,20034
37 ,Kagawa,55_ 59,1950,Showa,25,31503,15589,15914
37 ,Kagawa,60_ 64,1950,Showa,25,29370,14309,15061
37 ,Kagawa,65_ 69,1950,Showa,25,24731,11548,13183
37 ,Kagawa,70_ 74,1950,Showa,25,18120,7970,10150
37 ,Kagawa,75_ 79,1950,Showa,25,10277,4287,5990
37 ,Kagawa,over_80,1950,Showa,25,6055,2140,3915
37 ,Kagawa,total,1955,Showa,30,943823,456711,487112
37 ,Kagawa,0_ 4,1955,Showa,30,89218,45594,43624
37 ,Kagawa,5_ 9,1955,Showa,30,122299,62317,59982
37 ,Kagawa,10_ 14,1955,Showa,30,102320,51800,50520
37 ,Kagawa,15_ 19,1955,Showa,30,84610,42030,42580
37 ,Kagawa,20_ 24,1955,Showa,30,79794,37994,41800
37 ,Kagawa,25_ 29,1955,Showa,30,75586,36725,38861
37 ,Kagawa,30_ 34,1955,Showa,30,62712,28212,34500
37 ,Kagawa,35_ 39,1955,Showa,30,53239,23416,29823
37 ,Kagawa,40_ 44,1955,Showa,30,53583,24230,29353
37 ,Kagawa,45_ 49,1955,Showa,30,47751,22551,25200
37 ,Kagawa,50_ 54,1955,Showa,30,42029,20792,21237
37 ,Kagawa,55_ 59,1955,Showa,30,37119,18365,18754
37 ,Kagawa,60_ 64,1955,Showa,30,28386,13862,14524
37 ,Kagawa,65_ 69,1955,Showa,30,24970,11909,13061
37 ,Kagawa,70_ 74,1955,Showa,30,19668,8790,10878
37 ,Kagawa,75_ 79,1955,Showa,30,12561,5232,7329
37 ,Kagawa,80_ 84,1955,Showa,30,5731,2195,3536
37 ,Kagawa,over_85,1955,Showa,30,2243,695,1548
37 ,Kagawa,total,1960,Showa,35,918867,438924,479943
37 ,Kagawa,0_ 4,1960,Showa,35,70877,36210,34667
37 ,Kagawa,5_ 9,1960,Showa,35,87425,44647,42778
37 ,Kagawa,10_ 14,1960,Showa,35,119542,60810,58732
37 ,Kagawa,15_ 19,1960,Showa,35,81960,38937,43023
37 ,Kagawa,20_ 24,1960,Showa,35,64462,28544,35918
37 ,Kagawa,25_ 29,1960,Showa,35,72053,34523,37530
37 ,Kagawa,30_ 34,1960,Showa,35,72543,35262,37281
37 ,Kagawa,35_ 39,1960,Showa,35,60564,27157,33407
37 ,Kagawa,40_ 44,1960,Showa,35,51157,22416,28741
37 ,Kagawa,45_ 49,1960,Showa,35,51217,23010,28207
37 ,Kagawa,50_ 54,1960,Showa,35,45090,21148,23942
37 ,Kagawa,55_ 59,1960,Showa,35,39325,19289,20036
37 ,Kagawa,60_ 64,1960,Showa,35,33933,16468,17465
37 ,Kagawa,65_ 69,1960,Showa,35,24586,11757,12829
37 ,Kagawa,70_ 74,1960,Showa,35,20298,9248,11050
37 ,Kagawa,75_ 79,1960,Showa,35,13735,5749,7986
37 ,Kagawa,80_ 84,1960,Showa,35,7134,2727,4407
37 ,Kagawa,over_85,1960,Showa,35,2966,1022,1944
37 ,Kagawa,total,1965,Showa,40,900845,427058,473787
37 ,Kagawa,0_ 4,1965,Showa,40,63065,32017,31048
37 ,Kagawa,5_ 9,1965,Showa,40,70135,35554,34581
37 ,Kagawa,10_ 14,1965,Showa,40,86250,43689,42561
37 ,Kagawa,15_ 19,1965,Showa,40,101721,48960,52761
37 ,Kagawa,20_ 24,1965,Showa,40,62325,26350,35975
37 ,Kagawa,25_ 29,1965,Showa,40,61241,28619,32622
37 ,Kagawa,30_ 34,1965,Showa,40,70930,34387,36543
37 ,Kagawa,35_ 39,1965,Showa,40,71575,34904,36671
37 ,Kagawa,40_ 44,1965,Showa,40,59299,26669,32630
37 ,Kagawa,45_ 49,1965,Showa,40,49590,21862,27728
37 ,Kagawa,50_ 54,1965,Showa,40,49076,22187,26889
37 ,Kagawa,55_ 59,1965,Showa,40,42760,20095,22665
37 ,Kagawa,60_ 64,1965,Showa,40,36348,17684,18664
37 ,Kagawa,65_ 69,1965,Showa,40,30034,14186,15848
37 ,Kagawa,70_ 74,1965,Showa,40,20319,9323,10996
37 ,Kagawa,75_ 79,1965,Showa,40,14589,6322,8267
37 ,Kagawa,80_ 84,1965,Showa,40,7748,2990,4758
37 ,Kagawa,over_85,1965,Showa,40,3840,1260,2580
37 ,Kagawa,total,1970,Showa,45,907897,430773,477124
37 ,Kagawa,0_ 4,1970,Showa,45,65267,33427,31840
37 ,Kagawa,5_ 9,1970,Showa,45,65022,33167,31855
37 ,Kagawa,10_ 14,1970,Showa,45,70779,35999,34780
37 ,Kagawa,15_ 19,1970,Showa,45,75122,36528,38594
37 ,Kagawa,20_ 24,1970,Showa,45,79712,35001,44711
37 ,Kagawa,25_ 29,1970,Showa,45,65083,31193,33890
37 ,Kagawa,30_ 34,1970,Showa,45,63808,30708,33100
37 ,Kagawa,35_ 39,1970,Showa,45,71993,35119,36874
37 ,Kagawa,40_ 44,1970,Showa,45,70818,34581,36237
37 ,Kagawa,45_ 49,1970,Showa,45,58251,26021,32230
37 ,Kagawa,50_ 54,1970,Showa,45,48347,21151,27196
37 ,Kagawa,55_ 59,1970,Showa,45,46924,21012,25912
37 ,Kagawa,60_ 64,1970,Showa,45,40111,18512,21599
37 ,Kagawa,65_ 69,1970,Showa,45,32811,15465,17346
37 ,Kagawa,70_ 74,1970,Showa,45,25412,11478,13934
37 ,Kagawa,75_ 79,1970,Showa,45,15122,6467,8655
37 ,Kagawa,80_ 84,1970,Showa,45,8792,3454,5338
37 ,Kagawa,over_85,1970,Showa,45,4523,1490,3033
37 ,Kagawa,total,1975,Showa,50,961292,461370,499922
37 ,Kagawa,0_ 4,1975,Showa,50,79448,40938,38510
37 ,Kagawa,5_ 9,1975,Showa,50,68382,35089,33293
37 ,Kagawa,10_ 14,1975,Showa,50,66027,33828,32199
37 ,Kagawa,15_ 19,1975,Showa,50,65567,32359,33208
37 ,Kagawa,20_ 24,1975,Showa,50,63808,28933,34875
37 ,Kagawa,25_ 29,1975,Showa,50,88585,44048,44537
37 ,Kagawa,30_ 34,1975,Showa,50,69798,34475,35323
37 ,Kagawa,35_ 39,1975,Showa,50,65852,32057,33795
37 ,Kagawa,40_ 44,1975,Showa,50,72477,35365,37112
37 ,Kagawa,45_ 49,1975,Showa,50,70545,34433,36112
37 ,Kagawa,50_ 54,1975,Showa,50,57180,25539,31641
37 ,Kagawa,55_ 59,1975,Showa,50,46931,20313,26618
37 ,Kagawa,60_ 64,1975,Showa,50,45214,19937,25277
37 ,Kagawa,65_ 69,1975,Showa,50,37480,16835,20645
37 ,Kagawa,70_ 74,1975,Showa,50,28677,12998,15679
37 ,Kagawa,75_ 79,1975,Showa,50,19973,8502,11471
37 ,Kagawa,80_ 84,1975,Showa,50,9726,3855,5871
37 ,Kagawa,over_85,1975,Showa,50,5520,1804,3716
37 ,Kagawa,total,1980,Showa,55,999864,481104,518760
37 ,Kagawa,0_ 4,1980,Showa,55,70716,36242,34474
37 ,Kagawa,5_ 9,1980,Showa,55,82177,42305,39872
37 ,Kagawa,10_ 14,1980,Showa,55,69351,35567,33784
37 ,Kagawa,15_ 19,1980,Showa,55,62574,31131,31443
37 ,Kagawa,20_ 24,1980,Showa,55,54993,24930,30063
37 ,Kagawa,25_ 29,1980,Showa,55,70435,34598,35837
37 ,Kagawa,30_ 34,1980,Showa,55,91662,46267,45395
37 ,Kagawa,35_ 39,1980,Showa,55,71392,35389,36003
37 ,Kagawa,40_ 44,1980,Showa,55,65715,32087,33628
37 ,Kagawa,45_ 49,1980,Showa,55,71667,34993,36674
37 ,Kagawa,50_ 54,1980,Showa,55,69135,33564,35571
37 ,Kagawa,55_ 59,1980,Showa,55,55638,24572,31066
37 ,Kagawa,60_ 64,1980,Showa,55,45080,19260,25820
37 ,Kagawa,65_ 69,1980,Showa,55,42171,18164,24007
37 ,Kagawa,70_ 74,1980,Showa,55,33414,14424,18990
37 ,Kagawa,75_ 79,1980,Showa,55,23104,9894,13210
37 ,Kagawa,80_ 84,1980,Showa,55,13518,5295,8223
37 ,Kagawa,over_85,1980,Showa,55,6824,2233,4591
37 ,Kagawa,total,1985,Showa,60,1022569,492696,529873
37 ,Kagawa,0_ 4,1985,Showa,60,60517,31057,29460
37 ,Kagawa,5_ 9,1985,Showa,60,71643,36644,34999
37 ,Kagawa,10_ 14,1985,Showa,60,82535,42487,40048
37 ,Kagawa,15_ 19,1985,Showa,60,66643,33749,32894
37 ,Kagawa,20_ 24,1985,Showa,60,53177,24560,28617
37 ,Kagawa,25_ 29,1985,Showa,60,60271,29426,30845
37 ,Kagawa,30_ 34,1985,Showa,60,71873,35663,36210
37 ,Kagawa,35_ 39,1985,Showa,60,92295,46712,45583
37 ,Kagawa,40_ 44,1985,Showa,60,71010,35279,35731
37 ,Kagawa,45_ 49,1985,Showa,60,65059,31832,33227
37 ,Kagawa,50_ 54,1985,Showa,60,70258,34057,36201
37 ,Kagawa,55_ 59,1985,Showa,60,67519,32390,35129
37 ,Kagawa,60_ 64,1985,Showa,60,53917,23495,30422
37 ,Kagawa,65_ 69,1985,Showa,60,42722,17929,24793
37 ,Kagawa,70_ 74,1985,Showa,60,38358,15944,22414
37 ,Kagawa,75_ 79,1985,Showa,60,28077,11505,16572
37 ,Kagawa,80_ 84,1985,Showa,60,16564,6532,10032
37 ,Kagawa,over_85,1985,Showa,60,9975,3343,6632
37 ,Kagawa,total,1990,Heisei,2,1023412,491621,531791
37 ,Kagawa,0_ 4,1990,Heisei,2,51906,26512,25394
37 ,Kagawa,5_ 9,1990,Heisei,2,61112,31329,29783
37 ,Kagawa,10_ 14,1990,Heisei,2,71711,36747,34964
37 ,Kagawa,15_ 19,1990,Heisei,2,77845,39512,38333
37 ,Kagawa,20_ 24,1990,Heisei,2,55252,25860,29392
37 ,Kagawa,25_ 29,1990,Heisei,2,56049,27124,28925
37 ,Kagawa,30_ 34,1990,Heisei,2,61043,30052,30991
37 ,Kagawa,35_ 39,1990,Heisei,2,72104,35874,36230
37 ,Kagawa,40_ 44,1990,Heisei,2,91646,46368,45278
37 ,Kagawa,45_ 49,1990,Heisei,2,69519,34494,35025
37 ,Kagawa,50_ 54,1990,Heisei,2,63409,30715,32694
37 ,Kagawa,55_ 59,1990,Heisei,2,68455,32790,35665
37 ,Kagawa,60_ 64,1990,Heisei,2,65171,30790,34381
37 ,Kagawa,65_ 69,1990,Heisei,2,51102,21783,29319
37 ,Kagawa,70_ 74,1990,Heisei,2,39176,15900,23276
37 ,Kagawa,75_ 79,1990,Heisei,2,32749,12868,19881
37 ,Kagawa,80_ 84,1990,Heisei,2,20829,7805,13024
37 ,Kagawa,over_85,1990,Heisei,2,13381,4459,8922
37 ,Kagawa,total,1995,Heisei,7,1027006,493482,533524
37 ,Kagawa,0_ 4,1995,Heisei,7,46813,23968,22845
37 ,Kagawa,5_ 9,1995,Heisei,7,53113,27165,25948
37 ,Kagawa,10_ 14,1995,Heisei,7,61748,31674,30074
37 ,Kagawa,15_ 19,1995,Heisei,7,68635,35158,33477
37 ,Kagawa,20_ 24,1995,Heisei,7,68049,33199,34850
37 ,Kagawa,25_ 29,1995,Heisei,7,59822,29204,30618
37 ,Kagawa,30_ 34,1995,Heisei,7,57506,28272,29234
37 ,Kagawa,35_ 39,1995,Heisei,7,62281,30689,31592
37 ,Kagawa,40_ 44,1995,Heisei,7,72892,36437,36455
37 ,Kagawa,45_ 49,1995,Heisei,7,91299,46318,44981
37 ,Kagawa,50_ 54,1995,Heisei,7,69031,34247,34784
37 ,Kagawa,55_ 59,1995,Heisei,7,62514,29983,32531
37 ,Kagawa,60_ 64,1995,Heisei,7,66375,31320,35055
37 ,Kagawa,65_ 69,1995,Heisei,7,62005,28671,33334
37 ,Kagawa,70_ 74,1995,Heisei,7,47478,19542,27936
37 ,Kagawa,75_ 79,1995,Heisei,7,34069,13049,21020
37 ,Kagawa,80_ 84,1995,Heisei,7,25128,8911,16217
37 ,Kagawa,over_85,1995,Heisei,7,18170,5630,12540
37 ,Kagawa,total,2000,Heisei,12,1022890,491761,531129
37 ,Kagawa,0_ 4,2000,Heisei,12,47131,24109,23022
37 ,Kagawa,5_ 9,2000,Heisei,12,47479,24352,23127
37 ,Kagawa,10_ 14,2000,Heisei,12,53605,27442,26163
37 ,Kagawa,15_ 19,2000,Heisei,12,57706,29815,27891
37 ,Kagawa,20_ 24,2000,Heisei,12,57760,28613,29147
37 ,Kagawa,25_ 29,2000,Heisei,12,72267,35844,36423
37 ,Kagawa,30_ 34,2000,Heisei,12,60711,30015,30696
37 ,Kagawa,35_ 39,2000,Heisei,12,58263,28672,29591
37 ,Kagawa,40_ 44,2000,Heisei,12,62520,30967,31553
37 ,Kagawa,45_ 49,2000,Heisei,12,72193,36119,36074
37 ,Kagawa,50_ 54,2000,Heisei,12,89820,45291,44529
37 ,Kagawa,55_ 59,2000,Heisei,12,67590,33117,34473
37 ,Kagawa,60_ 64,2000,Heisei,12,61051,28956,32095
37 ,Kagawa,65_ 69,2000,Heisei,12,63163,29157,34006
37 ,Kagawa,70_ 74,2000,Heisei,12,57337,25675,31662
37 ,Kagawa,75_ 79,2000,Heisei,12,42072,16532,25540
37 ,Kagawa,80_ 84,2000,Heisei,12,27156,9573,17583
37 ,Kagawa,over_85,2000,Heisei,12,24514,7154,17360
37 ,Kagawa,total,2005,Heisei,17,1012400,486108,526292
37 ,Kagawa,0_ 4,2005,Heisei,17,45104,23141,21963
37 ,Kagawa,5_ 9,2005,Heisei,17,47204,24156,23048
37 ,Kagawa,10_ 14,2005,Heisei,17,47197,24162,23035
37 ,Kagawa,15_ 19,2005,Heisei,17,49873,25745,24128
37 ,Kagawa,20_ 24,2005,Heisei,17,47492,23705,23787
37 ,Kagawa,25_ 29,2005,Heisei,17,60496,30033,30463
37 ,Kagawa,30_ 34,2005,Heisei,17,72526,36288,36238
37 ,Kagawa,35_ 39,2005,Heisei,17,60474,29994,30480
37 ,Kagawa,40_ 44,2005,Heisei,17,57831,28535,29296
37 ,Kagawa,45_ 49,2005,Heisei,17,61528,30403,31125
37 ,Kagawa,50_ 54,2005,Heisei,17,71001,35288,35713
37 ,Kagawa,55_ 59,2005,Heisei,17,88193,44000,44193
37 ,Kagawa,60_ 64,2005,Heisei,17,66332,32127,34205
37 ,Kagawa,65_ 69,2005,Heisei,17,58980,27606,31374
37 ,Kagawa,70_ 74,2005,Heisei,17,59201,26522,32679
37 ,Kagawa,75_ 79,2005,Heisei,17,51468,21921,29547
37 ,Kagawa,80_ 84,2005,Heisei,17,34718,12554,22164
37 ,Kagawa,over_85,2005,Heisei,17,31141,8818,22323
37 ,Kagawa,total,2010,Heisei,22,995842,479951,515891
37 ,Kagawa,0_ 4,2010,Heisei,22,40631,20675,19956
37 ,Kagawa,5_ 9,2010,Heisei,22,44774,23046,21728
37 ,Kagawa,10_ 14,2010,Heisei,22,46265,23647,22618
37 ,Kagawa,15_ 19,2010,Heisei,22,43947,23029,20918
37 ,Kagawa,20_ 24,2010,Heisei,22,39973,19881,20092
37 ,Kagawa,25_ 29,2010,Heisei,22,48980,24375,24605
37 ,Kagawa,30_ 34,2010,Heisei,22,59946,29880,30066
37 ,Kagawa,35_ 39,2010,Heisei,22,71052,35612,35440
37 ,Kagawa,40_ 44,2010,Heisei,22,59453,29452,30001
37 ,Kagawa,45_ 49,2010,Heisei,22,56311,27661,28650
37 ,Kagawa,50_ 54,2010,Heisei,22,60113,29522,30591
37 ,Kagawa,55_ 59,2010,Heisei,22,69470,34161,35309
37 ,Kagawa,60_ 64,2010,Heisei,22,86206,42539,43667
37 ,Kagawa,65_ 69,2010,Heisei,22,63747,30411,33336
37 ,Kagawa,70_ 74,2010,Heisei,22,55070,25060,30010
37 ,Kagawa,75_ 79,2010,Heisei,22,52944,22594,30350
37 ,Kagawa,80_ 84,2010,Heisei,22,42430,16693,25737
37 ,Kagawa,over_85,2010,Heisei,22,39054,11108,27946
37 ,Kagawa,total,2015,Heisei,27,976263,472308,503955
37 ,Kagawa,0_ 4,2015,Heisei,27,37374,19270,18104
37 ,Kagawa,5_ 9,2015,Heisei,27,40740,20780,19960
37 ,Kagawa,10_ 14,2015,Heisei,27,44210,22716,21494
37 ,Kagawa,15_ 19,2015,Heisei,27,44768,23420,21348
37 ,Kagawa,20_ 24,2015,Heisei,27,36777,18793,17984
37 ,Kagawa,25_ 29,2015,Heisei,27,42999,21884,21115
37 ,Kagawa,30_ 34,2015,Heisei,27,50111,25161,24950
37 ,Kagawa,35_ 39,2015,Heisei,27,60264,30174,30090
37 ,Kagawa,40_ 44,2015,Heisei,27,70911,35501,35410
37 ,Kagawa,45_ 49,2015,Heisei,27,58791,29226,29565
37 ,Kagawa,50_ 54,2015,Heisei,27,55660,27398,28262
37 ,Kagawa,55_ 59,2015,Heisei,27,59359,29098,30261
37 ,Kagawa,60_ 64,2015,Heisei,27,68204,33360,34844
37 ,Kagawa,65_ 69,2015,Heisei,27,83042,40586,42456
37 ,Kagawa,70_ 74,2015,Heisei,27,60065,28045,32020
37 ,Kagawa,75_ 79,2015,Heisei,27,49910,22072,27838
37 ,Kagawa,80_ 84,2015,Heisei,27,44399,17786,26613
37 ,Kagawa,over_85,2015,Heisei,27,48880,14866,34014
38 ,Ehime,total,1920,Taisho,9,1046720,515389,531331
38 ,Ehime,0_ 4,1920,Taisho,9,140604,70945,69659
38 ,Ehime,5_ 9,1920,Taisho,9,132156,66778,65378
38 ,Ehime,10_ 14,1920,Taisho,9,118936,59600,59336
38 ,Ehime,15_ 19,1920,Taisho,9,94394,45581,48813
38 ,Ehime,20_ 24,1920,Taisho,9,76849,36524,40325
38 ,Ehime,25_ 29,1920,Taisho,9,63354,31478,31876
38 ,Ehime,30_ 34,1920,Taisho,9,59391,29081,30310
38 ,Ehime,35_ 39,1920,Taisho,9,60345,29074,31271
38 ,Ehime,40_ 44,1920,Taisho,9,58756,28781,29975
38 ,Ehime,45_ 49,1920,Taisho,9,53711,26401,27310
38 ,Ehime,50_ 54,1920,Taisho,9,45628,22696,22932
38 ,Ehime,55_ 59,1920,Taisho,9,38298,18926,19372
38 ,Ehime,60_ 64,1920,Taisho,9,36773,18151,18622
38 ,Ehime,65_ 69,1920,Taisho,9,29147,14040,15107
38 ,Ehime,70_ 74,1920,Taisho,9,20117,9538,10579
38 ,Ehime,75_ 79,1920,Taisho,9,11570,5164,6406
38 ,Ehime,over_80,1920,Taisho,9,6691,2631,4060
38 ,Ehime,total,1925,Taisho,14,1096366,542271,554095
38 ,Ehime,0_ 4,1925,Taisho,14,154587,77977,76610
38 ,Ehime,5_ 9,1925,Taisho,14,132366,66933,65433
38 ,Ehime,10_ 14,1925,Taisho,14,127033,63973,63060
38 ,Ehime,15_ 19,1925,Taisho,14,102479,49960,52519
38 ,Ehime,20_ 24,1925,Taisho,14,80083,38565,41518
38 ,Ehime,25_ 29,1925,Taisho,14,73318,36577,36741
38 ,Ehime,30_ 34,1925,Taisho,14,60791,30715,30076
38 ,Ehime,35_ 39,1925,Taisho,14,57156,28450,28706
38 ,Ehime,40_ 44,1925,Taisho,14,57058,27868,29190
38 ,Ehime,45_ 49,1925,Taisho,14,55527,27241,28286
38 ,Ehime,50_ 54,1925,Taisho,14,50204,24661,25543
38 ,Ehime,55_ 59,1925,Taisho,14,41120,20330,20790
38 ,Ehime,60_ 64,1925,Taisho,14,33501,16295,17206
38 ,Ehime,65_ 69,1925,Taisho,14,29459,14220,15239
38 ,Ehime,70_ 74,1925,Taisho,14,21344,9864,11480
38 ,Ehime,75_ 79,1925,Taisho,14,12583,5576,7007
38 ,Ehime,80_ 84,1925,Taisho,14,5769,2351,3418
38 ,Ehime,over_85,1925,Taisho,14,1988,715,1273
38 ,Ehime,total,1930,Showa,5,1142122,564699,577423
38 ,Ehime,0_ 4,1930,Showa,5,161813,81227,80586
38 ,Ehime,5_ 9,1930,Showa,5,145585,73545,72040
38 ,Ehime,10_ 14,1930,Showa,5,126049,63470,62579
38 ,Ehime,15_ 19,1930,Showa,5,107754,52978,54776
38 ,Ehime,20_ 24,1930,Showa,5,85040,40992,44048
38 ,Ehime,25_ 29,1930,Showa,5,74661,37078,37583
38 ,Ehime,30_ 34,1930,Showa,5,69732,35089,34643
38 ,Ehime,35_ 39,1930,Showa,5,58506,29702,28804
38 ,Ehime,40_ 44,1930,Showa,5,54212,27090,27122
38 ,Ehime,45_ 49,1930,Showa,5,54099,26331,27768
38 ,Ehime,50_ 54,1930,Showa,5,51875,25357,26518
38 ,Ehime,55_ 59,1930,Showa,5,45637,22232,23405
38 ,Ehime,60_ 64,1930,Showa,5,36012,17449,18563
38 ,Ehime,65_ 69,1930,Showa,5,27250,12889,14361
38 ,Ehime,70_ 74,1930,Showa,5,21790,10040,11750
38 ,Ehime,75_ 79,1930,Showa,5,13394,5836,7558
38 ,Ehime,over_80,1930,Showa,5,8713,3394,5319
38 ,Ehime,total,1935,Showa,10,1164898,575627,589271
38 ,Ehime,0_ 4,1935,Showa,10,160568,81244,79324
38 ,Ehime,5_ 9,1935,Showa,10,152841,76686,76155
38 ,Ehime,10_ 14,1935,Showa,10,138913,69684,69229
38 ,Ehime,15_ 19,1935,Showa,10,99088,48830,50258
38 ,Ehime,20_ 24,1935,Showa,10,82731,39148,43583
38 ,Ehime,25_ 29,1935,Showa,10,77038,37881,39157
38 ,Ehime,30_ 34,1935,Showa,10,70319,35110,35209
38 ,Ehime,35_ 39,1935,Showa,10,66260,33578,32682
38 ,Ehime,40_ 44,1935,Showa,10,54831,28116,26715
38 ,Ehime,45_ 49,1935,Showa,10,51054,25517,25537
38 ,Ehime,50_ 54,1935,Showa,10,50223,24532,25691
38 ,Ehime,55_ 59,1935,Showa,10,47302,23002,24300
38 ,Ehime,60_ 64,1935,Showa,10,40369,19372,20997
38 ,Ehime,65_ 69,1935,Showa,10,29592,13922,15670
38 ,Ehime,70_ 74,1935,Showa,10,20301,9238,11063
38 ,Ehime,75_ 79,1935,Showa,10,13851,6086,7765
38 ,Ehime,over_80,1935,Showa,10,9617,3681,5936
38 ,Ehime,total,1940,Showa,15,1178498,580700,597798
38 ,Ehime,0_ 4,1940,Showa,15,150450,75923,74527
38 ,Ehime,5_ 9,1940,Showa,15,151369,76662,74707
38 ,Ehime,10_ 14,1940,Showa,15,145628,72593,73035
38 ,Ehime,15_ 19,1940,Showa,15,108298,51400,56898
38 ,Ehime,20_ 24,1940,Showa,15,85642,43747,41895
38 ,Ehime,25_ 29,1940,Showa,15,75256,36473,38783
38 ,Ehime,30_ 34,1940,Showa,15,70937,34603,36334
38 ,Ehime,35_ 39,1940,Showa,15,65643,32435,33208
38 ,Ehime,40_ 44,1940,Showa,15,61999,31227,30772
38 ,Ehime,45_ 49,1940,Showa,15,51261,26051,25210
38 ,Ehime,50_ 54,1940,Showa,15,47239,23417,23822
38 ,Ehime,55_ 59,1940,Showa,15,45468,21892,23576
38 ,Ehime,60_ 64,1940,Showa,15,41572,19747,21825
38 ,Ehime,65_ 69,1940,Showa,15,33073,15367,17706
38 ,Ehime,70_ 74,1940,Showa,15,22105,9964,12141
38 ,Ehime,75_ 79,1940,Showa,15,12789,5457,7332
38 ,Ehime,80_ 84,1940,Showa,15,6847,2742,4105
38 ,Ehime,over_85,1940,Showa,15,2922,1000,1922
38 ,Ehime,total,1945,Showa,20,1361484,635305,726179
38 ,Ehime,1_ 5,1945,Showa,20,179836,91168,88668
38 ,Ehime,6_ 10,1945,Showa,20,167830,84532,83298
38 ,Ehime,11_ 15,1945,Showa,20,166898,84282,82616
38 ,Ehime,16_ 20,1945,Showa,20,146243,70252,75991
38 ,Ehime,21_ 25,1945,Showa,20,100735,36758,63977
38 ,Ehime,26_ 30,1945,Showa,20,77428,26804,50624
38 ,Ehime,31_ 35,1945,Showa,20,77419,30064,47355
38 ,Ehime,36_ 40,1945,Showa,20,75452,33294,42158
38 ,Ehime,41_ 45,1945,Showa,20,71632,35216,36416
38 ,Ehime,46_ 50,1945,Showa,20,65778,33189,32589
38 ,Ehime,51_ 55,1945,Showa,20,53580,27162,26418
38 ,Ehime,56_ 60,1945,Showa,20,47778,23638,24140
38 ,Ehime,61_ 65,1945,Showa,20,42746,20136,22610
38 ,Ehime,66_ 70,1945,Showa,20,36764,16904,19860
38 ,Ehime,71_ 75,1945,Showa,20,26843,11917,14926
38 ,Ehime,76_ 80,1945,Showa,20,14728,6259,8469
38 ,Ehime,81_ 85,1945,Showa,20,6799,2703,4096
38 ,Ehime,86以上,1945,Showa,20,2995,1027,1968
38 ,Ehime,total,1950,Showa,25,1521878,742092,779786
38 ,Ehime,0_ 4,1950,Showa,25,215101,110004,105097
38 ,Ehime,5_ 9,1950,Showa,25,178689,90654,88035
38 ,Ehime,10_ 14,1950,Showa,25,163951,82585,81366
38 ,Ehime,15_ 19,1950,Showa,25,156471,77729,78742
38 ,Ehime,20_ 24,1950,Showa,25,133568,63808,69760
38 ,Ehime,25_ 29,1950,Showa,25,107599,48874,58725
38 ,Ehime,30_ 34,1950,Showa,25,87193,39301,47892
38 ,Ehime,35_ 39,1950,Showa,25,84174,38731,45443
38 ,Ehime,40_ 44,1950,Showa,25,78012,37731,40281
38 ,Ehime,45_ 49,1950,Showa,25,69323,34589,34734
38 ,Ehime,50_ 54,1950,Showa,25,62484,31649,30835
38 ,Ehime,55_ 59,1950,Showa,25,49807,25128,24679
38 ,Ehime,60_ 64,1950,Showa,25,42533,20632,21901
38 ,Ehime,65_ 69,1950,Showa,25,36110,16538,19572
38 ,Ehime,70_ 74,1950,Showa,25,28237,12488,15749
38 ,Ehime,75_ 79,1950,Showa,25,17704,7444,10260
38 ,Ehime,over_80,1950,Showa,25,10906,4196,6710
38 ,Ehime,total,1955,Showa,30,1540628,749342,791286
38 ,Ehime,0_ 4,1955,Showa,30,166293,84867,81426
38 ,Ehime,5_ 9,1955,Showa,30,205347,105040,100307
38 ,Ehime,10_ 14,1955,Showa,30,172721,87515,85206
38 ,Ehime,15_ 19,1955,Showa,30,140434,69752,70682
38 ,Ehime,20_ 24,1955,Showa,30,128334,60600,67734
38 ,Ehime,25_ 29,1955,Showa,30,121949,58267,63682
38 ,Ehime,30_ 34,1955,Showa,30,101174,46171,55003
38 ,Ehime,35_ 39,1955,Showa,30,82379,36991,45388
38 ,Ehime,40_ 44,1955,Showa,30,79370,36426,42944
38 ,Ehime,45_ 49,1955,Showa,30,73746,35483,38263
38 ,Ehime,50_ 54,1955,Showa,30,65145,32308,32837
38 ,Ehime,55_ 59,1955,Showa,30,58308,29248,29060
38 ,Ehime,60_ 64,1955,Showa,30,45115,22431,22684
38 ,Ehime,65_ 69,1955,Showa,30,36695,17441,19254
38 ,Ehime,70_ 74,1955,Showa,30,29031,12902,16129
38 ,Ehime,75_ 79,1955,Showa,30,20028,8437,11591
38 ,Ehime,80_ 84,1955,Showa,30,10347,4019,6328
38 ,Ehime,over_85,1955,Showa,30,4201,1439,2762
38 ,Ehime,total,1960,Showa,35,1500687,721311,779376
38 ,Ehime,0_ 4,1960,Showa,35,128320,65652,62668
38 ,Ehime,5_ 9,1960,Showa,35,161937,82515,79422
38 ,Ehime,10_ 14,1960,Showa,35,200810,102585,98225
38 ,Ehime,15_ 19,1960,Showa,35,129737,63145,66592
38 ,Ehime,20_ 24,1960,Showa,35,106368,47144,59224
38 ,Ehime,25_ 29,1960,Showa,35,115508,54364,61144
38 ,Ehime,30_ 34,1960,Showa,35,115574,55326,60248
38 ,Ehime,35_ 39,1960,Showa,35,96601,43665,52936
38 ,Ehime,40_ 44,1960,Showa,35,78769,35095,43674
38 ,Ehime,45_ 49,1960,Showa,35,75566,34349,41217
38 ,Ehime,50_ 54,1960,Showa,35,69631,33252,36379
38 ,Ehime,55_ 59,1960,Showa,35,60931,29921,31010
38 ,Ehime,60_ 64,1960,Showa,35,53283,26284,26999
38 ,Ehime,65_ 69,1960,Showa,35,39427,19159,20268
38 ,Ehime,70_ 74,1960,Showa,35,29945,13667,16278
38 ,Ehime,75_ 79,1960,Showa,35,20756,8720,12036
38 ,Ehime,80_ 84,1960,Showa,35,11776,4531,7245
38 ,Ehime,over_85,1960,Showa,35,5748,1937,3811
38 ,Ehime,total,1965,Showa,40,1446384,688063,758321
38 ,Ehime,0_ 4,1965,Showa,40,112814,57207,55607
38 ,Ehime,5_ 9,1965,Showa,40,124225,63138,61087
38 ,Ehime,10_ 14,1965,Showa,40,157150,79695,77455
38 ,Ehime,15_ 19,1965,Showa,40,152807,74731,78076
38 ,Ehime,20_ 24,1965,Showa,40,99794,42847,56947
38 ,Ehime,25_ 29,1965,Showa,40,98575,45261,53314
38 ,Ehime,30_ 34,1965,Showa,40,110272,52780,57492
38 ,Ehime,35_ 39,1965,Showa,40,111094,53076,58018
38 ,Ehime,40_ 44,1965,Showa,40,92898,41989,50909
38 ,Ehime,45_ 49,1965,Showa,40,75341,33351,41990
38 ,Ehime,50_ 54,1965,Showa,40,71439,32268,39171
38 ,Ehime,55_ 59,1965,Showa,40,65287,30964,34323
38 ,Ehime,60_ 64,1965,Showa,40,55864,27211,28653
38 ,Ehime,65_ 69,1965,Showa,40,46598,22399,24199
38 ,Ehime,70_ 74,1965,Showa,40,32294,15120,17174
38 ,Ehime,75_ 79,1965,Showa,40,21513,9356,12157
38 ,Ehime,80_ 84,1965,Showa,40,11886,4483,7403
38 ,Ehime,over_85,1965,Showa,40,6533,2187,4346
38 ,Ehime,total,1970,Showa,45,1418124,670980,747144
38 ,Ehime,0_ 4,1970,Showa,45,106999,54885,52114
38 ,Ehime,5_ 9,1970,Showa,45,112731,57225,55506
38 ,Ehime,10_ 14,1970,Showa,45,122941,62507,60434
38 ,Ehime,15_ 19,1970,Showa,45,120784,58779,62005
38 ,Ehime,20_ 24,1970,Showa,45,118270,51495,66775
38 ,Ehime,25_ 29,1970,Showa,45,99222,46137,53085
38 ,Ehime,30_ 34,1970,Showa,45,98602,46422,52180
38 ,Ehime,35_ 39,1970,Showa,45,108600,52173,56427
38 ,Ehime,40_ 44,1970,Showa,45,107015,51189,55826
38 ,Ehime,45_ 49,1970,Showa,45,90143,40441,49702
38 ,Ehime,50_ 54,1970,Showa,45,72412,31863,40549
38 ,Ehime,55_ 59,1970,Showa,45,66840,30064,36776
38 ,Ehime,60_ 64,1970,Showa,45,60353,28052,32301
38 ,Ehime,65_ 69,1970,Showa,45,49828,23472,26356
38 ,Ehime,70_ 74,1970,Showa,45,39503,18205,21298
38 ,Ehime,75_ 79,1970,Showa,45,23730,10519,13211
38 ,Ehime,80_ 84,1970,Showa,45,13127,5306,7821
38 ,Ehime,over_85,1970,Showa,45,7024,2246,4778
38 ,Ehime,total,1975,Showa,50,1465215,697794,767421
38 ,Ehime,0_ 4,1975,Showa,50,120507,61671,58836
38 ,Ehime,5_ 9,1975,Showa,50,109685,56278,53407
38 ,Ehime,10_ 14,1975,Showa,50,113690,57843,55847
38 ,Ehime,15_ 19,1975,Showa,50,104178,51711,52467
38 ,Ehime,20_ 24,1975,Showa,50,98590,43989,54601
38 ,Ehime,25_ 29,1975,Showa,50,125225,60680,64545
38 ,Ehime,30_ 34,1975,Showa,50,103475,50049,53426
38 ,Ehime,35_ 39,1975,Showa,50,100138,47627,52511
38 ,Ehime,40_ 44,1975,Showa,50,108672,52245,56427
38 ,Ehime,45_ 49,1975,Showa,50,106671,50862,55809
38 ,Ehime,50_ 54,1975,Showa,50,87682,39293,48389
38 ,Ehime,55_ 59,1975,Showa,50,69634,30427,39207
38 ,Ehime,60_ 64,1975,Showa,50,64562,28467,36095
38 ,Ehime,65_ 69,1975,Showa,50,55668,25138,30530
38 ,Ehime,70_ 74,1975,Showa,50,42762,19242,23520
38 ,Ehime,75_ 79,1975,Showa,50,30127,13093,17034
38 ,Ehime,80_ 84,1975,Showa,50,15344,6209,9135
38 ,Ehime,over_85,1975,Showa,50,8443,2872,5571
38 ,Ehime,total,1980,Showa,55,1506637,718517,788120
38 ,Ehime,0_ 4,1980,Showa,55,106027,54467,51560
38 ,Ehime,5_ 9,1980,Showa,55,124029,63503,60526
38 ,Ehime,10_ 14,1980,Showa,55,111206,57250,53956
38 ,Ehime,15_ 19,1980,Showa,55,101162,50771,50391
38 ,Ehime,20_ 24,1980,Showa,55,85032,38105,46927
38 ,Ehime,25_ 29,1980,Showa,55,107050,51279,55771
38 ,Ehime,30_ 34,1980,Showa,55,128857,63979,64878
38 ,Ehime,35_ 39,1980,Showa,55,104872,50921,53951
38 ,Ehime,40_ 44,1980,Showa,55,99625,47285,52340
38 ,Ehime,45_ 49,1980,Showa,55,106737,50960,55777
38 ,Ehime,50_ 54,1980,Showa,55,104510,49423,55087
38 ,Ehime,55_ 59,1980,Showa,55,85616,37893,47723
38 ,Ehime,60_ 64,1980,Showa,55,66940,28921,38019
38 ,Ehime,65_ 69,1980,Showa,55,60166,25895,34271
38 ,Ehime,70_ 74,1980,Showa,55,49028,21297,27731
38 ,Ehime,75_ 79,1980,Showa,55,34383,14563,19820
38 ,Ehime,80_ 84,1980,Showa,55,20421,8185,12236
38 ,Ehime,over_85,1980,Showa,55,10731,3670,7061
38 ,Ehime,total,1985,Showa,60,1529983,728506,801477
38 ,Ehime,0_ 4,1985,Showa,60,92926,47414,45512
38 ,Ehime,5_ 9,1985,Showa,60,107828,55449,52379
38 ,Ehime,10_ 14,1985,Showa,60,125204,64337,60867
38 ,Ehime,15_ 19,1985,Showa,60,102366,52056,50310
38 ,Ehime,20_ 24,1985,Showa,60,82191,37396,44795
38 ,Ehime,25_ 29,1985,Showa,60,91418,43355,48063
38 ,Ehime,30_ 34,1985,Showa,60,108834,53190,55644
38 ,Ehime,35_ 39,1985,Showa,60,129959,64787,65172
38 ,Ehime,40_ 44,1985,Showa,60,104024,50380,53644
38 ,Ehime,45_ 49,1985,Showa,60,97869,46230,51639
38 ,Ehime,50_ 54,1985,Showa,60,104369,49401,54968
38 ,Ehime,55_ 59,1985,Showa,60,102142,47681,54461
38 ,Ehime,60_ 64,1985,Showa,60,82796,36188,46608
38 ,Ehime,65_ 69,1985,Showa,60,63106,26681,36425
38 ,Ehime,70_ 74,1985,Showa,60,54275,22505,31770
38 ,Ehime,75_ 79,1985,Showa,60,40902,16674,24228
38 ,Ehime,80_ 84,1985,Showa,60,24425,9480,14945
38 ,Ehime,over_85,1985,Showa,60,15336,5295,10041
38 ,Ehime,total,1990,Heisei,2,1515025,716940,798085
38 ,Ehime,0_ 4,1990,Heisei,2,79210,40334,38876
38 ,Ehime,5_ 9,1990,Heisei,2,93640,47816,45824
38 ,Ehime,10_ 14,1990,Heisei,2,108069,55632,52437
38 ,Ehime,15_ 19,1990,Heisei,2,111914,56373,55541
38 ,Ehime,20_ 24,1990,Heisei,2,78829,35958,42871
38 ,Ehime,25_ 29,1990,Heisei,2,84535,39496,45039
38 ,Ehime,30_ 34,1990,Heisei,2,90891,43898,46993
38 ,Ehime,35_ 39,1990,Heisei,2,108450,53013,55437
38 ,Ehime,40_ 44,1990,Heisei,2,128030,63681,64349
38 ,Ehime,45_ 49,1990,Heisei,2,101476,48935,52541
38 ,Ehime,50_ 54,1990,Heisei,2,95312,44659,50653
38 ,Ehime,55_ 59,1990,Heisei,2,101902,47562,54340
38 ,Ehime,60_ 64,1990,Heisei,2,99065,45626,53439
38 ,Ehime,65_ 69,1990,Heisei,2,78491,33732,44759
38 ,Ehime,70_ 74,1990,Heisei,2,57549,23504,34045
38 ,Ehime,75_ 79,1990,Heisei,2,46291,18115,28176
38 ,Ehime,80_ 84,1990,Heisei,2,30222,11285,18937
38 ,Ehime,over_85,1990,Heisei,2,20173,6696,13477
38 ,Ehime,total,1995,Heisei,7,1506700,712518,794182
38 ,Ehime,0_ 4,1995,Heisei,7,70515,36236,34279
38 ,Ehime,5_ 9,1995,Heisei,7,80694,41095,39599
38 ,Ehime,10_ 14,1995,Heisei,7,94354,48317,46037
38 ,Ehime,15_ 19,1995,Heisei,7,97255,49529,47726
38 ,Ehime,20_ 24,1995,Heisei,7,92914,44455,48459
38 ,Ehime,25_ 29,1995,Heisei,7,84409,39942,44467
38 ,Ehime,30_ 34,1995,Heisei,7,86171,41393,44778
38 ,Ehime,35_ 39,1995,Heisei,7,92234,44884,47350
38 ,Ehime,40_ 44,1995,Heisei,7,108599,53212,55387
38 ,Ehime,45_ 49,1995,Heisei,7,127109,63259,63850
38 ,Ehime,50_ 54,1995,Heisei,7,100271,48073,52198
38 ,Ehime,55_ 59,1995,Heisei,7,94181,43723,50458
38 ,Ehime,60_ 64,1995,Heisei,7,99257,45879,53378
38 ,Ehime,65_ 69,1995,Heisei,7,94137,42358,51779
38 ,Ehime,70_ 74,1995,Heisei,7,72411,29953,42458
38 ,Ehime,75_ 79,1995,Heisei,7,49757,19181,30576
38 ,Ehime,80_ 84,1995,Heisei,7,35540,12739,22801
38 ,Ehime,over_85,1995,Heisei,7,26846,8264,18582
38 ,Ehime,total,2000,Heisei,12,1493092,704289,788803
38 ,Ehime,0_ 4,2000,Heisei,12,66658,33935,32723
38 ,Ehime,5_ 9,2000,Heisei,12,71425,36714,34711
38 ,Ehime,10_ 14,2000,Heisei,12,81257,41557,39700
38 ,Ehime,15_ 19,2000,Heisei,12,85225,43085,42140
38 ,Ehime,20_ 24,2000,Heisei,12,80144,38648,41496
38 ,Ehime,25_ 29,2000,Heisei,12,98351,47942,50409
38 ,Ehime,30_ 34,2000,Heisei,12,85848,41408,44440
38 ,Ehime,35_ 39,2000,Heisei,12,86858,41954,44904
38 ,Ehime,40_ 44,2000,Heisei,12,92324,45008,47316
38 ,Ehime,45_ 49,2000,Heisei,12,107482,52554,54928
38 ,Ehime,50_ 54,2000,Heisei,12,125050,61752,63298
38 ,Ehime,55_ 59,2000,Heisei,12,98894,46823,52071
38 ,Ehime,60_ 64,2000,Heisei,12,93013,42902,50111
38 ,Ehime,65_ 69,2000,Heisei,12,94847,42881,51966
38 ,Ehime,70_ 74,2000,Heisei,12,86978,37826,49152
38 ,Ehime,75_ 79,2000,Heisei,12,63630,24866,38764
38 ,Ehime,80_ 84,2000,Heisei,12,39184,13837,25347
38 ,Ehime,over_85,2000,Heisei,12,35439,10289,25150
38 ,Ehime,total,2005,Heisei,17,1467815,691677,776138
38 ,Ehime,0_ 4,2005,Heisei,17,61145,31402,29743
38 ,Ehime,5_ 9,2005,Heisei,17,67357,34303,33054
38 ,Ehime,10_ 14,2005,Heisei,17,71768,37002,34766
38 ,Ehime,15_ 19,2005,Heisei,17,73670,37497,36173
38 ,Ehime,20_ 24,2005,Heisei,17,69128,33613,35515
38 ,Ehime,25_ 29,2005,Heisei,17,83389,40873,42516
38 ,Ehime,30_ 34,2005,Heisei,17,98227,48429,49798
38 ,Ehime,35_ 39,2005,Heisei,17,85583,41487,44096
38 ,Ehime,40_ 44,2005,Heisei,17,86588,41829,44759
38 ,Ehime,45_ 49,2005,Heisei,17,91249,44331,46918
38 ,Ehime,50_ 54,2005,Heisei,17,105947,51531,54416
38 ,Ehime,55_ 59,2005,Heisei,17,123199,60363,62836
38 ,Ehime,60_ 64,2005,Heisei,17,97767,46104,51663
38 ,Ehime,65_ 69,2005,Heisei,17,89511,40723,48788
38 ,Ehime,70_ 74,2005,Heisei,17,88643,38849,49794
38 ,Ehime,75_ 79,2005,Heisei,17,77253,31812,45441
38 ,Ehime,80_ 84,2005,Heisei,17,52020,18590,33430
38 ,Ehime,over_85,2005,Heisei,17,44563,12464,32099
38 ,Ehime,total,2010,Heisei,22,1431493,673326,758167
38 ,Ehime,0_ 4,2010,Heisei,22,56508,28767,27741
38 ,Ehime,5_ 9,2010,Heisei,22,61357,31568,29789
38 ,Ehime,10_ 14,2010,Heisei,22,67314,34467,32847
38 ,Ehime,15_ 19,2010,Heisei,22,65646,33744,31902
38 ,Ehime,20_ 24,2010,Heisei,22,58624,28370,30254
38 ,Ehime,25_ 29,2010,Heisei,22,70427,34670,35757
38 ,Ehime,30_ 34,2010,Heisei,22,82870,41111,41759
38 ,Ehime,35_ 39,2010,Heisei,22,97172,48112,49060
38 ,Ehime,40_ 44,2010,Heisei,22,84402,40722,43680
38 ,Ehime,45_ 49,2010,Heisei,22,85099,40976,44123
38 ,Ehime,50_ 54,2010,Heisei,22,89511,43169,46342
38 ,Ehime,55_ 59,2010,Heisei,22,104136,50298,53838
38 ,Ehime,60_ 64,2010,Heisei,22,121104,58729,62375
38 ,Ehime,65_ 69,2010,Heisei,22,94089,43709,50380
38 ,Ehime,70_ 74,2010,Heisei,22,83951,37072,46879
38 ,Ehime,75_ 79,2010,Heisei,22,79119,32897,46222
38 ,Ehime,80_ 84,2010,Heisei,22,63446,23873,39573
38 ,Ehime,over_85,2010,Heisei,22,57986,16205,41781
38 ,Ehime,total,2015,Heisei,27,1385262,654380,730882
38 ,Ehime,0_ 4,2015,Heisei,27,51632,26658,24974
38 ,Ehime,5_ 9,2015,Heisei,27,56441,28749,27692
38 ,Ehime,10_ 14,2015,Heisei,27,61037,31442,29595
38 ,Ehime,15_ 19,2015,Heisei,27,62603,32297,30306
38 ,Ehime,20_ 24,2015,Heisei,27,51846,26153,25693
38 ,Ehime,25_ 29,2015,Heisei,27,59274,29397,29877
38 ,Ehime,30_ 34,2015,Heisei,27,69717,34558,35159
38 ,Ehime,35_ 39,2015,Heisei,27,81749,40635,41114
38 ,Ehime,40_ 44,2015,Heisei,27,95392,47086,48306
38 ,Ehime,45_ 49,2015,Heisei,27,82646,39856,42790
38 ,Ehime,50_ 54,2015,Heisei,27,83188,39927,43261
38 ,Ehime,55_ 59,2015,Heisei,27,87694,42071,45623
38 ,Ehime,60_ 64,2015,Heisei,27,102002,48969,53033
38 ,Ehime,65_ 69,2015,Heisei,27,116490,55774,60716
38 ,Ehime,70_ 74,2015,Heisei,27,87797,39720,48077
38 ,Ehime,75_ 79,2015,Heisei,27,75316,32009,43307
38 ,Ehime,80_ 84,2015,Heisei,27,65694,25186,40508
38 ,Ehime,over_85,2015,Heisei,27,71889,21152,50737
39 ,Kochi,total,1920,Taisho,9,670895,332087,338808
39 ,Kochi,0_ 4,1920,Taisho,9,83270,41880,41390
39 ,Kochi,5_ 9,1920,Taisho,9,78019,39561,38458
39 ,Kochi,10_ 14,1920,Taisho,9,68279,35048,33231
39 ,Kochi,15_ 19,1920,Taisho,9,59065,29642,29423
39 ,Kochi,20_ 24,1920,Taisho,9,53277,25305,27972
39 ,Kochi,25_ 29,1920,Taisho,9,44759,21987,22772
39 ,Kochi,30_ 34,1920,Taisho,9,44686,21271,23415
39 ,Kochi,35_ 39,1920,Taisho,9,35626,16950,18676
39 ,Kochi,40_ 44,1920,Taisho,9,34670,16971,17699
39 ,Kochi,45_ 49,1920,Taisho,9,37501,18438,19063
39 ,Kochi,50_ 54,1920,Taisho,9,31697,15666,16031
39 ,Kochi,55_ 59,1920,Taisho,9,27178,13625,13553
39 ,Kochi,60_ 64,1920,Taisho,9,25960,13225,12735
39 ,Kochi,65_ 69,1920,Taisho,9,19802,9881,9921
39 ,Kochi,70_ 74,1920,Taisho,9,13190,6270,6920
39 ,Kochi,75_ 79,1920,Taisho,9,8556,4076,4480
39 ,Kochi,over_80,1920,Taisho,9,5360,2291,3069
39 ,Kochi,total,1925,Taisho,14,687478,341687,345791
39 ,Kochi,0_ 4,1925,Taisho,14,89944,45048,44896
39 ,Kochi,5_ 9,1925,Taisho,14,77820,39216,38604
39 ,Kochi,10_ 14,1925,Taisho,14,73344,37666,35678
39 ,Kochi,15_ 19,1925,Taisho,14,58472,30228,28244
39 ,Kochi,20_ 24,1925,Taisho,14,51511,25313,26198
39 ,Kochi,25_ 29,1925,Taisho,14,50059,24599,25460
39 ,Kochi,30_ 34,1925,Taisho,14,41991,20888,21103
39 ,Kochi,35_ 39,1925,Taisho,14,42368,20474,21894
39 ,Kochi,40_ 44,1925,Taisho,14,33700,16260,17440
39 ,Kochi,45_ 49,1925,Taisho,14,32777,16017,16760
39 ,Kochi,50_ 54,1925,Taisho,14,34613,17090,17523
39 ,Kochi,55_ 59,1925,Taisho,14,28705,14123,14582
39 ,Kochi,60_ 64,1925,Taisho,14,23498,11647,11851
39 ,Kochi,65_ 69,1925,Taisho,14,20697,10284,10413
39 ,Kochi,70_ 74,1925,Taisho,14,14248,6840,7408
39 ,Kochi,75_ 79,1925,Taisho,14,8124,3621,4503
39 ,Kochi,80_ 84,1925,Taisho,14,4055,1796,2259
39 ,Kochi,over_85,1925,Taisho,14,1552,577,975
39 ,Kochi,total,1930,Showa,5,718152,357166,360986
39 ,Kochi,0_ 4,1930,Showa,5,92928,46967,45961
39 ,Kochi,5_ 9,1930,Showa,5,84747,42497,42250
39 ,Kochi,10_ 14,1930,Showa,5,74018,37385,36633
39 ,Kochi,15_ 19,1930,Showa,5,64797,33045,31752
39 ,Kochi,20_ 24,1930,Showa,5,52657,26366,26291
39 ,Kochi,25_ 29,1930,Showa,5,50156,25154,25002
39 ,Kochi,30_ 34,1930,Showa,5,48802,24223,24579
39 ,Kochi,35_ 39,1930,Showa,5,40795,20481,20314
39 ,Kochi,40_ 44,1930,Showa,5,40740,19967,20773
39 ,Kochi,45_ 49,1930,Showa,5,32150,15526,16624
39 ,Kochi,50_ 54,1930,Showa,5,30456,15000,15456
39 ,Kochi,55_ 59,1930,Showa,5,31660,15489,16171
39 ,Kochi,60_ 64,1930,Showa,5,25288,12217,13071
39 ,Kochi,65_ 69,1930,Showa,5,19191,9320,9871
39 ,Kochi,70_ 74,1930,Showa,5,15182,7261,7921
39 ,Kochi,75_ 79,1930,Showa,5,8830,3991,4839
39 ,Kochi,over_80,1930,Showa,5,5755,2277,3478
39 ,Kochi,total,1935,Showa,10,714980,355225,359755
39 ,Kochi,0_ 4,1935,Showa,10,87523,44405,43118
39 ,Kochi,5_ 9,1935,Showa,10,87241,44110,43131
39 ,Kochi,10_ 14,1935,Showa,10,78686,40111,38575
39 ,Kochi,15_ 19,1935,Showa,10,58039,29925,28114
39 ,Kochi,20_ 24,1935,Showa,10,51507,24976,26531
39 ,Kochi,25_ 29,1935,Showa,10,46909,23311,23598
39 ,Kochi,30_ 34,1935,Showa,10,46357,23112,23245
39 ,Kochi,35_ 39,1935,Showa,10,45431,22488,22943
39 ,Kochi,40_ 44,1935,Showa,10,38209,19248,18961
39 ,Kochi,45_ 49,1935,Showa,10,38277,18640,19637
39 ,Kochi,50_ 54,1935,Showa,10,29832,14379,15453
39 ,Kochi,55_ 59,1935,Showa,10,27976,13642,14334
39 ,Kochi,60_ 64,1935,Showa,10,27736,13342,14394
39 ,Kochi,65_ 69,1935,Showa,10,20854,9874,10980
39 ,Kochi,70_ 74,1935,Showa,10,14294,6688,7606
39 ,Kochi,75_ 79,1935,Showa,10,9688,4422,5266
39 ,Kochi,over_80,1935,Showa,10,6421,2552,3869
39 ,Kochi,total,1940,Showa,15,709108,348779,360329
39 ,Kochi,0_ 4,1940,Showa,15,77194,39288,37906
39 ,Kochi,5_ 9,1940,Showa,15,82532,41980,40552
39 ,Kochi,10_ 14,1940,Showa,15,82413,41534,40879
39 ,Kochi,15_ 19,1940,Showa,15,61702,29580,32122
39 ,Kochi,20_ 24,1940,Showa,15,51107,25771,25336
39 ,Kochi,25_ 29,1940,Showa,15,46392,22334,24058
39 ,Kochi,30_ 34,1940,Showa,15,43269,21249,22020
39 ,Kochi,35_ 39,1940,Showa,15,43470,21359,22111
39 ,Kochi,40_ 44,1940,Showa,15,42964,21147,21817
39 ,Kochi,45_ 49,1940,Showa,15,36083,17979,18104
39 ,Kochi,50_ 54,1940,Showa,15,35677,17253,18424
39 ,Kochi,55_ 59,1940,Showa,15,27153,12920,14233
39 ,Kochi,60_ 64,1940,Showa,15,24667,11752,12915
39 ,Kochi,65_ 69,1940,Showa,15,22855,10699,12156
39 ,Kochi,70_ 74,1940,Showa,15,15660,7111,8549
39 ,Kochi,75_ 79,1940,Showa,15,9119,4016,5103
39 ,Kochi,80_ 84,1940,Showa,15,4796,2056,2740
39 ,Kochi,over_85,1940,Showa,15,2055,751,1304
39 ,Kochi,total,1945,Showa,20,775578,357940,417638
39 ,Kochi,1_ 5,1945,Showa,20,92919,47142,45777
39 ,Kochi,6_ 10,1945,Showa,20,82994,42204,40790
39 ,Kochi,11_ 15,1945,Showa,20,88109,44600,43509
39 ,Kochi,16_ 20,1945,Showa,20,80936,38831,42105
39 ,Kochi,21_ 25,1945,Showa,20,57706,20896,36810
39 ,Kochi,26_ 30,1945,Showa,20,44289,14540,29749
39 ,Kochi,31_ 35,1945,Showa,20,43629,15955,27674
39 ,Kochi,36_ 40,1945,Showa,20,42361,18090,24271
39 ,Kochi,41_ 45,1945,Showa,20,45167,22124,23043
39 ,Kochi,46_ 50,1945,Showa,20,44353,21708,22645
39 ,Kochi,51_ 55,1945,Showa,20,36407,18242,18165
39 ,Kochi,56_ 60,1945,Showa,20,34332,16577,17755
39 ,Kochi,61_ 65,1945,Showa,20,25482,11848,13634
39 ,Kochi,66_ 70,1945,Showa,20,21483,9841,11642
39 ,Kochi,71_ 75,1945,Showa,20,17729,7941,9788
39 ,Kochi,76_ 80,1945,Showa,20,10896,4715,6181
39 ,Kochi,81_ 85,1945,Showa,20,4770,1925,2845
39 ,Kochi,86以上,1945,Showa,20,2016,761,1255
39 ,Kochi,total,1950,Showa,25,873874,425968,447906
39 ,Kochi,0_ 4,1950,Showa,25,111730,57296,54434
39 ,Kochi,5_ 9,1950,Showa,25,94550,48091,46459
39 ,Kochi,10_ 14,1950,Showa,25,83801,42739,41062
39 ,Kochi,15_ 19,1950,Showa,25,82116,42261,39855
39 ,Kochi,20_ 24,1950,Showa,25,75390,36411,38979
39 ,Kochi,25_ 29,1950,Showa,25,63856,28887,34969
39 ,Kochi,30_ 34,1950,Showa,25,52650,23365,29285
39 ,Kochi,35_ 39,1950,Showa,25,50393,22908,27485
39 ,Kochi,40_ 44,1950,Showa,25,46657,22621,24036
39 ,Kochi,45_ 49,1950,Showa,25,45087,22408,22679
39 ,Kochi,50_ 54,1950,Showa,25,42885,21197,21688
39 ,Kochi,55_ 59,1950,Showa,25,34613,17204,17409
39 ,Kochi,60_ 64,1950,Showa,25,32031,15172,16859
39 ,Kochi,65_ 69,1950,Showa,25,21455,9846,11609
39 ,Kochi,70_ 74,1950,Showa,25,16658,7390,9268
39 ,Kochi,75_ 79,1950,Showa,25,12088,5099,6989
39 ,Kochi,over_80,1950,Showa,25,7872,3056,4816
39 ,Kochi,total,1955,Showa,30,882683,429175,453508
39 ,Kochi,0_ 4,1955,Showa,30,84224,43267,40957
39 ,Kochi,5_ 9,1955,Showa,30,107656,55249,52407
39 ,Kochi,10_ 14,1955,Showa,30,91834,46719,45115
39 ,Kochi,15_ 19,1955,Showa,30,72204,36840,35364
39 ,Kochi,20_ 24,1955,Showa,30,71156,34315,36841
39 ,Kochi,25_ 29,1955,Showa,30,71402,34534,36868
39 ,Kochi,30_ 34,1955,Showa,30,60804,27584,33220
39 ,Kochi,35_ 39,1955,Showa,30,50317,22291,28026
39 ,Kochi,40_ 44,1955,Showa,30,48084,21752,26332
39 ,Kochi,45_ 49,1955,Showa,30,44247,21376,22871
39 ,Kochi,50_ 54,1955,Showa,30,42724,21169,21555
39 ,Kochi,55_ 59,1955,Showa,30,40273,19737,20536
39 ,Kochi,60_ 64,1955,Showa,30,31381,15336,16045
39 ,Kochi,65_ 69,1955,Showa,30,27544,12685,14859
39 ,Kochi,70_ 74,1955,Showa,30,17376,7642,9734
39 ,Kochi,75_ 79,1955,Showa,30,11567,4921,6646
39 ,Kochi,80_ 84,1955,Showa,30,6827,2661,4166
39 ,Kochi,over_85,1955,Showa,30,3053,1095,1958
39 ,Kochi,total,1960,Showa,35,854595,411162,443433
39 ,Kochi,0_ 4,1960,Showa,35,65509,33430,32079
39 ,Kochi,5_ 9,1960,Showa,35,82304,42272,40032
39 ,Kochi,10_ 14,1960,Showa,35,105268,53932,51336
39 ,Kochi,15_ 19,1960,Showa,35,67854,34150,33704
39 ,Kochi,20_ 24,1960,Showa,35,55544,25380,30164
39 ,Kochi,25_ 29,1960,Showa,35,65855,31412,34443
39 ,Kochi,30_ 34,1960,Showa,35,68063,32819,35244
39 ,Kochi,35_ 39,1960,Showa,35,58385,26245,32140
39 ,Kochi,40_ 44,1960,Showa,35,48162,21232,26930
39 ,Kochi,45_ 49,1960,Showa,35,45976,20596,25380
39 ,Kochi,50_ 54,1960,Showa,35,41954,20151,21803
39 ,Kochi,55_ 59,1960,Showa,35,40254,19606,20648
39 ,Kochi,60_ 64,1960,Showa,35,36835,17776,19059
39 ,Kochi,65_ 69,1960,Showa,35,27401,13059,14342
39 ,Kochi,70_ 74,1960,Showa,35,22436,9996,12440
39 ,Kochi,75_ 79,1960,Showa,35,12399,5193,7206
39 ,Kochi,80_ 84,1960,Showa,35,6726,2642,4084
39 ,Kochi,over_85,1960,Showa,35,3670,1271,2399
39 ,Kochi,total,1965,Showa,40,812714,386725,425989
39 ,Kochi,0_ 4,1965,Showa,40,57280,29309,27971
39 ,Kochi,5_ 9,1965,Showa,40,63492,32244,31248
39 ,Kochi,10_ 14,1965,Showa,40,79283,40432,38851
39 ,Kochi,15_ 19,1965,Showa,40,76638,38315,38323
39 ,Kochi,20_ 24,1965,Showa,40,52416,23176,29240
39 ,Kochi,25_ 29,1965,Showa,40,53066,24676,28390
39 ,Kochi,30_ 34,1965,Showa,40,62976,30258,32718
39 ,Kochi,35_ 39,1965,Showa,40,65294,31409,33885
39 ,Kochi,40_ 44,1965,Showa,40,55520,24939,30581
39 ,Kochi,45_ 49,1965,Showa,40,45689,19941,25748
39 ,Kochi,50_ 54,1965,Showa,40,43282,19320,23962
39 ,Kochi,55_ 59,1965,Showa,40,39197,18591,20606
39 ,Kochi,60_ 64,1965,Showa,40,36759,17667,19092
39 ,Kochi,65_ 69,1965,Showa,40,32234,15251,16983
39 ,Kochi,70_ 74,1965,Showa,40,22472,10377,12095
39 ,Kochi,75_ 79,1965,Showa,40,16219,6787,9432
39 ,Kochi,80_ 84,1965,Showa,40,7089,2764,4325
39 ,Kochi,over_85,1965,Showa,40,3808,1269,2539
39 ,Kochi,total,1970,Showa,45,786882,372014,414868
39 ,Kochi,0_ 4,1970,Showa,45,52898,27151,25747
39 ,Kochi,5_ 9,1970,Showa,45,56920,29093,27827
39 ,Kochi,10_ 14,1970,Showa,45,62173,31713,30460
39 ,Kochi,15_ 19,1970,Showa,45,58521,29338,29183
39 ,Kochi,20_ 24,1970,Showa,45,61166,27700,33466
39 ,Kochi,25_ 29,1970,Showa,45,53818,25316,28502
39 ,Kochi,30_ 34,1970,Showa,45,52891,25137,27754
39 ,Kochi,35_ 39,1970,Showa,45,61678,29608,32070
39 ,Kochi,40_ 44,1970,Showa,45,62788,30117,32671
39 ,Kochi,45_ 49,1970,Showa,45,53556,23870,29686
39 ,Kochi,50_ 54,1970,Showa,45,43720,18922,24798
39 ,Kochi,55_ 59,1970,Showa,45,40694,17899,22795
39 ,Kochi,60_ 64,1970,Showa,45,36086,16667,19419
39 ,Kochi,65_ 69,1970,Showa,45,32608,15166,17442
39 ,Kochi,70_ 74,1970,Showa,45,26946,12111,14835
39 ,Kochi,75_ 79,1970,Showa,45,16617,7160,9457
39 ,Kochi,80_ 84,1970,Showa,45,9687,3676,6011
39 ,Kochi,over_85,1970,Showa,45,4115,1370,2745
39 ,Kochi,total,1975,Showa,50,808397,383538,424859
39 ,Kochi,0_ 4,1975,Showa,50,61421,31450,29971
39 ,Kochi,5_ 9,1975,Showa,50,54278,27960,26318
39 ,Kochi,10_ 14,1975,Showa,50,57306,29291,28015
39 ,Kochi,15_ 19,1975,Showa,50,51608,26165,25443
39 ,Kochi,20_ 24,1975,Showa,50,50303,23150,27153
39 ,Kochi,25_ 29,1975,Showa,50,67216,32755,34461
39 ,Kochi,30_ 34,1975,Showa,50,56549,27435,29114
39 ,Kochi,35_ 39,1975,Showa,50,53611,25627,27984
39 ,Kochi,40_ 44,1975,Showa,50,61401,29510,31891
39 ,Kochi,45_ 49,1975,Showa,50,62020,29616,32404
39 ,Kochi,50_ 54,1975,Showa,50,52235,23101,29134
39 ,Kochi,55_ 59,1975,Showa,50,42210,18080,24130
39 ,Kochi,60_ 64,1975,Showa,50,38976,16823,22153
39 ,Kochi,65_ 69,1975,Showa,50,33136,14822,18314
39 ,Kochi,70_ 74,1975,Showa,50,28089,12483,15606
39 ,Kochi,75_ 79,1975,Showa,50,20939,8805,12134
39 ,Kochi,80_ 84,1975,Showa,50,10726,4252,6474
39 ,Kochi,over_85,1975,Showa,50,5862,1916,3946
39 ,Kochi,total,1980,Showa,55,831275,396418,434857
39 ,Kochi,0_ 4,1980,Showa,55,54321,27802,26519
39 ,Kochi,5_ 9,1980,Showa,55,63840,32756,31084
39 ,Kochi,10_ 14,1980,Showa,55,55488,28513,26975
39 ,Kochi,15_ 19,1980,Showa,55,50882,26088,24794
39 ,Kochi,20_ 24,1980,Showa,55,44206,20770,23436
39 ,Kochi,25_ 29,1980,Showa,55,56725,27713,29012
39 ,Kochi,30_ 34,1980,Showa,55,70617,35338,35279
39 ,Kochi,35_ 39,1980,Showa,55,57752,28169,29583
39 ,Kochi,40_ 44,1980,Showa,55,53963,25960,28003
39 ,Kochi,45_ 49,1980,Showa,55,60837,29213,31624
39 ,Kochi,50_ 54,1980,Showa,55,61132,29013,32119
39 ,Kochi,55_ 59,1980,Showa,55,51105,22428,28677
39 ,Kochi,60_ 64,1980,Showa,55,40561,17270,23291
39 ,Kochi,65_ 69,1980,Showa,55,36017,15150,20867
39 ,Kochi,70_ 74,1980,Showa,55,29120,12499,16621
39 ,Kochi,75_ 79,1980,Showa,55,22464,9348,13116
39 ,Kochi,80_ 84,1980,Showa,55,14144,5467,8677
39 ,Kochi,over_85,1980,Showa,55,7371,2479,4892
39 ,Kochi,total,1985,Showa,60,839784,398408,441376
39 ,Kochi,0_ 4,1985,Showa,60,48751,24759,23992
39 ,Kochi,5_ 9,1985,Showa,60,55515,28464,27051
39 ,Kochi,10_ 14,1985,Showa,60,64314,32933,31381
39 ,Kochi,15_ 19,1985,Showa,60,50392,25605,24787
39 ,Kochi,20_ 24,1985,Showa,60,42059,19643,22416
39 ,Kochi,25_ 29,1985,Showa,60,48308,23426,24882
39 ,Kochi,30_ 34,1985,Showa,60,58051,28646,29405
39 ,Kochi,35_ 39,1985,Showa,60,70935,35485,35450
39 ,Kochi,40_ 44,1985,Showa,60,57236,27815,29421
39 ,Kochi,45_ 49,1985,Showa,60,52923,25278,27645
39 ,Kochi,50_ 54,1985,Showa,60,59477,28253,31224
39 ,Kochi,55_ 59,1985,Showa,60,59482,27841,31641
39 ,Kochi,60_ 64,1985,Showa,60,49304,21241,28063
39 ,Kochi,65_ 69,1985,Showa,60,38236,15874,22362
39 ,Kochi,70_ 74,1985,Showa,60,32596,13107,19489
39 ,Kochi,75_ 79,1985,Showa,60,24053,9640,14413
39 ,Kochi,80_ 84,1985,Showa,60,16092,6075,10017
39 ,Kochi,over_85,1985,Showa,60,10782,3566,7216
39 ,Kochi,total,1990,Heisei,2,825034,389063,435971
39 ,Kochi,0_ 4,1990,Heisei,2,40057,20311,19746
39 ,Kochi,5_ 9,1990,Heisei,2,48829,24880,23949
39 ,Kochi,10_ 14,1990,Heisei,2,55390,28521,26869
39 ,Kochi,15_ 19,1990,Heisei,2,57216,29193,28023
39 ,Kochi,20_ 24,1990,Heisei,2,38180,17433,20747
39 ,Kochi,25_ 29,1990,Heisei,2,43373,20675,22698
39 ,Kochi,30_ 34,1990,Heisei,2,47721,23306,24415
39 ,Kochi,35_ 39,1990,Heisei,2,57189,28152,29037
39 ,Kochi,40_ 44,1990,Heisei,2,69550,34720,34830
39 ,Kochi,45_ 49,1990,Heisei,2,55782,26976,28806
39 ,Kochi,50_ 54,1990,Heisei,2,51577,24282,27295
39 ,Kochi,55_ 59,1990,Heisei,2,57809,27085,30724
39 ,Kochi,60_ 64,1990,Heisei,2,57598,26572,31026
39 ,Kochi,65_ 69,1990,Heisei,2,46804,19709,27095
39 ,Kochi,70_ 74,1990,Heisei,2,34961,13932,21029
39 ,Kochi,75_ 79,1990,Heisei,2,27835,10459,17376
39 ,Kochi,80_ 84,1990,Heisei,2,17940,6531,11409
39 ,Kochi,over_85,1990,Heisei,2,13968,4443,9525
39 ,Kochi,total,1995,Heisei,7,816704,384446,432258
39 ,Kochi,0_ 4,1995,Heisei,7,35934,18494,17440
39 ,Kochi,5_ 9,1995,Heisei,7,40849,20653,20196
39 ,Kochi,10_ 14,1995,Heisei,7,49050,24945,24105
39 ,Kochi,15_ 19,1995,Heisei,7,51159,26270,24889
39 ,Kochi,20_ 24,1995,Heisei,7,47147,22842,24305
39 ,Kochi,25_ 29,1995,Heisei,7,41751,19796,21955
39 ,Kochi,30_ 34,1995,Heisei,7,44723,21693,23030
39 ,Kochi,35_ 39,1995,Heisei,7,48430,23816,24614
39 ,Kochi,40_ 44,1995,Heisei,7,57267,28390,28877
39 ,Kochi,45_ 49,1995,Heisei,7,69178,34550,34628
39 ,Kochi,50_ 54,1995,Heisei,7,55202,26578,28624
39 ,Kochi,55_ 59,1995,Heisei,7,50799,23696,27103
39 ,Kochi,60_ 64,1995,Heisei,7,56552,26128,30424
39 ,Kochi,65_ 69,1995,Heisei,7,55203,24901,30302
39 ,Kochi,70_ 74,1995,Heisei,7,43365,17550,25815
39 ,Kochi,75_ 79,1995,Heisei,7,30425,11363,19062
39 ,Kochi,80_ 84,1995,Heisei,7,21622,7220,14402
39 ,Kochi,over_85,1995,Heisei,7,17352,5146,12206
39 ,Kochi,total,2000,Heisei,12,813949,383859,430090
39 ,Kochi,0_ 4,2000,Heisei,12,33910,17362,16548
39 ,Kochi,5_ 9,2000,Heisei,12,36623,18787,17836
39 ,Kochi,10_ 14,2000,Heisei,12,41207,20904,20303
39 ,Kochi,15_ 19,2000,Heisei,12,45875,23489,22386
39 ,Kochi,20_ 24,2000,Heisei,12,43265,21676,21589
39 ,Kochi,25_ 29,2000,Heisei,12,50959,25283,25676
39 ,Kochi,30_ 34,2000,Heisei,12,43298,20807,22491
39 ,Kochi,35_ 39,2000,Heisei,12,45336,22070,23266
39 ,Kochi,40_ 44,2000,Heisei,12,48646,24005,24641
39 ,Kochi,45_ 49,2000,Heisei,12,57142,28313,28829
39 ,Kochi,50_ 54,2000,Heisei,12,68799,34225,34574
39 ,Kochi,55_ 59,2000,Heisei,12,55033,26180,28853
39 ,Kochi,60_ 64,2000,Heisei,12,50697,23446,27251
39 ,Kochi,65_ 69,2000,Heisei,12,54778,24835,29943
39 ,Kochi,70_ 74,2000,Heisei,12,51500,22397,29103
39 ,Kochi,75_ 79,2000,Heisei,12,38533,14798,23735
39 ,Kochi,80_ 84,2000,Heisei,12,24456,8366,16090
39 ,Kochi,over_85,2000,Heisei,12,22462,6093,16369
39 ,Kochi,total,2005,Heisei,17,796292,374435,421857
39 ,Kochi,0_ 4,2005,Heisei,17,31346,15921,15425
39 ,Kochi,5_ 9,2005,Heisei,17,34335,17665,16670
39 ,Kochi,10_ 14,2005,Heisei,17,36740,18865,17875
39 ,Kochi,15_ 19,2005,Heisei,17,39072,20001,19071
39 ,Kochi,20_ 24,2005,Heisei,17,37696,18899,18797
39 ,Kochi,25_ 29,2005,Heisei,17,43869,21924,21945
39 ,Kochi,30_ 34,2005,Heisei,17,51268,25289,25979
39 ,Kochi,35_ 39,2005,Heisei,17,43312,20897,22415
39 ,Kochi,40_ 44,2005,Heisei,17,45140,21973,23167
39 ,Kochi,45_ 49,2005,Heisei,17,48117,23707,24410
39 ,Kochi,50_ 54,2005,Heisei,17,56435,27866,28569
39 ,Kochi,55_ 59,2005,Heisei,17,67977,33445,34532
39 ,Kochi,60_ 64,2005,Heisei,17,54481,25705,28776
39 ,Kochi,65_ 69,2005,Heisei,17,48888,22260,26628
39 ,Kochi,70_ 74,2005,Heisei,17,51133,22412,28721
39 ,Kochi,75_ 79,2005,Heisei,17,46074,18899,27175
39 ,Kochi,80_ 84,2005,Heisei,17,31925,11143,20782
39 ,Kochi,over_85,2005,Heisei,17,28355,7495,20860
39 ,Kochi,total,2010,Heisei,22,764456,359134,405322
39 ,Kochi,0_ 4,2010,Heisei,22,27885,14358,13527
39 ,Kochi,5_ 9,2010,Heisei,22,30872,15725,15147
39 ,Kochi,10_ 14,2010,Heisei,22,34041,17522,16519
39 ,Kochi,15_ 19,2010,Heisei,22,35086,18222,16864
39 ,Kochi,20_ 24,2010,Heisei,22,29081,14454,14627
39 ,Kochi,25_ 29,2010,Heisei,22,35268,17481,17787
39 ,Kochi,30_ 34,2010,Heisei,22,42608,21375,21233
39 ,Kochi,35_ 39,2010,Heisei,22,50102,24748,25354
39 ,Kochi,40_ 44,2010,Heisei,22,42375,20462,21913
39 ,Kochi,45_ 49,2010,Heisei,22,44094,21424,22670
39 ,Kochi,50_ 54,2010,Heisei,22,47162,23127,24035
39 ,Kochi,55_ 59,2010,Heisei,22,55087,26911,28176
39 ,Kochi,60_ 64,2010,Heisei,22,66677,32571,34106
39 ,Kochi,65_ 69,2010,Heisei,22,52209,24182,28027
39 ,Kochi,70_ 74,2010,Heisei,22,45583,20154,25429
39 ,Kochi,75_ 79,2010,Heisei,22,45774,18992,26782
39 ,Kochi,80_ 84,2010,Heisei,22,38124,14193,23931
39 ,Kochi,over_85,2010,Heisei,22,36458,9599,26859
39 ,Kochi,total,2015,Heisei,27,728276,342672,385604
39 ,Kochi,0_ 4,2015,Heisei,27,25144,12728,12416
39 ,Kochi,5_ 9,2015,Heisei,27,27922,14338,13584
39 ,Kochi,10_ 14,2015,Heisei,27,30818,15711,15107
39 ,Kochi,15_ 19,2015,Heisei,27,32785,17032,15753
39 ,Kochi,20_ 24,2015,Heisei,27,26702,13770,12932
39 ,Kochi,25_ 29,2015,Heisei,27,28521,14114,14407
39 ,Kochi,30_ 34,2015,Heisei,27,35291,17468,17823
39 ,Kochi,35_ 39,2015,Heisei,27,42328,21241,21087
39 ,Kochi,40_ 44,2015,Heisei,27,49601,24487,25114
39 ,Kochi,45_ 49,2015,Heisei,27,41711,20160,21551
39 ,Kochi,50_ 54,2015,Heisei,27,43494,21125,22369
39 ,Kochi,55_ 59,2015,Heisei,27,46146,22455,23691
39 ,Kochi,60_ 64,2015,Heisei,27,54026,26170,27856
39 ,Kochi,65_ 69,2015,Heisei,27,64157,30996,33161
39 ,Kochi,70_ 74,2015,Heisei,27,48963,22089,26874
39 ,Kochi,75_ 79,2015,Heisei,27,41011,17381,23630
39 ,Kochi,80_ 84,2015,Heisei,27,38401,14805,23596
39 ,Kochi,over_85,2015,Heisei,27,44480,12648,31832
40 ,Fukuoka,total,1920,Taisho,9,2188249,1116818,1071431
40 ,Fukuoka,0_ 4,1920,Taisho,9,279995,140720,139275
40 ,Fukuoka,5_ 9,1920,Taisho,9,258471,130294,128177
40 ,Fukuoka,10_ 14,1920,Taisho,9,234187,118879,115308
40 ,Fukuoka,15_ 19,1920,Taisho,9,220946,115000,105946
40 ,Fukuoka,20_ 24,1920,Taisho,9,209052,109780,99272
40 ,Fukuoka,25_ 29,1920,Taisho,9,171224,90284,80940
40 ,Fukuoka,30_ 34,1920,Taisho,9,145656,76756,68900
40 ,Fukuoka,35_ 39,1920,Taisho,9,135738,70538,65200
40 ,Fukuoka,40_ 44,1920,Taisho,9,125012,64930,60082
40 ,Fukuoka,45_ 49,1920,Taisho,9,104555,53677,50878
40 ,Fukuoka,50_ 54,1920,Taisho,9,84510,43181,41329
40 ,Fukuoka,55_ 59,1920,Taisho,9,68253,34295,33958
40 ,Fukuoka,60_ 64,1920,Taisho,9,55263,26839,28424
40 ,Fukuoka,65_ 69,1920,Taisho,9,41579,19212,22367
40 ,Fukuoka,70_ 74,1920,Taisho,9,29849,13167,16682
40 ,Fukuoka,75_ 79,1920,Taisho,9,15617,6367,9250
40 ,Fukuoka,over_80,1920,Taisho,9,8342,2899,5443
40 ,Fukuoka,total,1925,Taisho,14,2301668,1166165,1135503
40 ,Fukuoka,0_ 4,1925,Taisho,14,319325,160880,158445
40 ,Fukuoka,5_ 9,1925,Taisho,14,256765,129117,127648
40 ,Fukuoka,10_ 14,1925,Taisho,14,253296,128479,124817
40 ,Fukuoka,15_ 19,1925,Taisho,14,230773,117700,113073
40 ,Fukuoka,20_ 24,1925,Taisho,14,203661,104707,98954
40 ,Fukuoka,25_ 29,1925,Taisho,14,187349,97057,90292
40 ,Fukuoka,30_ 34,1925,Taisho,14,154596,81269,73327
40 ,Fukuoka,35_ 39,1925,Taisho,14,133909,70104,63805
40 ,Fukuoka,40_ 44,1925,Taisho,14,123108,63734,59374
40 ,Fukuoka,45_ 49,1925,Taisho,14,114910,58979,55931
40 ,Fukuoka,50_ 54,1925,Taisho,14,93579,47023,46556
40 ,Fukuoka,55_ 59,1925,Taisho,14,73342,36414,36928
40 ,Fukuoka,60_ 64,1925,Taisho,14,57904,27927,29977
40 ,Fukuoka,65_ 69,1925,Taisho,14,42920,19872,23048
40 ,Fukuoka,70_ 74,1925,Taisho,14,29269,12508,16761
40 ,Fukuoka,75_ 79,1925,Taisho,14,17526,7152,10374
40 ,Fukuoka,80_ 84,1925,Taisho,14,7098,2562,4536
40 ,Fukuoka,over_85,1925,Taisho,14,2338,681,1657
40 ,Fukuoka,total,1930,Showa,5,2527119,1280624,1246495
40 ,Fukuoka,0_ 4,1930,Showa,5,352302,177311,174991
40 ,Fukuoka,5_ 9,1930,Showa,5,301700,152187,149513
40 ,Fukuoka,10_ 14,1930,Showa,5,255649,128820,126829
40 ,Fukuoka,15_ 19,1930,Showa,5,256622,130720,125902
40 ,Fukuoka,20_ 24,1930,Showa,5,227143,116786,110357
40 ,Fukuoka,25_ 29,1930,Showa,5,201022,104367,96655
40 ,Fukuoka,30_ 34,1930,Showa,5,182078,95391,86687
40 ,Fukuoka,35_ 39,1930,Showa,5,151191,79988,71203
40 ,Fukuoka,40_ 44,1930,Showa,5,127656,67333,60323
40 ,Fukuoka,45_ 49,1930,Showa,5,115644,59213,56431
40 ,Fukuoka,50_ 54,1930,Showa,5,104855,52877,51978
40 ,Fukuoka,55_ 59,1930,Showa,5,83611,40972,42639
40 ,Fukuoka,60_ 64,1930,Showa,5,63327,29990,33337
40 ,Fukuoka,65_ 69,1930,Showa,5,46041,21117,24924
40 ,Fukuoka,70_ 74,1930,Showa,5,30268,13061,17207
40 ,Fukuoka,75_ 79,1930,Showa,5,17314,6812,10502
40 ,Fukuoka,over_80,1930,Showa,5,10696,3679,7017
40 ,Fukuoka,total,1935,Showa,10,2755804,1392799,1363005
40 ,Fukuoka,0_ 4,1935,Showa,10,376824,190282,186542
40 ,Fukuoka,5_ 9,1935,Showa,10,333596,167971,165625
40 ,Fukuoka,10_ 14,1935,Showa,10,301036,152042,148994
40 ,Fukuoka,15_ 19,1935,Showa,10,263102,133864,129238
40 ,Fukuoka,20_ 24,1935,Showa,10,247968,125952,122016
40 ,Fukuoka,25_ 29,1935,Showa,10,221158,113576,107582
40 ,Fukuoka,30_ 34,1935,Showa,10,193699,101161,92538
40 ,Fukuoka,35_ 39,1935,Showa,10,173657,91197,82460
40 ,Fukuoka,40_ 44,1935,Showa,10,141122,74750,66372
40 ,Fukuoka,45_ 49,1935,Showa,10,118292,61552,56740
40 ,Fukuoka,50_ 54,1935,Showa,10,105797,53243,52554
40 ,Fukuoka,55_ 59,1935,Showa,10,93640,45572,48068
40 ,Fukuoka,60_ 64,1935,Showa,10,72440,33842,38598
40 ,Fukuoka,65_ 69,1935,Showa,10,50796,22717,28079
40 ,Fukuoka,70_ 74,1935,Showa,10,33399,14283,19116
40 ,Fukuoka,75_ 79,1935,Showa,10,18149,7118,11031
40 ,Fukuoka,over_80,1935,Showa,10,11129,3677,7452
40 ,Fukuoka,total,1940,Showa,15,3092573,1575841,1516732
40 ,Fukuoka,0_ 4,1940,Showa,15,391541,198215,193326
40 ,Fukuoka,5_ 9,1940,Showa,15,367170,185549,181621
40 ,Fukuoka,10_ 14,1940,Showa,15,340939,172092,168847
40 ,Fukuoka,15_ 19,1940,Showa,15,335581,177299,158282
40 ,Fukuoka,20_ 24,1940,Showa,15,269863,138670,131193
40 ,Fukuoka,25_ 29,1940,Showa,15,257882,135043,122839
40 ,Fukuoka,30_ 34,1940,Showa,15,222647,116476,106171
40 ,Fukuoka,35_ 39,1940,Showa,15,191722,100818,90904
40 ,Fukuoka,40_ 44,1940,Showa,15,167893,88589,79304
40 ,Fukuoka,45_ 49,1940,Showa,15,134322,70613,63709
40 ,Fukuoka,50_ 54,1940,Showa,15,110004,56218,53786
40 ,Fukuoka,55_ 59,1940,Showa,15,95335,46207,49128
40 ,Fukuoka,60_ 64,1940,Showa,15,81283,37687,43596
40 ,Fukuoka,65_ 69,1940,Showa,15,58499,25671,32828
40 ,Fukuoka,70_ 74,1940,Showa,15,36636,15156,21480
40 ,Fukuoka,75_ 79,1940,Showa,15,19926,7782,12144
40 ,Fukuoka,80_ 84,1940,Showa,15,8137,2872,5265
40 ,Fukuoka,over_85,1940,Showa,15,3184,879,2305
40 ,Fukuoka,total,1945,Showa,20,2746855,1304677,1442178
40 ,Fukuoka,1_ 5,1945,Showa,20,343957,173940,170017
40 ,Fukuoka,6_ 10,1945,Showa,20,322911,163368,159543
40 ,Fukuoka,11_ 15,1945,Showa,20,331264,167367,163897
40 ,Fukuoka,16_ 20,1945,Showa,20,301556,150512,151044
40 ,Fukuoka,21_ 25,1945,Showa,20,216056,84278,131778
40 ,Fukuoka,26_ 30,1945,Showa,20,169544,64716,104828
40 ,Fukuoka,31_ 35,1945,Showa,20,169488,70504,98984
40 ,Fukuoka,36_ 40,1945,Showa,20,167171,76243,90928
40 ,Fukuoka,41_ 45,1945,Showa,20,160961,81297,79664
40 ,Fukuoka,46_ 50,1945,Showa,20,146455,75457,70998
40 ,Fukuoka,51_ 55,1945,Showa,20,116325,60241,56084
40 ,Fukuoka,56_ 60,1945,Showa,20,93965,46925,47040
40 ,Fukuoka,61_ 65,1945,Showa,20,75697,35504,40193
40 ,Fukuoka,66_ 70,1945,Showa,20,60419,26622,33797
40 ,Fukuoka,71_ 75,1945,Showa,20,39658,16232,23426
40 ,Fukuoka,76_ 80,1945,Showa,20,19872,7542,12330
40 ,Fukuoka,81_ 85,1945,Showa,20,8702,3054,5648
40 ,Fukuoka,86以上,1945,Showa,20,2854,875,1979
40 ,Fukuoka,total,1950,Showa,25,3530169,1745606,1784563
40 ,Fukuoka,0_ 4,1950,Showa,25,507801,259612,248189
40 ,Fukuoka,5_ 9,1950,Showa,25,392292,198966,193326
40 ,Fukuoka,10_ 14,1950,Showa,25,350537,177173,173364
40 ,Fukuoka,15_ 19,1950,Showa,25,359500,180993,178507
40 ,Fukuoka,20_ 24,1950,Showa,25,345579,175912,169667
40 ,Fukuoka,25_ 29,1950,Showa,25,281688,131681,150007
40 ,Fukuoka,30_ 34,1950,Showa,25,227255,105558,121697
40 ,Fukuoka,35_ 39,1950,Showa,25,216229,104255,111974
40 ,Fukuoka,40_ 44,1950,Showa,25,190157,94475,95682
40 ,Fukuoka,45_ 49,1950,Showa,25,166535,85028,81507
40 ,Fukuoka,50_ 54,1950,Showa,25,142557,72688,69869
40 ,Fukuoka,55_ 59,1950,Showa,25,111381,55755,55626
40 ,Fukuoka,60_ 64,1950,Showa,25,85528,40664,44864
40 ,Fukuoka,65_ 69,1950,Showa,25,65121,28685,36436
40 ,Fukuoka,70_ 74,1950,Showa,25,47135,19430,27705
40 ,Fukuoka,75_ 79,1950,Showa,25,26520,9955,16565
40 ,Fukuoka,over_80,1950,Showa,25,14236,4714,9522
40 ,Fukuoka,total,1955,Showa,30,3859764,1895365,1964399
40 ,Fukuoka,0_ 4,1955,Showa,30,430793,219838,210955
40 ,Fukuoka,5_ 9,1955,Showa,30,500266,255505,244761
40 ,Fukuoka,10_ 14,1955,Showa,30,394609,199921,194688
40 ,Fukuoka,15_ 19,1955,Showa,30,364394,182519,181875
40 ,Fukuoka,20_ 24,1955,Showa,30,365413,179190,186223
40 ,Fukuoka,25_ 29,1955,Showa,30,339614,168310,171304
40 ,Fukuoka,30_ 34,1955,Showa,30,276254,127438,148816
40 ,Fukuoka,35_ 39,1955,Showa,30,221997,101955,120042
40 ,Fukuoka,40_ 44,1955,Showa,30,210782,100532,110250
40 ,Fukuoka,45_ 49,1955,Showa,30,183900,90300,93600
40 ,Fukuoka,50_ 54,1955,Showa,30,158582,79770,78812
40 ,Fukuoka,55_ 59,1955,Showa,30,133907,66817,67090
40 ,Fukuoka,60_ 64,1955,Showa,30,100787,48980,51807
40 ,Fukuoka,65_ 69,1955,Showa,30,73299,33575,39724
40 ,Fukuoka,70_ 74,1955,Showa,30,51892,21536,30356
40 ,Fukuoka,75_ 79,1955,Showa,30,32985,12530,20455
40 ,Fukuoka,80_ 84,1955,Showa,30,15047,5038,10009
40 ,Fukuoka,over_85,1955,Showa,30,5216,1597,3619
40 ,Fukuoka,total,1960,Showa,35,4006679,1954636,2052043
40 ,Fukuoka,0_ 4,1960,Showa,35,340946,174395,166551
40 ,Fukuoka,5_ 9,1960,Showa,35,422558,215315,207243
40 ,Fukuoka,10_ 14,1960,Showa,35,493851,252095,241756
40 ,Fukuoka,15_ 19,1960,Showa,35,384707,192136,192571
40 ,Fukuoka,20_ 24,1960,Showa,35,344347,164239,180108
40 ,Fukuoka,25_ 29,1960,Showa,35,355407,172440,182967
40 ,Fukuoka,30_ 34,1960,Showa,35,328732,162649,166083
40 ,Fukuoka,35_ 39,1960,Showa,35,267304,122771,144533
40 ,Fukuoka,40_ 44,1960,Showa,35,214103,97701,116402
40 ,Fukuoka,45_ 49,1960,Showa,35,202662,95990,106672
40 ,Fukuoka,50_ 54,1960,Showa,35,174985,84908,90077
40 ,Fukuoka,55_ 59,1960,Showa,35,147796,72684,75112
40 ,Fukuoka,60_ 64,1960,Showa,35,121424,58908,62516
40 ,Fukuoka,65_ 69,1960,Showa,35,86957,40584,46373
40 ,Fukuoka,70_ 74,1960,Showa,35,58439,25377,33062
40 ,Fukuoka,75_ 79,1960,Showa,35,35996,13849,22147
40 ,Fukuoka,80_ 84,1960,Showa,35,18789,6439,12350
40 ,Fukuoka,over_85,1960,Showa,35,7676,2156,5520
40 ,Fukuoka,total,1965,Showa,40,3964611,1911317,2053294
40 ,Fukuoka,0_ 4,1965,Showa,40,314309,160122,154187
40 ,Fukuoka,5_ 9,1965,Showa,40,323228,164452,158776
40 ,Fukuoka,10_ 14,1965,Showa,40,402854,204325,198529
40 ,Fukuoka,15_ 19,1965,Showa,40,445986,222635,223351
40 ,Fukuoka,20_ 24,1965,Showa,40,335115,156178,178937
40 ,Fukuoka,25_ 29,1965,Showa,40,321165,149916,171249
40 ,Fukuoka,30_ 34,1965,Showa,40,333802,161697,172105
40 ,Fukuoka,35_ 39,1965,Showa,40,307547,151319,156228
40 ,Fukuoka,40_ 44,1965,Showa,40,249662,113398,136264
40 ,Fukuoka,45_ 49,1965,Showa,40,200984,90498,110486
40 ,Fukuoka,50_ 54,1965,Showa,40,189248,88490,100758
40 ,Fukuoka,55_ 59,1965,Showa,40,162291,77680,84611
40 ,Fukuoka,60_ 64,1965,Showa,40,133182,64144,69038
40 ,Fukuoka,65_ 69,1965,Showa,40,104367,48960,55407
40 ,Fukuoka,70_ 74,1965,Showa,40,69474,30860,38614
40 ,Fukuoka,75_ 79,1965,Showa,40,41160,16669,24491
40 ,Fukuoka,80_ 84,1965,Showa,40,20205,7035,13170
40 ,Fukuoka,over_85,1965,Showa,40,10032,2939,7093
40 ,Fukuoka,total,1970,Showa,45,4027416,1932033,2095383
40 ,Fukuoka,0_ 4,1970,Showa,45,325251,167160,158091
40 ,Fukuoka,5_ 9,1970,Showa,45,305084,155888,149196
40 ,Fukuoka,10_ 14,1970,Showa,45,313060,159361,153699
40 ,Fukuoka,15_ 19,1970,Showa,45,376613,189236,187377
40 ,Fukuoka,20_ 24,1970,Showa,45,408023,192552,215471
40 ,Fukuoka,25_ 29,1970,Showa,45,325396,152689,172707
40 ,Fukuoka,30_ 34,1970,Showa,45,312427,148490,163937
40 ,Fukuoka,35_ 39,1970,Showa,45,319360,154568,164792
40 ,Fukuoka,40_ 44,1970,Showa,45,291840,142205,149635
40 ,Fukuoka,45_ 49,1970,Showa,45,239278,107321,131957
40 ,Fukuoka,50_ 54,1970,Showa,45,191924,85158,106766
40 ,Fukuoka,55_ 59,1970,Showa,45,177350,81276,96074
40 ,Fukuoka,60_ 64,1970,Showa,45,149294,69513,79781
40 ,Fukuoka,65_ 69,1970,Showa,45,117699,54482,63217
40 ,Fukuoka,70_ 74,1970,Showa,45,86695,38397,48298
40 ,Fukuoka,75_ 79,1970,Showa,45,51234,21052,30182
40 ,Fukuoka,80_ 84,1970,Showa,45,24919,9102,15817
40 ,Fukuoka,over_85,1970,Showa,45,11969,3583,8386
40 ,Fukuoka,total,1975,Showa,50,4292963,2070190,2222773
40 ,Fukuoka,0_ 4,1975,Showa,50,368012,189283,178729
40 ,Fukuoka,5_ 9,1975,Showa,50,329202,169076,160126
40 ,Fukuoka,10_ 14,1975,Showa,50,304870,155770,149100
40 ,Fukuoka,15_ 19,1975,Showa,50,319145,163987,155158
40 ,Fukuoka,20_ 24,1975,Showa,50,366849,179032,187817
40 ,Fukuoka,25_ 29,1975,Showa,50,407861,195751,212110
40 ,Fukuoka,30_ 34,1975,Showa,50,333487,160789,172698
40 ,Fukuoka,35_ 39,1975,Showa,50,312910,149690,163220
40 ,Fukuoka,40_ 44,1975,Showa,50,317339,153587,163752
40 ,Fukuoka,45_ 49,1975,Showa,50,289174,140465,148709
40 ,Fukuoka,50_ 54,1975,Showa,50,232820,103669,129151
40 ,Fukuoka,55_ 59,1975,Showa,50,184529,80595,103934
40 ,Fukuoka,60_ 64,1975,Showa,50,169631,76153,93478
40 ,Fukuoka,65_ 69,1975,Showa,50,136785,61597,75188
40 ,Fukuoka,70_ 74,1975,Showa,50,101534,44497,57037
40 ,Fukuoka,75_ 79,1975,Showa,50,67300,27637,39663
40 ,Fukuoka,80_ 84,1975,Showa,50,33498,12408,21090
40 ,Fukuoka,over_85,1975,Showa,50,15730,4838,10892
40 ,Fukuoka,total,1980,Showa,55,4553461,2200450,2353011
40 ,Fukuoka,0_ 4,1980,Showa,55,340210,174058,166152
40 ,Fukuoka,5_ 9,1980,Showa,55,376543,193736,182807
40 ,Fukuoka,10_ 14,1980,Showa,55,333029,170806,162223
40 ,Fukuoka,15_ 19,1980,Showa,55,319672,164371,155301
40 ,Fukuoka,20_ 24,1980,Showa,55,325454,163346,162108
40 ,Fukuoka,25_ 29,1980,Showa,55,364866,177936,186930
40 ,Fukuoka,30_ 34,1980,Showa,55,417136,204410,212726
40 ,Fukuoka,35_ 39,1980,Showa,55,336874,162739,174135
40 ,Fukuoka,40_ 44,1980,Showa,55,311889,149007,162882
40 ,Fukuoka,45_ 49,1980,Showa,55,312550,150130,162420
40 ,Fukuoka,50_ 54,1980,Showa,55,282543,135669,146874
40 ,Fukuoka,55_ 59,1980,Showa,55,226142,99483,126659
40 ,Fukuoka,60_ 64,1980,Showa,55,175923,75366,100557
40 ,Fukuoka,65_ 69,1980,Showa,55,156593,68223,88370
40 ,Fukuoka,70_ 74,1980,Showa,55,119900,51376,68524
40 ,Fukuoka,75_ 79,1980,Showa,55,81037,33027,48010
40 ,Fukuoka,80_ 84,1980,Showa,55,46222,17057,29165
40 ,Fukuoka,over_85,1980,Showa,55,22743,7109,15634
40 ,Fukuoka,total,1985,Showa,60,4719259,2270496,2448763
40 ,Fukuoka,0_ 4,1985,Showa,60,306991,157203,149788
40 ,Fukuoka,5_ 9,1985,Showa,60,343016,175645,167371
40 ,Fukuoka,10_ 14,1985,Showa,60,378204,194270,183934
40 ,Fukuoka,15_ 19,1985,Showa,60,342883,175801,167082
40 ,Fukuoka,20_ 24,1985,Showa,60,317477,158166,159311
40 ,Fukuoka,25_ 29,1985,Showa,60,308341,149327,159014
40 ,Fukuoka,30_ 34,1985,Showa,60,365801,179764,186037
40 ,Fukuoka,35_ 39,1985,Showa,60,416262,203805,212457
40 ,Fukuoka,40_ 44,1985,Showa,60,334287,161004,173283
40 ,Fukuoka,45_ 49,1985,Showa,60,307450,145615,161835
40 ,Fukuoka,50_ 54,1985,Showa,60,306046,145315,160731
40 ,Fukuoka,55_ 59,1985,Showa,60,274396,129900,144496
40 ,Fukuoka,60_ 64,1985,Showa,60,217327,93959,123368
40 ,Fukuoka,65_ 69,1985,Showa,60,164710,68617,96093
40 ,Fukuoka,70_ 74,1985,Showa,60,140900,58800,82100
40 ,Fukuoka,75_ 79,1985,Showa,60,99663,39772,59891
40 ,Fukuoka,80_ 84,1985,Showa,60,58836,21729,37107
40 ,Fukuoka,over_85,1985,Showa,60,35119,10865,24254
40 ,Fukuoka,total,1990,Heisei,2,4811050,2303487,2507563
40 ,Fukuoka,0_ 4,1990,Heisei,2,259541,132985,126556
40 ,Fukuoka,5_ 9,1990,Heisei,2,307521,157339,150182
40 ,Fukuoka,10_ 14,1990,Heisei,2,343294,175535,167759
40 ,Fukuoka,15_ 19,1990,Heisei,2,392219,202537,189682
40 ,Fukuoka,20_ 24,1990,Heisei,2,336563,167932,168631
40 ,Fukuoka,25_ 29,1990,Heisei,2,290436,137096,153340
40 ,Fukuoka,30_ 34,1990,Heisei,2,304072,147853,156219
40 ,Fukuoka,35_ 39,1990,Heisei,2,362615,177590,185025
40 ,Fukuoka,40_ 44,1990,Heisei,2,412111,201040,211071
40 ,Fukuoka,45_ 49,1990,Heisei,2,327875,156791,171084
40 ,Fukuoka,50_ 54,1990,Heisei,2,300698,141058,159640
40 ,Fukuoka,55_ 59,1990,Heisei,2,297039,138857,158182
40 ,Fukuoka,60_ 64,1990,Heisei,2,264250,122917,141333
40 ,Fukuoka,65_ 69,1990,Heisei,2,205099,86518,118581
40 ,Fukuoka,70_ 74,1990,Heisei,2,149707,59781,89926
40 ,Fukuoka,75_ 79,1990,Heisei,2,119741,46531,73210
40 ,Fukuoka,80_ 84,1990,Heisei,2,74549,26589,47960
40 ,Fukuoka,over_85,1990,Heisei,2,48773,14813,33960
40 ,Fukuoka,total,1995,Heisei,7,4933393,2357525,2575868
40 ,Fukuoka,0_ 4,1995,Heisei,7,237450,121318,116132
40 ,Fukuoka,5_ 9,1995,Heisei,7,265779,136136,129643
40 ,Fukuoka,10_ 14,1995,Heisei,7,311941,159415,152526
40 ,Fukuoka,15_ 19,1995,Heisei,7,363368,186825,176543
40 ,Fukuoka,20_ 24,1995,Heisei,7,398553,202867,195686
40 ,Fukuoka,25_ 29,1995,Heisei,7,317982,151423,166559
40 ,Fukuoka,30_ 34,1995,Heisei,7,297622,143225,154397
40 ,Fukuoka,35_ 39,1995,Heisei,7,309482,150964,158518
40 ,Fukuoka,40_ 44,1995,Heisei,7,367238,180116,187122
40 ,Fukuoka,45_ 49,1995,Heisei,7,414484,202534,211950
40 ,Fukuoka,50_ 54,1995,Heisei,7,326939,156301,170638
40 ,Fukuoka,55_ 59,1995,Heisei,7,297683,138820,158863
40 ,Fukuoka,60_ 64,1995,Heisei,7,289119,133421,155698
40 ,Fukuoka,65_ 69,1995,Heisei,7,250752,113717,137035
40 ,Fukuoka,70_ 74,1995,Heisei,7,188540,76228,112312
40 ,Fukuoka,75_ 79,1995,Heisei,7,129328,48176,81152
40 ,Fukuoka,80_ 84,1995,Heisei,7,92495,32130,60365
40 ,Fukuoka,over_85,1995,Heisei,7,67459,19183,48276
40 ,Fukuoka,total,2000,Heisei,12,5015699,2388824,2626875
40 ,Fukuoka,0_ 4,2000,Heisei,12,233014,119196,113818
40 ,Fukuoka,5_ 9,2000,Heisei,12,241704,123648,118056
40 ,Fukuoka,10_ 14,2000,Heisei,12,268022,137127,130895
40 ,Fukuoka,15_ 19,2000,Heisei,12,328684,168237,160447
40 ,Fukuoka,20_ 24,2000,Heisei,12,368342,187096,181246
40 ,Fukuoka,25_ 29,2000,Heisei,12,374285,182659,191626
40 ,Fukuoka,30_ 34,2000,Heisei,12,321311,154561,166750
40 ,Fukuoka,35_ 39,2000,Heisei,12,300133,144397,155736
40 ,Fukuoka,40_ 44,2000,Heisei,12,310649,151149,159500
40 ,Fukuoka,45_ 49,2000,Heisei,12,365736,178827,186909
40 ,Fukuoka,50_ 54,2000,Heisei,12,409892,198849,211043
40 ,Fukuoka,55_ 59,2000,Heisei,12,322216,152774,169442
40 ,Fukuoka,60_ 64,2000,Heisei,12,291832,134644,157188
40 ,Fukuoka,65_ 69,2000,Heisei,12,275146,123872,151274
40 ,Fukuoka,70_ 74,2000,Heisei,12,230932,100770,130162
40 ,Fukuoka,75_ 79,2000,Heisei,12,167023,63869,103154
40 ,Fukuoka,80_ 84,2000,Heisei,12,103732,35164,68568
40 ,Fukuoka,over_85,2000,Heisei,12,93457,25692,67765
40 ,Fukuoka,total,2005,Heisei,17,5049908,2394094,2655814
40 ,Fukuoka,0_ 4,2005,Heisei,17,223175,114326,108849
40 ,Fukuoka,5_ 9,2005,Heisei,17,235557,120496,115061
40 ,Fukuoka,10_ 14,2005,Heisei,17,242463,123803,118660
40 ,Fukuoka,15_ 19,2005,Heisei,17,284218,145375,138843
40 ,Fukuoka,20_ 24,2005,Heisei,17,329047,165977,163070
40 ,Fukuoka,25_ 29,2005,Heisei,17,335361,162982,172379
40 ,Fukuoka,30_ 34,2005,Heisei,17,368858,180072,188786
40 ,Fukuoka,35_ 39,2005,Heisei,17,319615,153701,165914
40 ,Fukuoka,40_ 44,2005,Heisei,17,299631,143823,155808
40 ,Fukuoka,45_ 49,2005,Heisei,17,308589,149157,159432
40 ,Fukuoka,50_ 54,2005,Heisei,17,361348,175530,185818
40 ,Fukuoka,55_ 59,2005,Heisei,17,403526,194285,209241
40 ,Fukuoka,60_ 64,2005,Heisei,17,316417,148633,167784
40 ,Fukuoka,65_ 69,2005,Heisei,17,280061,126994,153067
40 ,Fukuoka,70_ 74,2005,Heisei,17,255797,110998,144799
40 ,Fukuoka,75_ 79,2005,Heisei,17,205102,84227,120875
40 ,Fukuoka,80_ 84,2005,Heisei,17,137163,47598,89565
40 ,Fukuoka,over_85,2005,Heisei,17,119675,31085,88590
40 ,Fukuoka,total,2010,Heisei,22,5071968,2393965,2678003
40 ,Fukuoka,0_ 4,2010,Heisei,22,222872,113985,108887
40 ,Fukuoka,5_ 9,2010,Heisei,22,224952,115156,109796
40 ,Fukuoka,10_ 14,2010,Heisei,22,236300,120726,115574
40 ,Fukuoka,15_ 19,2010,Heisei,22,256926,130715,126211
40 ,Fukuoka,20_ 24,2010,Heisei,22,275804,137098,138706
40 ,Fukuoka,25_ 29,2010,Heisei,22,300539,144669,155870
40 ,Fukuoka,30_ 34,2010,Heisei,22,333763,162410,171353
40 ,Fukuoka,35_ 39,2010,Heisei,22,370486,181228,189258
40 ,Fukuoka,40_ 44,2010,Heisei,22,322202,155111,167091
40 ,Fukuoka,45_ 49,2010,Heisei,22,300431,143909,156522
40 ,Fukuoka,50_ 54,2010,Heisei,22,307883,148511,159372
40 ,Fukuoka,55_ 59,2010,Heisei,22,359382,173417,185965
40 ,Fukuoka,60_ 64,2010,Heisei,22,400516,191748,208768
40 ,Fukuoka,65_ 69,2010,Heisei,22,307005,141785,165220
40 ,Fukuoka,70_ 74,2010,Heisei,22,263466,115680,147786
40 ,Fukuoka,75_ 79,2010,Heisei,22,229477,93940,135537
40 ,Fukuoka,80_ 84,2010,Heisei,22,169701,63198,106503
40 ,Fukuoka,over_85,2010,Heisei,22,153727,40091,113636
40 ,Fukuoka,total,2015,Heisei,27,5101556,2410418,2691138
40 ,Fukuoka,0_ 4,2015,Heisei,27,220594,112983,107611
40 ,Fukuoka,5_ 9,2015,Heisei,27,227380,116318,111062
40 ,Fukuoka,10_ 14,2015,Heisei,27,228071,116644,111427
40 ,Fukuoka,15_ 19,2015,Heisei,27,251462,128231,123231
40 ,Fukuoka,20_ 24,2015,Heisei,27,252385,125322,127063
40 ,Fukuoka,25_ 29,2015,Heisei,27,259473,125008,134465
40 ,Fukuoka,30_ 34,2015,Heisei,27,302406,146688,155718
40 ,Fukuoka,35_ 39,2015,Heisei,27,337412,164811,172601
40 ,Fukuoka,40_ 44,2015,Heisei,27,373331,183083,190248
40 ,Fukuoka,45_ 49,2015,Heisei,27,322189,155198,166991
40 ,Fukuoka,50_ 54,2015,Heisei,27,299320,143231,156089
40 ,Fukuoka,55_ 59,2015,Heisei,27,305195,146876,158319
40 ,Fukuoka,60_ 64,2015,Heisei,27,354682,170425,184257
40 ,Fukuoka,65_ 69,2015,Heisei,27,387794,183091,204703
40 ,Fukuoka,70_ 74,2015,Heisei,27,289265,129862,159403
40 ,Fukuoka,75_ 79,2015,Heisei,27,239132,100214,138918
40 ,Fukuoka,80_ 84,2015,Heisei,27,192713,72511,120202
40 ,Fukuoka,over_85,2015,Heisei,27,195860,54684,141176
41 ,Saga,total,1920,Taisho,9,673895,329962,343933
41 ,Saga,0_ 4,1920,Taisho,9,90053,45035,45018
41 ,Saga,5_ 9,1920,Taisho,9,83941,41981,41960
41 ,Saga,10_ 14,1920,Taisho,9,77633,39166,38467
41 ,Saga,15_ 19,1920,Taisho,9,65606,31675,33931
41 ,Saga,20_ 24,1920,Taisho,9,53380,25183,28197
41 ,Saga,25_ 29,1920,Taisho,9,44671,21947,22724
41 ,Saga,30_ 34,1920,Taisho,9,39807,19538,20269
41 ,Saga,35_ 39,1920,Taisho,9,39801,19343,20458
41 ,Saga,40_ 44,1920,Taisho,9,37724,18621,19103
41 ,Saga,45_ 49,1920,Taisho,9,32597,16054,16543
41 ,Saga,50_ 54,1920,Taisho,9,28715,14134,14581
41 ,Saga,55_ 59,1920,Taisho,9,23766,11673,12093
41 ,Saga,60_ 64,1920,Taisho,9,19997,9579,10418
41 ,Saga,65_ 69,1920,Taisho,9,15657,7405,8252
41 ,Saga,70_ 74,1920,Taisho,9,11579,5072,6507
41 ,Saga,75_ 79,1920,Taisho,9,5963,2460,3503
41 ,Saga,over_80,1920,Taisho,9,3005,1096,1909
41 ,Saga,total,1925,Taisho,14,684831,336223,348608
41 ,Saga,0_ 4,1925,Taisho,14,96155,48151,48004
41 ,Saga,5_ 9,1925,Taisho,14,82013,41169,40844
41 ,Saga,10_ 14,1925,Taisho,14,80060,39993,40067
41 ,Saga,15_ 19,1925,Taisho,14,66813,33108,33705
41 ,Saga,20_ 24,1925,Taisho,14,52687,25295,27392
41 ,Saga,25_ 29,1925,Taisho,14,47539,23468,24071
41 ,Saga,30_ 34,1925,Taisho,14,40577,20184,20393
41 ,Saga,35_ 39,1925,Taisho,14,37313,18285,19028
41 ,Saga,40_ 44,1925,Taisho,14,36860,18051,18809
41 ,Saga,45_ 49,1925,Taisho,14,34957,17123,17834
41 ,Saga,50_ 54,1925,Taisho,14,29258,14255,15003
41 ,Saga,55_ 59,1925,Taisho,14,25014,12151,12863
41 ,Saga,60_ 64,1925,Taisho,14,19895,9557,10338
41 ,Saga,65_ 69,1925,Taisho,14,15197,7017,8180
41 ,Saga,70_ 74,1925,Taisho,14,10571,4651,5920
41 ,Saga,75_ 79,1925,Taisho,14,6548,2584,3964
41 ,Saga,80_ 84,1925,Taisho,14,2585,945,1640
41 ,Saga,over_85,1925,Taisho,14,789,236,553
41 ,Saga,total,1930,Showa,5,691565,337996,353569
41 ,Saga,0_ 4,1930,Showa,5,97096,48686,48410
41 ,Saga,5_ 9,1930,Showa,5,86674,43398,43276
41 ,Saga,10_ 14,1930,Showa,5,77448,38656,38792
41 ,Saga,15_ 19,1930,Showa,5,67826,32922,34904
41 ,Saga,20_ 24,1930,Showa,5,52847,25119,27728
41 ,Saga,25_ 29,1930,Showa,5,47201,23313,23888
41 ,Saga,30_ 34,1930,Showa,5,43344,21492,21852
41 ,Saga,35_ 39,1930,Showa,5,37604,18655,18949
41 ,Saga,40_ 44,1930,Showa,5,34398,16809,17589
41 ,Saga,45_ 49,1930,Showa,5,33840,16318,17522
41 ,Saga,50_ 54,1930,Showa,5,31335,15187,16148
41 ,Saga,55_ 59,1930,Showa,5,25675,12247,13428
41 ,Saga,60_ 64,1930,Showa,5,20929,9951,10978
41 ,Saga,65_ 69,1930,Showa,5,15346,7159,8187
41 ,Saga,70_ 74,1930,Showa,5,10245,4401,5844
41 ,Saga,75_ 79,1930,Showa,5,6006,2449,3557
41 ,Saga,over_80,1930,Showa,5,3751,1234,2517
41 ,Saga,total,1935,Showa,10,686117,332764,353353
41 ,Saga,0_ 4,1935,Showa,10,93329,46943,46386
41 ,Saga,5_ 9,1935,Showa,10,88785,44478,44307
41 ,Saga,10_ 14,1935,Showa,10,82854,41224,41630
41 ,Saga,15_ 19,1935,Showa,10,62372,29791,32581
41 ,Saga,20_ 24,1935,Showa,10,49352,22315,27037
41 ,Saga,25_ 29,1935,Showa,10,45554,22250,23304
41 ,Saga,30_ 34,1935,Showa,10,42144,20559,21585
41 ,Saga,35_ 39,1935,Showa,10,39957,19679,20278
41 ,Saga,40_ 44,1935,Showa,10,34417,16950,17467
41 ,Saga,45_ 49,1935,Showa,10,31484,15329,16155
41 ,Saga,50_ 54,1935,Showa,10,30576,14707,15869
41 ,Saga,55_ 59,1935,Showa,10,27470,13080,14390
41 ,Saga,60_ 64,1935,Showa,10,21448,9908,11540
41 ,Saga,65_ 69,1935,Showa,10,16224,7362,8862
41 ,Saga,70_ 74,1935,Showa,10,10575,4627,5948
41 ,Saga,75_ 79,1935,Showa,10,5878,2283,3595
41 ,Saga,over_80,1935,Showa,10,3698,1279,2419
41 ,Saga,total,1940,Showa,15,701188,342810,358378
41 ,Saga,0_ 4,1940,Showa,15,88333,44877,43456
41 ,Saga,5_ 9,1940,Showa,15,88518,44433,44085
41 ,Saga,10_ 14,1940,Showa,15,86423,42855,43568
41 ,Saga,15_ 19,1940,Showa,15,67399,31486,35913
41 ,Saga,20_ 24,1940,Showa,15,52839,26934,25905
41 ,Saga,25_ 29,1940,Showa,15,45690,22704,22986
41 ,Saga,30_ 34,1940,Showa,15,42952,21108,21844
41 ,Saga,35_ 39,1940,Showa,15,41102,20214,20888
41 ,Saga,40_ 44,1940,Showa,15,38198,18957,19241
41 ,Saga,45_ 49,1940,Showa,15,32363,16003,16360
41 ,Saga,50_ 54,1940,Showa,15,28842,13830,15012
41 ,Saga,55_ 59,1940,Showa,15,27123,12770,14353
41 ,Saga,60_ 64,1940,Showa,15,23501,10761,12740
41 ,Saga,65_ 69,1940,Showa,15,17032,7510,9522
41 ,Saga,70_ 74,1940,Showa,15,11358,4791,6567
41 ,Saga,75_ 79,1940,Showa,15,6061,2451,3610
41 ,Saga,80_ 84,1940,Showa,15,2494,852,1642
41 ,Saga,over_85,1940,Showa,15,960,274,686
41 ,Saga,total,1945,Showa,20,830431,379361,451070
41 ,Saga,1_ 5,1945,Showa,20,107980,54249,53731
41 ,Saga,6_ 10,1945,Showa,20,104942,53117,51825
41 ,Saga,11_ 15,1945,Showa,20,104212,52298,51914
41 ,Saga,16_ 20,1945,Showa,20,89233,42944,46289
41 ,Saga,21_ 25,1945,Showa,20,61523,21689,39834
41 ,Saga,26_ 30,1945,Showa,20,46330,15121,31209
41 ,Saga,31_ 35,1945,Showa,20,46404,16904,29500
41 ,Saga,36_ 40,1945,Showa,20,45897,19129,26768
41 ,Saga,41_ 45,1945,Showa,20,45599,21838,23761
41 ,Saga,46_ 50,1945,Showa,20,41569,20346,21223
41 ,Saga,51_ 55,1945,Showa,20,34484,16801,17683
41 ,Saga,56_ 60,1945,Showa,20,29933,14093,15840
41 ,Saga,61_ 65,1945,Showa,20,26126,11759,14367
41 ,Saga,66_ 70,1945,Showa,20,21290,9299,11991
41 ,Saga,71_ 75,1945,Showa,20,13747,5595,8152
41 ,Saga,76_ 80,1945,Showa,20,7190,2761,4429
41 ,Saga,81_ 85,1945,Showa,20,3040,1115,1925
41 ,Saga,86以上,1945,Showa,20,932,303,629
41 ,Saga,total,1950,Showa,25,945082,455824,489258
41 ,Saga,0_ 4,1950,Showa,25,131661,66912,64749
41 ,Saga,5_ 9,1950,Showa,25,108180,54301,53879
41 ,Saga,10_ 14,1950,Showa,25,103940,52672,51268
41 ,Saga,15_ 19,1950,Showa,25,99470,49371,50099
41 ,Saga,20_ 24,1950,Showa,25,83195,39479,43716
41 ,Saga,25_ 29,1950,Showa,25,65969,29671,36298
41 ,Saga,30_ 34,1950,Showa,25,54375,24175,30200
41 ,Saga,35_ 39,1950,Showa,25,53882,24319,29563
41 ,Saga,40_ 44,1950,Showa,25,50396,24184,26212
41 ,Saga,45_ 49,1950,Showa,25,45833,22617,23216
41 ,Saga,50_ 54,1950,Showa,25,40303,19954,20349
41 ,Saga,55_ 59,1950,Showa,25,32376,15783,16593
41 ,Saga,60_ 64,1950,Showa,25,26541,12352,14189
41 ,Saga,65_ 69,1950,Showa,25,21312,9333,11979
41 ,Saga,70_ 74,1950,Showa,25,15049,6188,8861
41 ,Saga,75_ 79,1950,Showa,25,8152,3024,5128
41 ,Saga,over_80,1950,Showa,25,4444,1488,2956
41 ,Saga,total,1955,Showa,30,973749,470437,503312
41 ,Saga,0_ 4,1955,Showa,30,117700,60396,57304
41 ,Saga,5_ 9,1955,Showa,30,125427,63791,61636
41 ,Saga,10_ 14,1955,Showa,30,104827,52641,52186
41 ,Saga,15_ 19,1955,Showa,30,93028,45862,47166
41 ,Saga,20_ 24,1955,Showa,30,83202,39495,43707
41 ,Saga,25_ 29,1955,Showa,30,75903,36811,39092
41 ,Saga,30_ 34,1955,Showa,30,62247,28139,34108
41 ,Saga,35_ 39,1955,Showa,30,51349,22870,28479
41 ,Saga,40_ 44,1955,Showa,30,50863,22882,27981
41 ,Saga,45_ 49,1955,Showa,30,47270,22578,24692
41 ,Saga,50_ 54,1955,Showa,30,42621,20952,21669
41 ,Saga,55_ 59,1955,Showa,30,36838,17968,18870
41 ,Saga,60_ 64,1955,Showa,30,28544,13651,14893
41 ,Saga,65_ 69,1955,Showa,30,22117,9990,12127
41 ,Saga,70_ 74,1955,Showa,30,16188,6742,9446
41 ,Saga,75_ 79,1955,Showa,30,9969,3802,6167
41 ,Saga,80_ 84,1955,Showa,30,4205,1407,2798
41 ,Saga,over_85,1955,Showa,30,1450,460,990
41 ,Saga,total,1960,Showa,35,942874,448797,494077
41 ,Saga,0_ 4,1960,Showa,35,89649,45684,43965
41 ,Saga,5_ 9,1960,Showa,35,113429,58106,55323
41 ,Saga,10_ 14,1960,Showa,35,121712,61858,59854
41 ,Saga,15_ 19,1960,Showa,35,80135,37673,42462
41 ,Saga,20_ 24,1960,Showa,35,66705,28641,38064
41 ,Saga,25_ 29,1960,Showa,35,70652,33081,37571
41 ,Saga,30_ 34,1960,Showa,35,69998,33960,36038
41 ,Saga,35_ 39,1960,Showa,35,58504,26360,32144
41 ,Saga,40_ 44,1960,Showa,35,48499,21381,27118
41 ,Saga,45_ 49,1960,Showa,35,47635,21250,26385
41 ,Saga,50_ 54,1960,Showa,35,44021,20776,23245
41 ,Saga,55_ 59,1960,Showa,35,39083,18964,20119
41 ,Saga,60_ 64,1960,Showa,35,32998,15767,17231
41 ,Saga,65_ 69,1960,Showa,35,24189,11233,12956
41 ,Saga,70_ 74,1960,Showa,35,17275,7428,9847
41 ,Saga,75_ 79,1960,Showa,35,10993,4194,6799
41 ,Saga,80_ 84,1960,Showa,35,5427,1884,3543
41 ,Saga,over_85,1960,Showa,35,1970,557,1413
41 ,Saga,total,1965,Showa,40,871885,410937,460948
41 ,Saga,0_ 4,1965,Showa,40,70949,36021,34928
41 ,Saga,5_ 9,1965,Showa,40,83187,42246,40941
41 ,Saga,10_ 14,1965,Showa,40,106012,53871,52141
41 ,Saga,15_ 19,1965,Showa,40,91123,44518,46605
41 ,Saga,20_ 24,1965,Showa,40,54201,21687,32514
41 ,Saga,25_ 29,1965,Showa,40,55173,24701,30472
41 ,Saga,30_ 34,1965,Showa,40,62989,29962,33027
41 ,Saga,35_ 39,1965,Showa,40,63769,30875,32894
41 ,Saga,40_ 44,1965,Showa,40,53744,23935,29809
41 ,Saga,45_ 49,1965,Showa,40,44794,19542,25252
41 ,Saga,50_ 54,1965,Showa,40,43566,19241,24325
41 ,Saga,55_ 59,1965,Showa,40,39643,18512,21131
41 ,Saga,60_ 64,1965,Showa,40,34566,16510,18056
41 ,Saga,65_ 69,1965,Showa,40,27985,13033,14952
41 ,Saga,70_ 74,1965,Showa,40,19357,8587,10770
41 ,Saga,75_ 79,1965,Showa,40,11961,4803,7158
41 ,Saga,80_ 84,1965,Showa,40,6094,2054,4040
41 ,Saga,over_85,1965,Showa,40,2772,839,1933
41 ,Saga,total,1970,Showa,45,838468,393631,444837
41 ,Saga,0_ 4,1970,Showa,45,64507,33006,31501
41 ,Saga,5_ 9,1970,Showa,45,69619,35461,34158
41 ,Saga,10_ 14,1970,Showa,45,80546,40868,39678
41 ,Saga,15_ 19,1970,Showa,45,82249,40180,42069
41 ,Saga,20_ 24,1970,Showa,45,66875,28720,38155
41 ,Saga,25_ 29,1970,Showa,45,51684,23264,28420
41 ,Saga,30_ 34,1970,Showa,45,54025,25347,28678
41 ,Saga,35_ 39,1970,Showa,45,60812,29115,31697
41 ,Saga,40_ 44,1970,Showa,45,60304,29047,31257
41 ,Saga,45_ 49,1970,Showa,45,51009,22579,28430
41 ,Saga,50_ 54,1970,Showa,45,42391,18281,24110
41 ,Saga,55_ 59,1970,Showa,45,40455,17668,22787
41 ,Saga,60_ 64,1970,Showa,45,36267,16614,19653
41 ,Saga,65_ 69,1970,Showa,45,30215,13931,16284
41 ,Saga,70_ 74,1970,Showa,45,22890,10172,12718
41 ,Saga,75_ 79,1970,Showa,45,14113,5783,8330
41 ,Saga,80_ 84,1970,Showa,45,7197,2620,4577
41 ,Saga,over_85,1970,Showa,45,3310,975,2335
41 ,Saga,total,1975,Showa,50,837674,394661,443013
41 ,Saga,0_ 4,1975,Showa,50,67438,34601,32837
41 ,Saga,5_ 9,1975,Showa,50,65297,33445,31852
41 ,Saga,10_ 14,1975,Showa,50,69387,35400,33987
41 ,Saga,15_ 19,1975,Showa,50,66461,32472,33989
41 ,Saga,20_ 24,1975,Showa,50,60375,26664,33711
41 ,Saga,25_ 29,1975,Showa,50,64750,31038,33712
41 ,Saga,30_ 34,1975,Showa,50,52208,24615,27593
41 ,Saga,35_ 39,1975,Showa,50,54043,25605,28438
41 ,Saga,40_ 44,1975,Showa,50,60199,28836,31363
41 ,Saga,45_ 49,1975,Showa,50,59333,28474,30859
41 ,Saga,50_ 54,1975,Showa,50,49277,21678,27599
41 ,Saga,55_ 59,1975,Showa,50,40404,17356,23048
41 ,Saga,60_ 64,1975,Showa,50,38404,16431,21973
41 ,Saga,65_ 69,1975,Showa,50,33111,14725,18386
41 ,Saga,70_ 74,1975,Showa,50,25946,11350,14596
41 ,Saga,75_ 79,1975,Showa,50,17566,7199,10367
41 ,Saga,80_ 84,1975,Showa,50,9054,3363,5691
41 ,Saga,over_85,1975,Showa,50,4349,1372,2977
41 ,Saga,total,1980,Showa,55,865574,410912,454662
41 ,Saga,0_ 4,1980,Showa,55,64541,33192,31349
41 ,Saga,5_ 9,1980,Showa,55,69820,35781,34039
41 ,Saga,10_ 14,1980,Showa,55,66259,33887,32372
41 ,Saga,15_ 19,1980,Showa,55,62134,30767,31367
41 ,Saga,20_ 24,1980,Showa,55,54520,24862,29658
41 ,Saga,25_ 29,1980,Showa,55,65098,31665,33433
41 ,Saga,30_ 34,1980,Showa,55,67295,33676,33619
41 ,Saga,35_ 39,1980,Showa,55,53813,25552,28261
41 ,Saga,40_ 44,1980,Showa,55,54477,25900,28577
41 ,Saga,45_ 49,1980,Showa,55,59669,28433,31236
41 ,Saga,50_ 54,1980,Showa,55,58645,28041,30604
41 ,Saga,55_ 59,1980,Showa,55,48276,21088,27188
41 ,Saga,60_ 64,1980,Showa,55,38602,16394,22208
41 ,Saga,65_ 69,1980,Showa,55,35454,14803,20651
41 ,Saga,70_ 74,1980,Showa,55,28954,12334,16620
41 ,Saga,75_ 79,1980,Showa,55,20382,8321,12061
41 ,Saga,80_ 84,1980,Showa,55,11659,4326,7333
41 ,Saga,over_85,1980,Showa,55,5928,1868,4060
41 ,Saga,total,1985,Showa,60,880013,417308,462705
41 ,Saga,0_ 4,1985,Showa,60,59649,30548,29101
41 ,Saga,5_ 9,1985,Showa,60,65870,33881,31989
41 ,Saga,10_ 14,1985,Showa,60,70595,36185,34410
41 ,Saga,15_ 19,1985,Showa,60,59880,29682,30198
41 ,Saga,20_ 24,1985,Showa,60,50628,23208,27420
41 ,Saga,25_ 29,1985,Showa,60,55777,26509,29268
41 ,Saga,30_ 34,1985,Showa,60,65495,32569,32926
41 ,Saga,35_ 39,1985,Showa,60,67952,34060,33892
41 ,Saga,40_ 44,1985,Showa,60,53764,25573,28191
41 ,Saga,45_ 49,1985,Showa,60,53710,25343,28367
41 ,Saga,50_ 54,1985,Showa,60,58606,27736,30870
41 ,Saga,55_ 59,1985,Showa,60,57126,27062,30064
41 ,Saga,60_ 64,1985,Showa,60,46585,20076,26509
41 ,Saga,65_ 69,1985,Showa,60,36106,14981,21125
41 ,Saga,70_ 74,1985,Showa,60,31726,12639,19087
41 ,Saga,75_ 79,1985,Showa,60,23788,9397,14391
41 ,Saga,80_ 84,1985,Showa,60,14317,5238,9079
41 ,Saga,over_85,1985,Showa,60,8416,2606,5810
41 ,Saga,total,1990,Heisei,2,877851,414673,463178
41 ,Saga,0_ 4,1990,Heisei,2,51113,26173,24940
41 ,Saga,5_ 9,1990,Heisei,2,60104,30805,29299
41 ,Saga,10_ 14,1990,Heisei,2,66397,34217,32180
41 ,Saga,15_ 19,1990,Heisei,2,64337,32099,32238
41 ,Saga,20_ 24,1990,Heisei,2,47419,21538,25881
41 ,Saga,25_ 29,1990,Heisei,2,49869,23394,26475
41 ,Saga,30_ 34,1990,Heisei,2,54882,26615,28267
41 ,Saga,35_ 39,1990,Heisei,2,65422,32569,32853
41 ,Saga,40_ 44,1990,Heisei,2,67355,33622,33733
41 ,Saga,45_ 49,1990,Heisei,2,52807,25019,27788
41 ,Saga,50_ 54,1990,Heisei,2,52600,24585,28015
41 ,Saga,55_ 59,1990,Heisei,2,57149,26699,30450
41 ,Saga,60_ 64,1990,Heisei,2,55094,25704,29390
41 ,Saga,65_ 69,1990,Heisei,2,43862,18483,25379
41 ,Saga,70_ 74,1990,Heisei,2,32874,13097,19777
41 ,Saga,75_ 79,1990,Heisei,2,26842,10026,16816
41 ,Saga,80_ 84,1990,Heisei,2,17626,6245,11381
41 ,Saga,over_85,1990,Heisei,2,11768,3566,8202
41 ,Saga,total,1995,Heisei,7,884316,418666,465650
41 ,Saga,0_ 4,1995,Heisei,7,46079,23803,22276
41 ,Saga,5_ 9,1995,Heisei,7,52805,27037,25768
41 ,Saga,10_ 14,1995,Heisei,7,61423,31529,29894
41 ,Saga,15_ 19,1995,Heisei,7,62511,31758,30753
41 ,Saga,20_ 24,1995,Heisei,7,53903,25787,28116
41 ,Saga,25_ 29,1995,Heisei,7,48888,23035,25853
41 ,Saga,30_ 34,1995,Heisei,7,50641,24402,26239
41 ,Saga,35_ 39,1995,Heisei,7,56351,27558,28793
41 ,Saga,40_ 44,1995,Heisei,7,66538,33252,33286
41 ,Saga,45_ 49,1995,Heisei,7,67716,34002,33714
41 ,Saga,50_ 54,1995,Heisei,7,52507,24805,27702
41 ,Saga,55_ 59,1995,Heisei,7,52163,24270,27893
41 ,Saga,60_ 64,1995,Heisei,7,55453,25547,29906
41 ,Saga,65_ 69,1995,Heisei,7,52287,23678,28609
41 ,Saga,70_ 74,1995,Heisei,7,40340,16274,24066
41 ,Saga,75_ 79,1995,Heisei,7,28341,10564,17777
41 ,Saga,80_ 84,1995,Heisei,7,20559,6852,13707
41 ,Saga,over_85,1995,Heisei,7,15802,4505,11297
41 ,Saga,total,2000,Heisei,12,876654,414377,462277
41 ,Saga,0_ 4,2000,Heisei,12,43617,22425,21192
41 ,Saga,5_ 9,2000,Heisei,12,46796,24157,22639
41 ,Saga,10_ 14,2000,Heisei,12,53615,27559,26056
41 ,Saga,15_ 19,2000,Heisei,12,57105,29009,28096
41 ,Saga,20_ 24,2000,Heisei,12,50823,24659,26164
41 ,Saga,25_ 29,2000,Heisei,12,53863,26449,27414
41 ,Saga,30_ 34,2000,Heisei,12,48654,23189,25465
41 ,Saga,35_ 39,2000,Heisei,12,50805,24511,26294
41 ,Saga,40_ 44,2000,Heisei,12,56484,27593,28891
41 ,Saga,45_ 49,2000,Heisei,12,65963,32754,33209
41 ,Saga,50_ 54,2000,Heisei,12,66964,33329,33635
41 ,Saga,55_ 59,2000,Heisei,12,51715,24232,27483
41 ,Saga,60_ 64,2000,Heisei,12,50975,23445,27530
41 ,Saga,65_ 69,2000,Heisei,12,52826,23770,29056
41 ,Saga,70_ 74,2000,Heisei,12,47978,20946,27032
41 ,Saga,75_ 79,2000,Heisei,12,35385,13365,22020
41 ,Saga,80_ 84,2000,Heisei,12,22327,7495,14832
41 ,Saga,over_85,2000,Heisei,12,20616,5402,15214
41 ,Saga,total,2005,Heisei,17,866369,408230,458139
41 ,Saga,0_ 4,2005,Heisei,17,40288,20538,19750
41 ,Saga,5_ 9,2005,Heisei,17,44394,22804,21590
41 ,Saga,10_ 14,2005,Heisei,17,47287,24579,22708
41 ,Saga,15_ 19,2005,Heisei,17,49386,24937,24449
41 ,Saga,20_ 24,2005,Heisei,17,46456,22547,23909
41 ,Saga,25_ 29,2005,Heisei,17,50570,24822,25748
41 ,Saga,30_ 34,2005,Heisei,17,53306,26194,27112
41 ,Saga,35_ 39,2005,Heisei,17,48748,23320,25428
41 ,Saga,40_ 44,2005,Heisei,17,50877,24583,26294
41 ,Saga,45_ 49,2005,Heisei,17,55929,27159,28770
41 ,Saga,50_ 54,2005,Heisei,17,65458,32369,33089
41 ,Saga,55_ 59,2005,Heisei,17,66206,32735,33471
41 ,Saga,60_ 64,2005,Heisei,17,50928,23578,27350
41 ,Saga,65_ 69,2005,Heisei,17,49025,22217,26808
41 ,Saga,70_ 74,2005,Heisei,17,49262,21452,27810
41 ,Saga,75_ 79,2005,Heisei,17,42701,17497,25204
41 ,Saga,80_ 84,2005,Heisei,17,29299,10094,19205
41 ,Saga,over_85,2005,Heisei,17,25821,6559,19262
41 ,Saga,total,2010,Heisei,22,849788,400136,449652
41 ,Saga,0_ 4,2010,Heisei,22,37770,19324,18446
41 ,Saga,5_ 9,2010,Heisei,22,40862,20880,19982
41 ,Saga,10_ 14,2010,Heisei,22,44815,23074,21741
41 ,Saga,15_ 19,2010,Heisei,22,43817,22486,21331
41 ,Saga,20_ 24,2010,Heisei,22,38976,18666,20310
41 ,Saga,25_ 29,2010,Heisei,22,45086,21960,23126
41 ,Saga,30_ 34,2010,Heisei,22,49979,24659,25320
41 ,Saga,35_ 39,2010,Heisei,22,53271,26268,27003
41 ,Saga,40_ 44,2010,Heisei,22,48732,23366,25366
41 ,Saga,45_ 49,2010,Heisei,22,50390,24270,26120
41 ,Saga,50_ 54,2010,Heisei,22,55346,26760,28586
41 ,Saga,55_ 59,2010,Heisei,22,64677,31792,32885
41 ,Saga,60_ 64,2010,Heisei,22,64932,31864,33068
41 ,Saga,65_ 69,2010,Heisei,22,49113,22389,26724
41 ,Saga,70_ 74,2010,Heisei,22,45956,20202,25754
41 ,Saga,75_ 79,2010,Heisei,22,44250,18286,25964
41 ,Saga,80_ 84,2010,Heisei,22,35369,13257,22112
41 ,Saga,over_85,2010,Heisei,22,33408,8790,24618
41 ,Saga,total,2015,Heisei,27,832832,393073,439759
41 ,Saga,0_ 4,2015,Heisei,27,35910,18357,17553
41 ,Saga,5_ 9,2015,Heisei,27,38688,19752,18936
41 ,Saga,10_ 14,2015,Heisei,27,41524,21354,20170
41 ,Saga,15_ 19,2015,Heisei,27,42542,21738,20804
41 ,Saga,20_ 24,2015,Heisei,27,35630,17583,18047
41 ,Saga,25_ 29,2015,Heisei,27,38615,18834,19781
41 ,Saga,30_ 34,2015,Heisei,27,45108,22141,22967
41 ,Saga,35_ 39,2015,Heisei,27,50328,24925,25403
41 ,Saga,40_ 44,2015,Heisei,27,53459,26368,27091
41 ,Saga,45_ 49,2015,Heisei,27,48707,23450,25257
41 ,Saga,50_ 54,2015,Heisei,27,50073,24195,25878
41 ,Saga,55_ 59,2015,Heisei,27,54852,26480,28372
41 ,Saga,60_ 64,2015,Heisei,27,63705,31131,32574
41 ,Saga,65_ 69,2015,Heisei,27,62831,30558,32273
41 ,Saga,70_ 74,2015,Heisei,27,46263,20609,25654
41 ,Saga,75_ 79,2015,Heisei,27,41780,17587,24193
41 ,Saga,80_ 84,2015,Heisei,27,37055,14023,23032
41 ,Saga,over_85,2015,Heisei,27,41406,11535,29871
42 ,Nagasaki,total,1920,Taisho,9,1136182,584234,551948
42 ,Nagasaki,0_ 4,1920,Taisho,9,148926,74555,74371
42 ,Nagasaki,5_ 9,1920,Taisho,9,131382,65801,65581
42 ,Nagasaki,10_ 14,1920,Taisho,9,121474,61505,59969
42 ,Nagasaki,15_ 19,1920,Taisho,9,109133,59662,49471
42 ,Nagasaki,20_ 24,1920,Taisho,9,102477,57113,45364
42 ,Nagasaki,25_ 29,1920,Taisho,9,84353,45964,38389
42 ,Nagasaki,30_ 34,1920,Taisho,9,70644,37605,33039
42 ,Nagasaki,35_ 39,1920,Taisho,9,66963,34659,32304
42 ,Nagasaki,40_ 44,1920,Taisho,9,63963,33010,30953
42 ,Nagasaki,45_ 49,1920,Taisho,9,54524,27573,26951
42 ,Nagasaki,50_ 54,1920,Taisho,9,46949,23851,23098
42 ,Nagasaki,55_ 59,1920,Taisho,9,38676,19367,19309
42 ,Nagasaki,60_ 64,1920,Taisho,9,31927,15858,16069
42 ,Nagasaki,65_ 69,1920,Taisho,9,25772,12009,13763
42 ,Nagasaki,70_ 74,1920,Taisho,9,20043,8682,11361
42 ,Nagasaki,75_ 79,1920,Taisho,9,11481,4465,7016
42 ,Nagasaki,over_80,1920,Taisho,9,7495,2555,4940
42 ,Nagasaki,total,1925,Taisho,14,1163945,593472,570473
42 ,Nagasaki,0_ 4,1925,Taisho,14,163515,82250,81265
42 ,Nagasaki,5_ 9,1925,Taisho,14,136170,68233,67937
42 ,Nagasaki,10_ 14,1925,Taisho,14,124795,63345,61450
42 ,Nagasaki,15_ 19,1925,Taisho,14,108609,57875,50734
42 ,Nagasaki,20_ 24,1925,Taisho,14,98873,55096,43777
42 ,Nagasaki,25_ 29,1925,Taisho,14,87645,46344,41301
42 ,Nagasaki,30_ 34,1925,Taisho,14,73383,38543,34840
42 ,Nagasaki,35_ 39,1925,Taisho,14,64033,33245,30788
42 ,Nagasaki,40_ 44,1925,Taisho,14,60720,30885,29835
42 ,Nagasaki,45_ 49,1925,Taisho,14,57886,29129,28757
42 ,Nagasaki,50_ 54,1925,Taisho,14,48602,24005,24597
42 ,Nagasaki,55_ 59,1925,Taisho,14,41283,20397,20886
42 ,Nagasaki,60_ 64,1925,Taisho,14,32955,15929,17026
42 ,Nagasaki,65_ 69,1925,Taisho,14,25520,12111,13409
42 ,Nagasaki,70_ 74,1925,Taisho,14,18830,8230,10600
42 ,Nagasaki,75_ 79,1925,Taisho,14,12716,5063,7653
42 ,Nagasaki,80_ 84,1925,Taisho,14,5960,2058,3902
42 ,Nagasaki,over_85,1925,Taisho,14,2450,734,1716
42 ,Nagasaki,total,1930,Showa,5,1233362,630525,602837
42 ,Nagasaki,0_ 4,1930,Showa,5,172531,86791,85740
42 ,Nagasaki,5_ 9,1930,Showa,5,153923,77540,76383
42 ,Nagasaki,10_ 14,1930,Showa,5,130651,66121,64530
42 ,Nagasaki,15_ 19,1930,Showa,5,113486,60359,53127
42 ,Nagasaki,20_ 24,1930,Showa,5,107917,61472,46445
42 ,Nagasaki,25_ 29,1930,Showa,5,89478,47677,41801
42 ,Nagasaki,30_ 34,1930,Showa,5,81590,42597,38993
42 ,Nagasaki,35_ 39,1930,Showa,5,69397,36317,33080
42 ,Nagasaki,40_ 44,1930,Showa,5,59845,31014,28831
42 ,Nagasaki,45_ 49,1930,Showa,5,56491,28370,28121
42 ,Nagasaki,50_ 54,1930,Showa,5,52616,25905,26711
42 ,Nagasaki,55_ 59,1930,Showa,5,43276,20837,22439
42 ,Nagasaki,60_ 64,1930,Showa,5,35424,16774,18650
42 ,Nagasaki,65_ 69,1930,Showa,5,26748,12463,14285
42 ,Nagasaki,70_ 74,1930,Showa,5,18885,8377,10508
42 ,Nagasaki,75_ 79,1930,Showa,5,11933,4883,7050
42 ,Nagasaki,over_80,1930,Showa,5,9171,3028,6143
42 ,Nagasaki,total,1935,Showa,10,1296883,662174,634709
42 ,Nagasaki,0_ 4,1935,Showa,10,178480,90109,88371
42 ,Nagasaki,5_ 9,1935,Showa,10,162992,82133,80859
42 ,Nagasaki,10_ 14,1935,Showa,10,148796,75516,73280
42 ,Nagasaki,15_ 19,1935,Showa,10,117088,63321,53767
42 ,Nagasaki,20_ 24,1935,Showa,10,111364,63459,47905
42 ,Nagasaki,25_ 29,1935,Showa,10,93472,49136,44336
42 ,Nagasaki,30_ 34,1935,Showa,10,81703,42228,39475
42 ,Nagasaki,35_ 39,1935,Showa,10,75730,39036,36694
42 ,Nagasaki,40_ 44,1935,Showa,10,64596,33258,31338
42 ,Nagasaki,45_ 49,1935,Showa,10,55783,28420,27363
42 ,Nagasaki,50_ 54,1935,Showa,10,51596,25400,26196
42 ,Nagasaki,55_ 59,1935,Showa,10,47210,22658,24552
42 ,Nagasaki,60_ 64,1935,Showa,10,37725,17476,20249
42 ,Nagasaki,65_ 69,1935,Showa,10,28964,13094,15870
42 ,Nagasaki,70_ 74,1935,Showa,10,19946,8819,11127
42 ,Nagasaki,75_ 79,1935,Showa,10,12217,4980,7237
42 ,Nagasaki,over_80,1935,Showa,10,9221,3131,6090
42 ,Nagasaki,total,1940,Showa,15,1369016,697990,671026
42 ,Nagasaki,0_ 4,1940,Showa,15,176821,89687,87134
42 ,Nagasaki,5_ 9,1940,Showa,15,169785,85607,84178
42 ,Nagasaki,10_ 14,1940,Showa,15,159688,81101,78587
42 ,Nagasaki,15_ 19,1940,Showa,15,137258,73908,63350
42 ,Nagasaki,20_ 24,1940,Showa,15,109517,58715,50802
42 ,Nagasaki,25_ 29,1940,Showa,15,100439,53459,46980
42 ,Nagasaki,30_ 34,1940,Showa,15,90205,47448,42757
42 ,Nagasaki,35_ 39,1940,Showa,15,79427,41448,37979
42 ,Nagasaki,40_ 44,1940,Showa,15,72769,37859,34910
42 ,Nagasaki,45_ 49,1940,Showa,15,61013,31292,29721
42 ,Nagasaki,50_ 54,1940,Showa,15,51613,25753,25860
42 ,Nagasaki,55_ 59,1940,Showa,15,46359,22272,24087
42 ,Nagasaki,60_ 64,1940,Showa,15,41146,18993,22153
42 ,Nagasaki,65_ 69,1940,Showa,15,30587,13412,17175
42 ,Nagasaki,70_ 74,1940,Showa,15,21239,9019,12220
42 ,Nagasaki,75_ 79,1940,Showa,15,12481,5047,7434
42 ,Nagasaki,80_ 84,1940,Showa,15,5919,2152,3767
42 ,Nagasaki,over_85,1940,Showa,15,2744,814,1930
42 ,Nagasaki,total,1945,Showa,20,1318589,618861,699728
42 ,Nagasaki,1_ 5,1945,Showa,20,168619,85187,83432
42 ,Nagasaki,6_ 10,1945,Showa,20,163799,82982,80817
42 ,Nagasaki,11_ 15,1945,Showa,20,164305,82561,81744
42 ,Nagasaki,16_ 20,1945,Showa,20,144851,71633,73218
42 ,Nagasaki,21_ 25,1945,Showa,20,101299,38743,62556
42 ,Nagasaki,26_ 30,1945,Showa,20,76312,27496,48816
42 ,Nagasaki,31_ 35,1945,Showa,20,73441,29535,43906
42 ,Nagasaki,36_ 40,1945,Showa,20,73371,32793,40578
42 ,Nagasaki,41_ 45,1945,Showa,20,71244,35341,35903
42 ,Nagasaki,46_ 50,1945,Showa,20,65969,33329,32640
42 ,Nagasaki,51_ 55,1945,Showa,20,55270,27860,27410
42 ,Nagasaki,56_ 60,1945,Showa,20,45449,22085,23364
42 ,Nagasaki,61_ 65,1945,Showa,20,38797,17949,20848
42 ,Nagasaki,66_ 70,1945,Showa,20,32028,14131,17897
42 ,Nagasaki,71_ 75,1945,Showa,20,22123,9161,12962
42 ,Nagasaki,76_ 80,1945,Showa,20,12938,5062,7876
42 ,Nagasaki,81_ 85,1945,Showa,20,6321,2263,4058
42 ,Nagasaki,86以上,1945,Showa,20,2453,750,1703
42 ,Nagasaki,total,1950,Showa,25,1645492,812079,833413
42 ,Nagasaki,0_ 4,1950,Showa,25,242356,123746,118610
42 ,Nagasaki,5_ 9,1950,Showa,25,186298,94061,92237
42 ,Nagasaki,10_ 14,1950,Showa,25,175039,88726,86313
42 ,Nagasaki,15_ 19,1950,Showa,25,166260,85016,81244
42 ,Nagasaki,20_ 24,1950,Showa,25,150911,76868,74043
42 ,Nagasaki,25_ 29,1950,Showa,25,124233,58357,65876
42 ,Nagasaki,30_ 34,1950,Showa,25,99965,46095,53870
42 ,Nagasaki,35_ 39,1950,Showa,25,93260,44450,48810
42 ,Nagasaki,40_ 44,1950,Showa,25,85522,42264,43258
42 ,Nagasaki,45_ 49,1950,Showa,25,75429,38271,37158
42 ,Nagasaki,50_ 54,1950,Showa,25,66975,33780,33195
42 ,Nagasaki,55_ 59,1950,Showa,25,54093,26620,27473
42 ,Nagasaki,60_ 64,1950,Showa,25,42365,20001,22364
42 ,Nagasaki,65_ 69,1950,Showa,25,33382,14797,18585
42 ,Nagasaki,70_ 74,1950,Showa,25,25017,10225,14792
42 ,Nagasaki,75_ 79,1950,Showa,25,14670,5504,9166
42 ,Nagasaki,over_80,1950,Showa,25,9680,3281,6399
42 ,Nagasaki,total,1955,Showa,30,1747596,859689,887907
42 ,Nagasaki,0_ 4,1955,Showa,30,228500,117073,111427
42 ,Nagasaki,5_ 9,1955,Showa,30,234821,119931,114890
42 ,Nagasaki,10_ 14,1955,Showa,30,183133,92611,90522
42 ,Nagasaki,15_ 19,1955,Showa,30,158481,81444,77037
42 ,Nagasaki,20_ 24,1955,Showa,30,148180,73920,74260
42 ,Nagasaki,25_ 29,1955,Showa,30,141553,69810,71743
42 ,Nagasaki,30_ 34,1955,Showa,30,117930,54361,63569
42 ,Nagasaki,35_ 39,1955,Showa,30,94854,43047,51807
42 ,Nagasaki,40_ 44,1955,Showa,30,88159,41503,46656
42 ,Nagasaki,45_ 49,1955,Showa,30,80417,39251,41166
42 ,Nagasaki,50_ 54,1955,Showa,30,70304,35035,35269
42 ,Nagasaki,55_ 59,1955,Showa,30,61625,30463,31162
42 ,Nagasaki,60_ 64,1955,Showa,30,48628,23375,25253
42 ,Nagasaki,65_ 69,1955,Showa,30,35888,16391,19497
42 ,Nagasaki,70_ 74,1955,Showa,30,26225,11076,15149
42 ,Nagasaki,75_ 79,1955,Showa,30,17198,6544,10654
42 ,Nagasaki,80_ 84,1955,Showa,30,8188,2753,5435
42 ,Nagasaki,over_85,1955,Showa,30,3499,1092,2407
42 ,Nagasaki,total,1960,Showa,35,1760421,860623,899798
42 ,Nagasaki,0_ 4,1960,Showa,35,185344,94820,90524
42 ,Nagasaki,5_ 9,1960,Showa,35,223283,114303,108980
42 ,Nagasaki,10_ 14,1960,Showa,35,230223,117551,112672
42 ,Nagasaki,15_ 19,1960,Showa,35,138683,70358,68325
42 ,Nagasaki,20_ 24,1960,Showa,35,124765,59875,64890
42 ,Nagasaki,25_ 29,1960,Showa,35,138345,67486,70859
42 ,Nagasaki,30_ 34,1960,Showa,35,135515,66554,68961
42 ,Nagasaki,35_ 39,1960,Showa,35,112988,51829,61159
42 ,Nagasaki,40_ 44,1960,Showa,35,90621,41059,49562
42 ,Nagasaki,45_ 49,1960,Showa,35,83217,38833,44384
42 ,Nagasaki,50_ 54,1960,Showa,35,75170,36178,38992
42 ,Nagasaki,55_ 59,1960,Showa,35,64826,31628,33198
42 ,Nagasaki,60_ 64,1960,Showa,35,55399,26718,28681
42 ,Nagasaki,65_ 69,1960,Showa,35,41510,19296,22214
42 ,Nagasaki,70_ 74,1960,Showa,35,28448,12343,16105
42 ,Nagasaki,75_ 79,1960,Showa,35,18035,7192,10843
42 ,Nagasaki,80_ 84,1960,Showa,35,9705,3372,6333
42 ,Nagasaki,over_85,1960,Showa,35,4344,1228,3116
42 ,Nagasaki,total,1965,Showa,40,1641245,788667,852578
42 ,Nagasaki,0_ 4,1965,Showa,40,149835,76094,73741
42 ,Nagasaki,5_ 9,1965,Showa,40,170481,86639,83842
42 ,Nagasaki,10_ 14,1965,Showa,40,206807,105160,101647
42 ,Nagasaki,15_ 19,1965,Showa,40,160281,81990,78291
42 ,Nagasaki,20_ 24,1965,Showa,40,98498,43167,55331
42 ,Nagasaki,25_ 29,1965,Showa,40,109423,50244,59179
42 ,Nagasaki,30_ 34,1965,Showa,40,123590,59510,64080
42 ,Nagasaki,35_ 39,1965,Showa,40,121805,59175,62630
42 ,Nagasaki,40_ 44,1965,Showa,40,102111,46076,56035
42 ,Nagasaki,45_ 49,1965,Showa,40,82620,36708,45912
42 ,Nagasaki,50_ 54,1965,Showa,40,75731,34794,40937
42 ,Nagasaki,55_ 59,1965,Showa,40,67808,32070,35738
42 ,Nagasaki,60_ 64,1965,Showa,40,57436,27431,30005
42 ,Nagasaki,65_ 69,1965,Showa,40,47319,22057,25262
42 ,Nagasaki,70_ 74,1965,Showa,40,32827,14531,18296
42 ,Nagasaki,75_ 79,1965,Showa,40,19690,8014,11676
42 ,Nagasaki,80_ 84,1965,Showa,40,9871,3505,6366
42 ,Nagasaki,over_85,1965,Showa,40,5112,1502,3610
42 ,Nagasaki,total,1970,Showa,45,1570245,747971,822274
42 ,Nagasaki,0_ 4,1970,Showa,45,132302,67168,65134
42 ,Nagasaki,5_ 9,1970,Showa,45,143888,73381,70507
42 ,Nagasaki,10_ 14,1970,Showa,45,163108,82863,80245
42 ,Nagasaki,15_ 19,1970,Showa,45,146135,74230,71905
42 ,Nagasaki,20_ 24,1970,Showa,45,119608,54181,65427
42 ,Nagasaki,25_ 29,1970,Showa,45,98170,44567,53603
42 ,Nagasaki,30_ 34,1970,Showa,45,105251,49263,55988
42 ,Nagasaki,35_ 39,1970,Showa,45,116627,56105,60522
42 ,Nagasaki,40_ 44,1970,Showa,45,113283,54763,58520
42 ,Nagasaki,45_ 49,1970,Showa,45,95987,42817,53170
42 ,Nagasaki,50_ 54,1970,Showa,45,77305,33975,43330
42 ,Nagasaki,55_ 59,1970,Showa,45,68737,31075,37662
42 ,Nagasaki,60_ 64,1970,Showa,45,61313,28248,33065
42 ,Nagasaki,65_ 69,1970,Showa,45,49976,22984,26992
42 ,Nagasaki,70_ 74,1970,Showa,45,38582,17009,21573
42 ,Nagasaki,75_ 79,1970,Showa,45,23238,9582,13656
42 ,Nagasaki,80_ 84,1970,Showa,45,11395,4195,7200
42 ,Nagasaki,over_85,1970,Showa,45,5340,1565,3775
42 ,Nagasaki,total,1975,Showa,50,1571912,750418,821494
42 ,Nagasaki,0_ 4,1975,Showa,50,132427,67820,64607
42 ,Nagasaki,5_ 9,1975,Showa,50,131511,66873,64638
42 ,Nagasaki,10_ 14,1975,Showa,50,139886,71415,68471
42 ,Nagasaki,15_ 19,1975,Showa,50,126827,64801,62026
42 ,Nagasaki,20_ 24,1975,Showa,50,113868,53441,60427
42 ,Nagasaki,25_ 29,1975,Showa,50,125031,60439,64592
42 ,Nagasaki,30_ 34,1975,Showa,50,99431,46771,52660
42 ,Nagasaki,35_ 39,1975,Showa,50,103578,48838,54740
42 ,Nagasaki,40_ 44,1975,Showa,50,112806,54412,58394
42 ,Nagasaki,45_ 49,1975,Showa,50,108993,52413,56580
42 ,Nagasaki,50_ 54,1975,Showa,50,90863,40111,50752
42 ,Nagasaki,55_ 59,1975,Showa,50,72823,31484,41339
42 ,Nagasaki,60_ 64,1975,Showa,50,65081,28873,36208
42 ,Nagasaki,65_ 69,1975,Showa,50,55690,24770,30920
42 ,Nagasaki,70_ 74,1975,Showa,50,42580,18567,24013
42 ,Nagasaki,75_ 79,1975,Showa,50,29067,11861,17206
42 ,Nagasaki,80_ 84,1975,Showa,50,14623,5415,9208
42 ,Nagasaki,over_85,1975,Showa,50,6748,2071,4677
42 ,Nagasaki,total,1980,Showa,55,1590564,758374,832190
42 ,Nagasaki,0_ 4,1980,Showa,55,118379,60532,57847
42 ,Nagasaki,5_ 9,1980,Showa,55,134982,69040,65942
42 ,Nagasaki,10_ 14,1980,Showa,55,131839,67142,64697
42 ,Nagasaki,15_ 19,1980,Showa,55,117450,59988,57462
42 ,Nagasaki,20_ 24,1980,Showa,55,95791,44744,51047
42 ,Nagasaki,25_ 29,1980,Showa,55,120580,58335,62245
42 ,Nagasaki,30_ 34,1980,Showa,55,126794,62686,64108
42 ,Nagasaki,35_ 39,1980,Showa,55,99812,47108,52704
42 ,Nagasaki,40_ 44,1980,Showa,55,102213,48228,53985
42 ,Nagasaki,45_ 49,1980,Showa,55,110136,52827,57309
42 ,Nagasaki,50_ 54,1980,Showa,55,105660,50354,55306
42 ,Nagasaki,55_ 59,1980,Showa,55,87584,38065,49519
42 ,Nagasaki,60_ 64,1980,Showa,55,69258,29434,39824
42 ,Nagasaki,65_ 69,1980,Showa,55,59810,25780,34030
42 ,Nagasaki,70_ 74,1980,Showa,55,48349,20532,27817
42 ,Nagasaki,75_ 79,1980,Showa,55,33249,13374,19875
42 ,Nagasaki,80_ 84,1980,Showa,55,19052,7031,12021
42 ,Nagasaki,over_85,1980,Showa,55,9293,2958,6335
42 ,Nagasaki,total,1985,Showa,60,1593968,757617,836351
42 ,Nagasaki,0_ 4,1985,Showa,60,107372,55218,52154
42 ,Nagasaki,5_ 9,1985,Showa,60,119645,61115,58530
42 ,Nagasaki,10_ 14,1985,Showa,60,134806,69103,65703
42 ,Nagasaki,15_ 19,1985,Showa,60,112969,56979,55990
42 ,Nagasaki,20_ 24,1985,Showa,60,85871,39628,46243
42 ,Nagasaki,25_ 29,1985,Showa,60,101841,48900,52941
42 ,Nagasaki,30_ 34,1985,Showa,60,121120,59776,61344
42 ,Nagasaki,35_ 39,1985,Showa,60,126037,62506,63531
42 ,Nagasaki,40_ 44,1985,Showa,60,98392,46473,51919
42 ,Nagasaki,45_ 49,1985,Showa,60,99800,46868,52932
42 ,Nagasaki,50_ 54,1985,Showa,60,106829,50832,55997
42 ,Nagasaki,55_ 59,1985,Showa,60,101629,47679,53950
42 ,Nagasaki,60_ 64,1985,Showa,60,83908,35958,47950
42 ,Nagasaki,65_ 69,1985,Showa,60,64456,26648,37808
42 ,Nagasaki,70_ 74,1985,Showa,60,53151,21820,31331
42 ,Nagasaki,75_ 79,1985,Showa,60,39252,15588,23664
42 ,Nagasaki,80_ 84,1985,Showa,60,23115,8240,14875
42 ,Nagasaki,over_85,1985,Showa,60,13631,4198,9433
42 ,Nagasaki,total,1990,Heisei,2,1562959,736729,826230
42 ,Nagasaki,0_ 4,1990,Heisei,2,90644,46273,44371
42 ,Nagasaki,5_ 9,1990,Heisei,2,107268,55156,52112
42 ,Nagasaki,10_ 14,1990,Heisei,2,118849,60814,58035
42 ,Nagasaki,15_ 19,1990,Heisei,2,116014,58300,57714
42 ,Nagasaki,20_ 24,1990,Heisei,2,78372,35376,42996
42 ,Nagasaki,25_ 29,1990,Heisei,2,87970,41208,46762
42 ,Nagasaki,30_ 34,1990,Heisei,2,99988,48376,51612
42 ,Nagasaki,35_ 39,1990,Heisei,2,118945,58678,60267
42 ,Nagasaki,40_ 44,1990,Heisei,2,123236,60828,62408
42 ,Nagasaki,45_ 49,1990,Heisei,2,94975,44442,50533
42 ,Nagasaki,50_ 54,1990,Heisei,2,96291,44703,51588
42 ,Nagasaki,55_ 59,1990,Heisei,2,102879,48082,54797
42 ,Nagasaki,60_ 64,1990,Heisei,2,97668,45104,52564
42 ,Nagasaki,65_ 69,1990,Heisei,2,78773,32956,45817
42 ,Nagasaki,70_ 74,1990,Heisei,2,58165,23082,35083
42 ,Nagasaki,75_ 79,1990,Heisei,2,44708,17171,27537
42 ,Nagasaki,80_ 84,1990,Heisei,2,28643,10184,18459
42 ,Nagasaki,over_85,1990,Heisei,2,18702,5412,13290
42 ,Nagasaki,total,1995,Heisei,7,1544934,726894,818040
42 ,Nagasaki,0_ 4,1995,Heisei,7,79061,40477,38584
42 ,Nagasaki,5_ 9,1995,Heisei,7,91451,46694,44757
42 ,Nagasaki,10_ 14,1995,Heisei,7,106751,54923,51828
42 ,Nagasaki,15_ 19,1995,Heisei,7,105814,52798,53016
42 ,Nagasaki,20_ 24,1995,Heisei,7,86970,41092,45878
42 ,Nagasaki,25_ 29,1995,Heisei,7,83887,39244,44643
42 ,Nagasaki,30_ 34,1995,Heisei,7,89133,42542,46591
42 ,Nagasaki,35_ 39,1995,Heisei,7,100536,49093,51443
42 ,Nagasaki,40_ 44,1995,Heisei,7,118207,58596,59611
42 ,Nagasaki,45_ 49,1995,Heisei,7,121671,60216,61455
42 ,Nagasaki,50_ 54,1995,Heisei,7,93296,43462,49834
42 ,Nagasaki,55_ 59,1995,Heisei,7,94291,43404,50887
42 ,Nagasaki,60_ 64,1995,Heisei,7,99978,46118,53860
42 ,Nagasaki,65_ 69,1995,Heisei,7,92492,41607,50885
42 ,Nagasaki,70_ 74,1995,Heisei,7,72307,29062,43245
42 ,Nagasaki,75_ 79,1995,Heisei,7,49739,18552,31187
42 ,Nagasaki,80_ 84,1995,Heisei,7,33688,11574,22114
42 ,Nagasaki,over_85,1995,Heisei,7,25109,7055,18054
42 ,Nagasaki,total,2000,Heisei,12,1516523,712346,804177
42 ,Nagasaki,0_ 4,2000,Heisei,12,71855,36888,34967
42 ,Nagasaki,5_ 9,2000,Heisei,12,79824,40907,38917
42 ,Nagasaki,10_ 14,2000,Heisei,12,91367,46743,44624
42 ,Nagasaki,15_ 19,2000,Heisei,12,94775,47964,46811
42 ,Nagasaki,20_ 24,2000,Heisei,12,77431,36967,40464
42 ,Nagasaki,25_ 29,2000,Heisei,12,90631,43767,46864
42 ,Nagasaki,30_ 34,2000,Heisei,12,85001,40125,44876
42 ,Nagasaki,35_ 39,2000,Heisei,12,89527,43047,46480
42 ,Nagasaki,40_ 44,2000,Heisei,12,99715,48743,50972
42 ,Nagasaki,45_ 49,2000,Heisei,12,116422,57692,58730
42 ,Nagasaki,50_ 54,2000,Heisei,12,119099,58679,60420
42 ,Nagasaki,55_ 59,2000,Heisei,12,91504,42222,49282
42 ,Nagasaki,60_ 64,2000,Heisei,12,92587,42310,50277
42 ,Nagasaki,65_ 69,2000,Heisei,12,95057,42819,52238
42 ,Nagasaki,70_ 74,2000,Heisei,12,85050,36696,48354
42 ,Nagasaki,75_ 79,2000,Heisei,12,63179,23859,39320
42 ,Nagasaki,80_ 84,2000,Heisei,12,39157,13188,25969
42 ,Nagasaki,over_85,2000,Heisei,12,33428,9116,24312
42 ,Nagasaki,total,2005,Heisei,17,1478632,691444,787188
42 ,Nagasaki,0_ 4,2005,Heisei,17,64107,32631,31476
42 ,Nagasaki,5_ 9,2005,Heisei,17,72383,37057,35326
42 ,Nagasaki,10_ 14,2005,Heisei,17,79497,40920,38577
42 ,Nagasaki,15_ 19,2005,Heisei,17,81099,40958,40141
42 ,Nagasaki,20_ 24,2005,Heisei,17,71082,34168,36914
42 ,Nagasaki,25_ 29,2005,Heisei,17,78747,38239,40508
42 ,Nagasaki,30_ 34,2005,Heisei,17,90305,43519,46786
42 ,Nagasaki,35_ 39,2005,Heisei,17,84752,40168,44584
42 ,Nagasaki,40_ 44,2005,Heisei,17,88467,42523,45944
42 ,Nagasaki,45_ 49,2005,Heisei,17,97893,47665,50228
42 ,Nagasaki,50_ 54,2005,Heisei,17,114064,56209,57855
42 ,Nagasaki,55_ 59,2005,Heisei,17,116589,56860,59729
42 ,Nagasaki,60_ 64,2005,Heisei,17,90226,41321,48905
42 ,Nagasaki,65_ 69,2005,Heisei,17,89226,40117,49109
42 ,Nagasaki,70_ 74,2005,Heisei,17,88573,38693,49880
42 ,Nagasaki,75_ 79,2005,Heisei,17,75658,30780,44878
42 ,Nagasaki,80_ 84,2005,Heisei,17,51549,17763,33786
42 ,Nagasaki,over_85,2005,Heisei,17,43814,11451,32363
42 ,Nagasaki,total,2010,Heisei,22,1426779,665899,760880
42 ,Nagasaki,0_ 4,2010,Heisei,22,58853,30108,28745
42 ,Nagasaki,5_ 9,2010,Heisei,22,63354,32326,31028
42 ,Nagasaki,10_ 14,2010,Heisei,22,71221,36493,34728
42 ,Nagasaki,15_ 19,2010,Heisei,22,71016,36306,34710
42 ,Nagasaki,20_ 24,2010,Heisei,22,59140,28306,30834
42 ,Nagasaki,25_ 29,2010,Heisei,22,68514,33237,35277
42 ,Nagasaki,30_ 34,2010,Heisei,22,77621,37749,39872
42 ,Nagasaki,35_ 39,2010,Heisei,22,88804,43031,45773
42 ,Nagasaki,40_ 44,2010,Heisei,22,83437,39697,43740
42 ,Nagasaki,45_ 49,2010,Heisei,22,86883,41781,45102
42 ,Nagasaki,50_ 54,2010,Heisei,22,96001,46592,49409
42 ,Nagasaki,55_ 59,2010,Heisei,22,111526,54580,56946
42 ,Nagasaki,60_ 64,2010,Heisei,22,114474,55457,59017
42 ,Nagasaki,65_ 69,2010,Heisei,22,86751,39145,47606
42 ,Nagasaki,70_ 74,2010,Heisei,22,83797,36661,47136
42 ,Nagasaki,75_ 79,2010,Heisei,22,79288,32903,46385
42 ,Nagasaki,80_ 84,2010,Heisei,22,62187,22889,39298
42 ,Nagasaki,over_85,2010,Heisei,22,57267,14935,42332
42 ,Nagasaki,total,2015,Heisei,27,1377187,645763,731424
42 ,Nagasaki,0_ 4,2015,Heisei,27,55434,28406,27028
42 ,Nagasaki,5_ 9,2015,Heisei,27,59068,30248,28820
42 ,Nagasaki,10_ 14,2015,Heisei,27,63060,32276,30784
42 ,Nagasaki,15_ 19,2015,Heisei,27,64833,33081,31752
42 ,Nagasaki,20_ 24,2015,Heisei,27,54663,26912,27751
42 ,Nagasaki,25_ 29,2015,Heisei,27,58845,29152,29693
42 ,Nagasaki,30_ 34,2015,Heisei,27,69135,33949,35186
42 ,Nagasaki,35_ 39,2015,Heisei,27,77525,38079,39446
42 ,Nagasaki,40_ 44,2015,Heisei,27,88361,43269,45092
42 ,Nagasaki,45_ 49,2015,Heisei,27,82389,39397,42992
42 ,Nagasaki,50_ 54,2015,Heisei,27,85399,41043,44356
42 ,Nagasaki,55_ 59,2015,Heisei,27,94118,45502,48616
42 ,Nagasaki,60_ 64,2015,Heisei,27,109594,53325,56269
42 ,Nagasaki,65_ 69,2015,Heisei,27,110560,53022,57538
42 ,Nagasaki,70_ 74,2015,Heisei,27,81539,35904,45635
42 ,Nagasaki,75_ 79,2015,Heisei,27,75576,31635,43941
42 ,Nagasaki,80_ 84,2015,Heisei,27,65948,25206,40742
42 ,Nagasaki,over_85,2015,Heisei,27,71063,19614,51449
43 ,Kumamoto,total,1920,Taisho,9,1233233,602389,630844
43 ,Kumamoto,0_ 4,1920,Taisho,9,162645,81629,81016
43 ,Kumamoto,5_ 9,1920,Taisho,9,146140,73720,72420
43 ,Kumamoto,10_ 14,1920,Taisho,9,134150,67863,66287
43 ,Kumamoto,15_ 19,1920,Taisho,9,113735,57545,56190
43 ,Kumamoto,20_ 24,1920,Taisho,9,98861,48726,50135
43 ,Kumamoto,25_ 29,1920,Taisho,9,81788,40124,41664
43 ,Kumamoto,30_ 34,1920,Taisho,9,70420,34172,36248
43 ,Kumamoto,35_ 39,1920,Taisho,9,69098,32573,36525
43 ,Kumamoto,40_ 44,1920,Taisho,9,70036,32962,37074
43 ,Kumamoto,45_ 49,1920,Taisho,9,63462,29752,33710
43 ,Kumamoto,50_ 54,1920,Taisho,9,56237,26780,29457
43 ,Kumamoto,55_ 59,1920,Taisho,9,47922,23085,24837
43 ,Kumamoto,60_ 64,1920,Taisho,9,39881,19007,20874
43 ,Kumamoto,65_ 69,1920,Taisho,9,31372,14367,17005
43 ,Kumamoto,70_ 74,1920,Taisho,9,24995,11103,13892
43 ,Kumamoto,75_ 79,1920,Taisho,9,13762,5714,8048
43 ,Kumamoto,over_80,1920,Taisho,9,8729,3267,5462
43 ,Kumamoto,total,1925,Taisho,14,1296086,637753,658333
43 ,Kumamoto,0_ 4,1925,Taisho,14,179372,89848,89524
43 ,Kumamoto,5_ 9,1925,Taisho,14,152456,76590,75866
43 ,Kumamoto,10_ 14,1925,Taisho,14,143360,73092,70268
43 ,Kumamoto,15_ 19,1925,Taisho,14,121768,62838,58930
43 ,Kumamoto,20_ 24,1925,Taisho,14,98525,49532,48993
43 ,Kumamoto,25_ 29,1925,Taisho,14,90293,44557,45736
43 ,Kumamoto,30_ 34,1925,Taisho,14,78091,38775,39316
43 ,Kumamoto,35_ 39,1925,Taisho,14,68355,33581,34774
43 ,Kumamoto,40_ 44,1925,Taisho,14,66205,31644,34561
43 ,Kumamoto,45_ 49,1925,Taisho,14,67037,31600,35437
43 ,Kumamoto,50_ 54,1925,Taisho,14,58814,27601,31213
43 ,Kumamoto,55_ 59,1925,Taisho,14,50655,23883,26772
43 ,Kumamoto,60_ 64,1925,Taisho,14,41689,19729,21960
43 ,Kumamoto,65_ 69,1925,Taisho,14,31883,14711,17172
43 ,Kumamoto,70_ 74,1925,Taisho,14,22705,9941,12764
43 ,Kumamoto,75_ 79,1925,Taisho,14,15375,6366,9009
43 ,Kumamoto,80_ 84,1925,Taisho,14,6826,2589,4237
43 ,Kumamoto,over_85,1925,Taisho,14,2677,876,1801
43 ,Kumamoto,total,1930,Showa,5,1353993,664106,689887
43 ,Kumamoto,0_ 4,1930,Showa,5,190493,96090,94403
43 ,Kumamoto,5_ 9,1930,Showa,5,167847,84145,83702
43 ,Kumamoto,10_ 14,1930,Showa,5,147452,74144,73308
43 ,Kumamoto,15_ 19,1930,Showa,5,130362,66101,64261
43 ,Kumamoto,20_ 24,1930,Showa,5,103865,51344,52521
43 ,Kumamoto,25_ 29,1930,Showa,5,87830,43092,44738
43 ,Kumamoto,30_ 34,1930,Showa,5,84471,41475,42996
43 ,Kumamoto,35_ 39,1930,Showa,5,74242,36849,37393
43 ,Kumamoto,40_ 44,1930,Showa,5,64427,31665,32762
43 ,Kumamoto,45_ 49,1930,Showa,5,62517,29747,32770
43 ,Kumamoto,50_ 54,1930,Showa,5,61922,29109,32813
43 ,Kumamoto,55_ 59,1930,Showa,5,53255,24721,28534
43 ,Kumamoto,60_ 64,1930,Showa,5,44245,20477,23768
43 ,Kumamoto,65_ 69,1930,Showa,5,33418,15368,18050
43 ,Kumamoto,70_ 74,1930,Showa,5,23246,10310,12936
43 ,Kumamoto,75_ 79,1930,Showa,5,13929,5606,8323
43 ,Kumamoto,over_80,1930,Showa,5,10472,3863,6609
43 ,Kumamoto,total,1935,Showa,10,1387054,680409,706645
43 ,Kumamoto,0_ 4,1935,Showa,10,188084,94940,93144
43 ,Kumamoto,5_ 9,1935,Showa,10,177533,89591,87942
43 ,Kumamoto,10_ 14,1935,Showa,10,162634,82020,80614
43 ,Kumamoto,15_ 19,1935,Showa,10,127481,64492,62989
43 ,Kumamoto,20_ 24,1935,Showa,10,101742,49653,52089
43 ,Kumamoto,25_ 29,1935,Showa,10,89152,43244,45908
43 ,Kumamoto,30_ 34,1935,Showa,10,81593,39893,41700
43 ,Kumamoto,35_ 39,1935,Showa,10,80286,39405,40881
43 ,Kumamoto,40_ 44,1935,Showa,10,70576,35121,35455
43 ,Kumamoto,45_ 49,1935,Showa,10,61371,30154,31217
43 ,Kumamoto,50_ 54,1935,Showa,10,58094,27610,30484
43 ,Kumamoto,55_ 59,1935,Showa,10,56167,26233,29934
43 ,Kumamoto,60_ 64,1935,Showa,10,46846,21283,25563
43 ,Kumamoto,65_ 69,1935,Showa,10,36032,16226,19806
43 ,Kumamoto,70_ 74,1935,Showa,10,24683,10897,13786
43 ,Kumamoto,75_ 79,1935,Showa,10,14543,6004,8539
43 ,Kumamoto,over_80,1935,Showa,10,10237,3643,6594
43 ,Kumamoto,total,1940,Showa,15,1367734,666627,701107
43 ,Kumamoto,0_ 4,1940,Showa,15,171145,86344,84801
43 ,Kumamoto,5_ 9,1940,Showa,15,172191,86962,85229
43 ,Kumamoto,10_ 14,1940,Showa,15,168756,85013,83743
43 ,Kumamoto,15_ 19,1940,Showa,15,132566,63763,68803
43 ,Kumamoto,20_ 24,1940,Showa,15,101387,51279,50108
43 ,Kumamoto,25_ 29,1940,Showa,15,83860,40588,43272
43 ,Kumamoto,30_ 34,1940,Showa,15,78195,36992,41203
43 ,Kumamoto,35_ 39,1940,Showa,15,74633,35774,38859
43 ,Kumamoto,40_ 44,1940,Showa,15,74220,36176,38044
43 ,Kumamoto,45_ 49,1940,Showa,15,65509,32218,33291
43 ,Kumamoto,50_ 54,1940,Showa,15,56121,27470,28651
43 ,Kumamoto,55_ 59,1940,Showa,15,52241,24422,27819
43 ,Kumamoto,60_ 64,1940,Showa,15,48445,22115,26330
43 ,Kumamoto,65_ 69,1940,Showa,15,37642,16607,21035
43 ,Kumamoto,70_ 74,1940,Showa,15,26177,11199,14978
43 ,Kumamoto,75_ 79,1940,Showa,15,15016,6239,8777
43 ,Kumamoto,80_ 84,1940,Showa,15,6759,2574,4185
43 ,Kumamoto,over_85,1940,Showa,15,2868,889,1979
43 ,Kumamoto,total,1945,Showa,20,1556490,715526,840964
43 ,Kumamoto,1_ 5,1945,Showa,20,197901,99692,98209
43 ,Kumamoto,6_ 10,1945,Showa,20,192444,97201,95243
43 ,Kumamoto,11_ 15,1945,Showa,20,195666,98498,97168
43 ,Kumamoto,16_ 20,1945,Showa,20,172562,84746,87816
43 ,Kumamoto,21_ 25,1945,Showa,20,114529,40390,74139
43 ,Kumamoto,26_ 30,1945,Showa,20,86604,28854,57750
43 ,Kumamoto,31_ 35,1945,Showa,20,81987,30130,51857
43 ,Kumamoto,36_ 40,1945,Showa,20,84046,35702,48344
43 ,Kumamoto,41_ 45,1945,Showa,20,80957,38359,42598
43 ,Kumamoto,46_ 50,1945,Showa,20,78365,38010,40355
43 ,Kumamoto,51_ 55,1945,Showa,20,66812,32906,33906
43 ,Kumamoto,56_ 60,1945,Showa,20,56829,27413,29416
43 ,Kumamoto,61_ 65,1945,Showa,20,49042,22298,26744
43 ,Kumamoto,66_ 70,1945,Showa,20,42376,18651,23725
43 ,Kumamoto,71_ 75,1945,Showa,20,29546,12318,17228
43 ,Kumamoto,76_ 80,1945,Showa,20,16627,6588,10039
43 ,Kumamoto,81_ 85,1945,Showa,20,7545,2885,4660
43 ,Kumamoto,86以上,1945,Showa,20,2652,885,1767
43 ,Kumamoto,total,1950,Showa,25,1827582,882420,945162
43 ,Kumamoto,0_ 4,1950,Showa,25,254431,129741,124690
43 ,Kumamoto,5_ 9,1950,Showa,25,209359,105926,103433
43 ,Kumamoto,10_ 14,1950,Showa,25,198757,100524,98233
43 ,Kumamoto,15_ 19,1950,Showa,25,190336,95960,94376
43 ,Kumamoto,20_ 24,1950,Showa,25,159692,76356,83336
43 ,Kumamoto,25_ 29,1950,Showa,25,128168,56257,71911
43 ,Kumamoto,30_ 34,1950,Showa,25,107293,47143,60150
43 ,Kumamoto,35_ 39,1950,Showa,25,100439,45602,54837
43 ,Kumamoto,40_ 44,1950,Showa,25,94008,44434,49574
43 ,Kumamoto,45_ 49,1950,Showa,25,84198,41166,43032
43 ,Kumamoto,50_ 54,1950,Showa,25,78228,38432,39796
43 ,Kumamoto,55_ 59,1950,Showa,25,65398,32167,33231
43 ,Kumamoto,60_ 64,1950,Showa,25,51741,24738,27003
43 ,Kumamoto,65_ 69,1950,Showa,25,41690,18464,23226
43 ,Kumamoto,70_ 74,1950,Showa,25,32524,13656,18868
43 ,Kumamoto,75_ 79,1950,Showa,25,19363,7595,11768
43 ,Kumamoto,over_80,1950,Showa,25,11882,4227,7655
43 ,Kumamoto,total,1955,Showa,30,1895663,917171,978492
43 ,Kumamoto,0_ 4,1955,Showa,30,222593,113487,109106
43 ,Kumamoto,5_ 9,1955,Showa,30,242933,123816,119117
43 ,Kumamoto,10_ 14,1955,Showa,30,204336,103498,100838
43 ,Kumamoto,15_ 19,1955,Showa,30,182455,91657,90798
43 ,Kumamoto,20_ 24,1955,Showa,30,161512,76985,84527
43 ,Kumamoto,25_ 29,1955,Showa,30,147797,71432,76365
43 ,Kumamoto,30_ 34,1955,Showa,30,121558,53769,67789
43 ,Kumamoto,35_ 39,1955,Showa,30,102048,44990,57058
43 ,Kumamoto,40_ 44,1955,Showa,30,95680,43568,52112
43 ,Kumamoto,45_ 49,1955,Showa,30,89721,42404,47317
43 ,Kumamoto,50_ 54,1955,Showa,30,79402,38618,40784
43 ,Kumamoto,55_ 59,1955,Showa,30,73237,35863,37374
43 ,Kumamoto,60_ 64,1955,Showa,30,58772,28544,30228
43 ,Kumamoto,65_ 69,1955,Showa,30,43677,20520,23157
43 ,Kumamoto,70_ 74,1955,Showa,30,32679,13892,18787
43 ,Kumamoto,75_ 79,1955,Showa,30,22402,8858,13544
43 ,Kumamoto,80_ 84,1955,Showa,30,10777,3970,6807
43 ,Kumamoto,over_85,1955,Showa,30,4065,1293,2772
43 ,Kumamoto,total,1960,Showa,35,1856192,887038,969154
43 ,Kumamoto,0_ 4,1960,Showa,35,173819,88823,84996
43 ,Kumamoto,5_ 9,1960,Showa,35,217109,110782,106327
43 ,Kumamoto,10_ 14,1960,Showa,35,238620,121484,117136
43 ,Kumamoto,15_ 19,1960,Showa,35,155243,76012,79231
43 ,Kumamoto,20_ 24,1960,Showa,35,133352,58995,74357
43 ,Kumamoto,25_ 29,1960,Showa,35,142227,66723,75504
43 ,Kumamoto,30_ 34,1960,Showa,35,139026,66934,72092
43 ,Kumamoto,35_ 39,1960,Showa,35,115810,50654,65156
43 ,Kumamoto,40_ 44,1960,Showa,35,97796,42915,54881
43 ,Kumamoto,45_ 49,1960,Showa,35,91066,41023,50043
43 ,Kumamoto,50_ 54,1960,Showa,35,84591,39663,44928
43 ,Kumamoto,55_ 59,1960,Showa,35,73986,35555,38431
43 ,Kumamoto,60_ 64,1960,Showa,35,66437,31929,34508
43 ,Kumamoto,65_ 69,1960,Showa,35,50776,24056,26720
43 ,Kumamoto,70_ 74,1960,Showa,35,34998,15887,19111
43 ,Kumamoto,75_ 79,1960,Showa,35,22919,9195,13724
43 ,Kumamoto,80_ 84,1960,Showa,35,12755,4643,8112
43 ,Kumamoto,over_85,1960,Showa,35,5662,1765,3897
43 ,Kumamoto,total,1965,Showa,40,1770736,838584,932152
43 ,Kumamoto,0_ 4,1965,Showa,40,142031,72088,69943
43 ,Kumamoto,5_ 9,1965,Showa,40,168122,85243,82879
43 ,Kumamoto,10_ 14,1965,Showa,40,211313,107357,103956
43 ,Kumamoto,15_ 19,1965,Showa,40,176861,88887,87974
43 ,Kumamoto,20_ 24,1965,Showa,40,110145,46532,63613
43 ,Kumamoto,25_ 29,1965,Showa,40,117648,52616,65032
43 ,Kumamoto,30_ 34,1965,Showa,40,133961,63650,70311
43 ,Kumamoto,35_ 39,1965,Showa,40,132461,63710,68751
43 ,Kumamoto,40_ 44,1965,Showa,40,110746,48227,62519
43 ,Kumamoto,45_ 49,1965,Showa,40,92856,40459,52397
43 ,Kumamoto,50_ 54,1965,Showa,40,85466,38105,47361
43 ,Kumamoto,55_ 59,1965,Showa,40,78415,36573,41842
43 ,Kumamoto,60_ 64,1965,Showa,40,67047,31780,35267
43 ,Kumamoto,65_ 69,1965,Showa,40,57652,26887,30765
43 ,Kumamoto,70_ 74,1965,Showa,40,41274,18811,22463
43 ,Kumamoto,75_ 79,1965,Showa,40,24638,10598,14040
43 ,Kumamoto,80_ 84,1965,Showa,40,13112,4841,8271
43 ,Kumamoto,over_85,1965,Showa,40,6988,2220,4768
43 ,Kumamoto,total,1970,Showa,45,1700229,798152,902077
43 ,Kumamoto,0_ 4,1970,Showa,45,124918,63848,61070
43 ,Kumamoto,5_ 9,1970,Showa,45,139990,71182,68808
43 ,Kumamoto,10_ 14,1970,Showa,45,164615,83880,80735
43 ,Kumamoto,15_ 19,1970,Showa,45,158514,78812,79702
43 ,Kumamoto,20_ 24,1970,Showa,45,131456,57549,73907
43 ,Kumamoto,25_ 29,1970,Showa,45,105235,47315,57920
43 ,Kumamoto,30_ 34,1970,Showa,45,114211,52367,61844
43 ,Kumamoto,35_ 39,1970,Showa,45,129718,61501,68217
43 ,Kumamoto,40_ 44,1970,Showa,45,125305,59967,65338
43 ,Kumamoto,45_ 49,1970,Showa,45,106402,45858,60544
43 ,Kumamoto,50_ 54,1970,Showa,45,88320,37978,50342
43 ,Kumamoto,55_ 59,1970,Showa,45,79226,35199,44027
43 ,Kumamoto,60_ 64,1970,Showa,45,72275,32923,39352
43 ,Kumamoto,65_ 69,1970,Showa,45,59312,27214,32098
43 ,Kumamoto,70_ 74,1970,Showa,45,48070,21429,26641
43 ,Kumamoto,75_ 79,1970,Showa,45,30144,12881,17263
43 ,Kumamoto,80_ 84,1970,Showa,45,14989,5897,9092
43 ,Kumamoto,over_85,1970,Showa,45,7529,2352,5177
43 ,Kumamoto,total,1975,Showa,50,1715273,809998,905275
43 ,Kumamoto,0_ 4,1975,Showa,50,129383,66317,63066
43 ,Kumamoto,5_ 9,1975,Showa,50,127823,65275,62548
43 ,Kumamoto,10_ 14,1975,Showa,50,140196,71357,68839
43 ,Kumamoto,15_ 19,1975,Showa,50,136591,69184,67407
43 ,Kumamoto,20_ 24,1975,Showa,50,122007,55727,66280
43 ,Kumamoto,25_ 29,1975,Showa,50,132847,63563,69284
43 ,Kumamoto,30_ 34,1975,Showa,50,109300,51581,57719
43 ,Kumamoto,35_ 39,1975,Showa,50,115226,53466,61760
43 ,Kumamoto,40_ 44,1975,Showa,50,129096,61427,67669
43 ,Kumamoto,45_ 49,1975,Showa,50,124716,59553,65163
43 ,Kumamoto,50_ 54,1975,Showa,50,103079,44333,58746
43 ,Kumamoto,55_ 59,1975,Showa,50,85302,36622,48680
43 ,Kumamoto,60_ 64,1975,Showa,50,76736,33625,43111
43 ,Kumamoto,65_ 69,1975,Showa,50,66515,29647,36868
43 ,Kumamoto,70_ 74,1975,Showa,50,50904,22274,28630
43 ,Kumamoto,75_ 79,1975,Showa,50,36839,15415,21424
43 ,Kumamoto,80_ 84,1975,Showa,50,19260,7476,11784
43 ,Kumamoto,over_85,1975,Showa,50,9341,3088,6253
43 ,Kumamoto,total,1980,Showa,55,1790327,850831,939496
43 ,Kumamoto,0_ 4,1980,Showa,55,126547,64702,61845
43 ,Kumamoto,5_ 9,1980,Showa,55,136847,70087,66760
43 ,Kumamoto,10_ 14,1980,Showa,55,131633,67210,64423
43 ,Kumamoto,15_ 19,1980,Showa,55,129592,66634,62958
43 ,Kumamoto,20_ 24,1980,Showa,55,114689,54203,60486
43 ,Kumamoto,25_ 29,1980,Showa,55,133527,64593,68934
43 ,Kumamoto,30_ 34,1980,Showa,55,141679,70511,71168
43 ,Kumamoto,35_ 39,1980,Showa,55,113591,54047,59544
43 ,Kumamoto,40_ 44,1980,Showa,55,116783,54403,62380
43 ,Kumamoto,45_ 49,1980,Showa,55,128278,60894,67384
43 ,Kumamoto,50_ 54,1980,Showa,55,123255,58389,64866
43 ,Kumamoto,55_ 59,1980,Showa,55,101450,43389,58061
43 ,Kumamoto,60_ 64,1980,Showa,55,82234,34911,47323
43 ,Kumamoto,65_ 69,1980,Showa,55,71577,30738,40839
43 ,Kumamoto,70_ 74,1980,Showa,55,59086,25206,33880
43 ,Kumamoto,75_ 79,1980,Showa,55,40987,16850,24137
43 ,Kumamoto,80_ 84,1980,Showa,55,25288,9618,15670
43 ,Kumamoto,over_85,1980,Showa,55,13113,4353,8760
43 ,Kumamoto,total,1985,Showa,60,1837747,872932,964815
43 ,Kumamoto,0_ 4,1985,Showa,60,119835,61407,58428
43 ,Kumamoto,5_ 9,1985,Showa,60,129938,66450,63488
43 ,Kumamoto,10_ 14,1985,Showa,60,139300,71446,67854
43 ,Kumamoto,15_ 19,1985,Showa,60,123296,63070,60226
43 ,Kumamoto,20_ 24,1985,Showa,60,108014,51308,56706
43 ,Kumamoto,25_ 29,1985,Showa,60,118412,56652,61760
43 ,Kumamoto,30_ 34,1985,Showa,60,136825,67637,69188
43 ,Kumamoto,35_ 39,1985,Showa,60,144151,71923,72228
43 ,Kumamoto,40_ 44,1985,Showa,60,113903,54168,59735
43 ,Kumamoto,45_ 49,1985,Showa,60,115740,53706,62034
43 ,Kumamoto,50_ 54,1985,Showa,60,126315,59673,66642
43 ,Kumamoto,55_ 59,1985,Showa,60,121205,56965,64240
43 ,Kumamoto,60_ 64,1985,Showa,60,98797,41802,56995
43 ,Kumamoto,65_ 69,1985,Showa,60,77780,32426,45354
43 ,Kumamoto,70_ 74,1985,Showa,60,64964,26892,38072
43 ,Kumamoto,75_ 79,1985,Showa,60,49499,19755,29744
43 ,Kumamoto,80_ 84,1985,Showa,60,29939,11133,18806
43 ,Kumamoto,over_85,1985,Showa,60,19673,6424,13249
43 ,Kumamoto,total,1990,Heisei,2,1840326,869441,970885
43 ,Kumamoto,0_ 4,1990,Heisei,2,103394,52708,50686
43 ,Kumamoto,5_ 9,1990,Heisei,2,121117,62192,58925
43 ,Kumamoto,10_ 14,1990,Heisei,2,131123,67171,63952
43 ,Kumamoto,15_ 19,1990,Heisei,2,129165,66409,62756
43 ,Kumamoto,20_ 24,1990,Heisei,2,99156,46598,52558
43 ,Kumamoto,25_ 29,1990,Heisei,2,105343,49065,56278
43 ,Kumamoto,30_ 34,1990,Heisei,2,117795,57110,60685
43 ,Kumamoto,35_ 39,1990,Heisei,2,136857,67426,69431
43 ,Kumamoto,40_ 44,1990,Heisei,2,143274,71157,72117
43 ,Kumamoto,45_ 49,1990,Heisei,2,111751,52782,58969
43 ,Kumamoto,50_ 54,1990,Heisei,2,113454,52225,61229
43 ,Kumamoto,55_ 59,1990,Heisei,2,123653,57500,66153
43 ,Kumamoto,60_ 64,1990,Heisei,2,117871,54776,63095
43 ,Kumamoto,65_ 69,1990,Heisei,2,93779,38876,54903
43 ,Kumamoto,70_ 74,1990,Heisei,2,71280,28720,42560
43 ,Kumamoto,75_ 79,1990,Heisei,2,55732,21771,33961
43 ,Kumamoto,80_ 84,1990,Heisei,2,37423,13496,23927
43 ,Kumamoto,over_85,1990,Heisei,2,25803,8007,17796
43 ,Kumamoto,total,1995,Heisei,7,1859793,879873,979920
43 ,Kumamoto,0_ 4,1995,Heisei,7,92139,47282,44857
43 ,Kumamoto,5_ 9,1995,Heisei,7,106165,54084,52081
43 ,Kumamoto,10_ 14,1995,Heisei,7,123158,63212,59946
43 ,Kumamoto,15_ 19,1995,Heisei,7,126559,65807,60752
43 ,Kumamoto,20_ 24,1995,Heisei,7,113066,56431,56635
43 ,Kumamoto,25_ 29,1995,Heisei,7,101117,47196,53921
43 ,Kumamoto,30_ 34,1995,Heisei,7,108489,51743,56746
43 ,Kumamoto,35_ 39,1995,Heisei,7,120393,58768,61625
43 ,Kumamoto,40_ 44,1995,Heisei,7,138628,68501,70127
43 ,Kumamoto,45_ 49,1995,Heisei,7,143072,71053,72019
43 ,Kumamoto,50_ 54,1995,Heisei,7,111182,52291,58891
43 ,Kumamoto,55_ 59,1995,Heisei,7,112596,51499,61097
43 ,Kumamoto,60_ 64,1995,Heisei,7,121377,55984,65393
43 ,Kumamoto,65_ 69,1995,Heisei,7,112887,51343,61544
43 ,Kumamoto,70_ 74,1995,Heisei,7,87395,34962,52433
43 ,Kumamoto,75_ 79,1995,Heisei,7,62192,23584,38608
43 ,Kumamoto,80_ 84,1995,Heisei,7,43443,15307,28136
43 ,Kumamoto,over_85,1995,Heisei,7,35007,10220,24787
43 ,Kumamoto,total,2000,Heisei,12,1859344,878145,981199
43 ,Kumamoto,0_ 4,2000,Heisei,12,86388,44420,41968
43 ,Kumamoto,5_ 9,2000,Heisei,12,94469,48524,45945
43 ,Kumamoto,10_ 14,2000,Heisei,12,107797,54943,52854
43 ,Kumamoto,15_ 19,2000,Heisei,12,117474,60781,56693
43 ,Kumamoto,20_ 24,2000,Heisei,12,109041,55209,53832
43 ,Kumamoto,25_ 29,2000,Heisei,12,111736,54173,57563
43 ,Kumamoto,30_ 34,2000,Heisei,12,103257,48865,54392
43 ,Kumamoto,35_ 39,2000,Heisei,12,110108,52641,57467
43 ,Kumamoto,40_ 44,2000,Heisei,12,121166,59116,62050
43 ,Kumamoto,45_ 49,2000,Heisei,12,137585,67918,69667
43 ,Kumamoto,50_ 54,2000,Heisei,12,141333,69757,71576
43 ,Kumamoto,55_ 59,2000,Heisei,12,110278,51299,58979
43 ,Kumamoto,60_ 64,2000,Heisei,12,111812,50767,61045
43 ,Kumamoto,65_ 69,2000,Heisei,12,116706,52950,63756
43 ,Kumamoto,70_ 74,2000,Heisei,12,105197,46383,58814
43 ,Kumamoto,75_ 79,2000,Heisei,12,78066,29545,48521
43 ,Kumamoto,80_ 84,2000,Heisei,12,50151,17335,32816
43 ,Kumamoto,over_85,2000,Heisei,12,45900,12981,32919
43 ,Kumamoto,total,2005,Heisei,17,1842233,866916,975317
43 ,Kumamoto,0_ 4,2005,Heisei,17,81187,41701,39486
43 ,Kumamoto,5_ 9,2005,Heisei,17,87771,45179,42592
43 ,Kumamoto,10_ 14,2005,Heisei,17,95055,48725,46330
43 ,Kumamoto,15_ 19,2005,Heisei,17,102653,52841,49812
43 ,Kumamoto,20_ 24,2005,Heisei,17,100183,49905,50278
43 ,Kumamoto,25_ 29,2005,Heisei,17,105059,51426,53633
43 ,Kumamoto,30_ 34,2005,Heisei,17,111897,54505,57392
43 ,Kumamoto,35_ 39,2005,Heisei,17,103332,48891,54441
43 ,Kumamoto,40_ 44,2005,Heisei,17,109699,52378,57321
43 ,Kumamoto,45_ 49,2005,Heisei,17,120119,58333,61786
43 ,Kumamoto,50_ 54,2005,Heisei,17,136147,66732,69415
43 ,Kumamoto,55_ 59,2005,Heisei,17,140118,68604,71514
43 ,Kumamoto,60_ 64,2005,Heisei,17,109918,51073,58845
43 ,Kumamoto,65_ 69,2005,Heisei,17,108729,48851,59878
43 ,Kumamoto,70_ 74,2005,Heisei,17,109816,48408,61408
43 ,Kumamoto,75_ 79,2005,Heisei,17,94789,39705,55084
43 ,Kumamoto,80_ 84,2005,Heisei,17,64880,22556,42324
43 ,Kumamoto,over_85,2005,Heisei,17,59030,16045,42985
43 ,Kumamoto,total,2010,Heisei,22,1817426,853514,963912
43 ,Kumamoto,0_ 4,2010,Heisei,22,79226,40373,38853
43 ,Kumamoto,5_ 9,2010,Heisei,22,82058,42188,39870
43 ,Kumamoto,10_ 14,2010,Heisei,22,88322,45413,42909
43 ,Kumamoto,15_ 19,2010,Heisei,22,90657,46655,44002
43 ,Kumamoto,20_ 24,2010,Heisei,22,84206,41088,43118
43 ,Kumamoto,25_ 29,2010,Heisei,22,95464,46599,48865
43 ,Kumamoto,30_ 34,2010,Heisei,22,105338,51628,53710
43 ,Kumamoto,35_ 39,2010,Heisei,22,112467,54906,57561
43 ,Kumamoto,40_ 44,2010,Heisei,22,103677,49166,54511
43 ,Kumamoto,45_ 49,2010,Heisei,22,109043,52042,57001
43 ,Kumamoto,50_ 54,2010,Heisei,22,118799,57577,61222
43 ,Kumamoto,55_ 59,2010,Heisei,22,134731,65649,69082
43 ,Kumamoto,60_ 64,2010,Heisei,22,139058,67912,71146
43 ,Kumamoto,65_ 69,2010,Heisei,22,106597,48903,57694
43 ,Kumamoto,70_ 74,2010,Heisei,22,102743,45122,57621
43 ,Kumamoto,75_ 79,2010,Heisei,22,99404,41751,57653
43 ,Kumamoto,80_ 84,2010,Heisei,22,79191,30429,48762
43 ,Kumamoto,over_85,2010,Heisei,22,75331,20158,55173
43 ,Kumamoto,total,2015,Heisei,27,1786170,841046,945124
43 ,Kumamoto,0_ 4,2015,Heisei,27,77321,39736,37585
43 ,Kumamoto,5_ 9,2015,Heisei,27,80840,41202,39638
43 ,Kumamoto,10_ 14,2015,Heisei,27,83006,42643,40363
43 ,Kumamoto,15_ 19,2015,Heisei,27,85116,43893,41223
43 ,Kumamoto,20_ 24,2015,Heisei,27,75010,36784,38226
43 ,Kumamoto,25_ 29,2015,Heisei,27,84253,41179,43074
43 ,Kumamoto,30_ 34,2015,Heisei,27,96841,47582,49259
43 ,Kumamoto,35_ 39,2015,Heisei,27,106567,52433,54134
43 ,Kumamoto,40_ 44,2015,Heisei,27,113420,55558,57862
43 ,Kumamoto,45_ 49,2015,Heisei,27,103398,49143,54255
43 ,Kumamoto,50_ 54,2015,Heisei,27,108069,51633,56436
43 ,Kumamoto,55_ 59,2015,Heisei,27,117745,56877,60868
43 ,Kumamoto,60_ 64,2015,Heisei,27,133981,65215,68766
43 ,Kumamoto,65_ 69,2015,Heisei,27,135949,65786,70163
43 ,Kumamoto,70_ 74,2015,Heisei,27,101596,45615,55981
43 ,Kumamoto,75_ 79,2015,Heisei,27,94559,40066,54493
43 ,Kumamoto,80_ 84,2015,Heisei,27,84873,33147,51726
43 ,Kumamoto,over_85,2015,Heisei,27,94507,27540,66967
44 ,Oita,total,1920,Taisho,9,860282,422708,437574
44 ,Oita,0_ 4,1920,Taisho,9,109932,55402,54530
44 ,Oita,5_ 9,1920,Taisho,9,102777,51970,50807
44 ,Oita,10_ 14,1920,Taisho,9,91834,46545,45289
44 ,Oita,15_ 19,1920,Taisho,9,75783,36758,39025
44 ,Oita,20_ 24,1920,Taisho,9,64274,30321,33953
44 ,Oita,25_ 29,1920,Taisho,9,54732,26774,27958
44 ,Oita,30_ 34,1920,Taisho,9,50470,24890,25580
44 ,Oita,35_ 39,1920,Taisho,9,51215,24732,26483
44 ,Oita,40_ 44,1920,Taisho,9,52270,25564,26706
44 ,Oita,45_ 49,1920,Taisho,9,46738,22824,23914
44 ,Oita,50_ 54,1920,Taisho,9,39878,19717,20161
44 ,Oita,55_ 59,1920,Taisho,9,33457,16230,17227
44 ,Oita,60_ 64,1920,Taisho,9,29588,14435,15153
44 ,Oita,65_ 69,1920,Taisho,9,23933,11356,12577
44 ,Oita,70_ 74,1920,Taisho,9,18181,8578,9603
44 ,Oita,75_ 79,1920,Taisho,9,9856,4399,5457
44 ,Oita,over_80,1920,Taisho,9,5364,2213,3151
44 ,Oita,total,1925,Taisho,14,915136,451298,463838
44 ,Oita,0_ 4,1925,Taisho,14,124902,62539,62363
44 ,Oita,5_ 9,1925,Taisho,14,102971,51940,51031
44 ,Oita,10_ 14,1925,Taisho,14,102098,51445,50653
44 ,Oita,15_ 19,1925,Taisho,14,85205,41646,43559
44 ,Oita,20_ 24,1925,Taisho,14,67474,32638,34836
44 ,Oita,25_ 29,1925,Taisho,14,62083,30808,31275
44 ,Oita,30_ 34,1925,Taisho,14,53287,26631,26656
44 ,Oita,35_ 39,1925,Taisho,14,49565,24780,24785
44 ,Oita,40_ 44,1925,Taisho,14,49854,24440,25414
44 ,Oita,45_ 49,1925,Taisho,14,50470,24728,25742
44 ,Oita,50_ 54,1925,Taisho,14,44016,21563,22453
44 ,Oita,55_ 59,1925,Taisho,14,36129,17677,18452
44 ,Oita,60_ 64,1925,Taisho,14,29101,13960,15141
44 ,Oita,65_ 69,1925,Taisho,14,23673,11291,12382
44 ,Oita,70_ 74,1925,Taisho,14,17149,7805,9344
44 ,Oita,75_ 79,1925,Taisho,14,10926,4889,6037
44 ,Oita,80_ 84,1925,Taisho,14,4710,1959,2751
44 ,Oita,over_85,1925,Taisho,14,1523,559,964
44 ,Oita,total,1930,Showa,5,945771,465994,479777
44 ,Oita,0_ 4,1930,Showa,5,130578,66252,64326
44 ,Oita,5_ 9,1930,Showa,5,116055,58265,57790
44 ,Oita,10_ 14,1930,Showa,5,100116,50568,49548
44 ,Oita,15_ 19,1930,Showa,5,89521,43847,45674
44 ,Oita,20_ 24,1930,Showa,5,68855,32712,36143
44 ,Oita,25_ 29,1930,Showa,5,61100,29761,31339
44 ,Oita,30_ 34,1930,Showa,5,58325,29170,29155
44 ,Oita,35_ 39,1930,Showa,5,51154,25601,25553
44 ,Oita,40_ 44,1930,Showa,5,47094,23597,23497
44 ,Oita,45_ 49,1930,Showa,5,47135,22927,24208
44 ,Oita,50_ 54,1930,Showa,5,46840,22900,23940
44 ,Oita,55_ 59,1930,Showa,5,39961,19367,20594
44 ,Oita,60_ 64,1930,Showa,5,31474,15211,16263
44 ,Oita,65_ 69,1930,Showa,5,23121,10749,12372
44 ,Oita,70_ 74,1930,Showa,5,17111,7816,9295
44 ,Oita,75_ 79,1930,Showa,5,10364,4423,5941
44 ,Oita,over_80,1930,Showa,5,6967,2828,4139
44 ,Oita,total,1935,Showa,10,980458,481549,498909
44 ,Oita,0_ 4,1935,Showa,10,131558,66125,65433
44 ,Oita,5_ 9,1935,Showa,10,123187,62354,60833
44 ,Oita,10_ 14,1935,Showa,10,113827,56990,56837
44 ,Oita,15_ 19,1935,Showa,10,86538,41982,44556
44 ,Oita,20_ 24,1935,Showa,10,71921,33557,38364
44 ,Oita,25_ 29,1935,Showa,10,63444,30770,32674
44 ,Oita,30_ 34,1935,Showa,10,58360,28814,29546
44 ,Oita,35_ 39,1935,Showa,10,56251,28262,27989
44 ,Oita,40_ 44,1935,Showa,10,48590,24421,24169
44 ,Oita,45_ 49,1935,Showa,10,44941,22504,22437
44 ,Oita,50_ 54,1935,Showa,10,44305,21601,22704
44 ,Oita,55_ 59,1935,Showa,10,42999,20851,22148
44 ,Oita,60_ 64,1935,Showa,10,34822,16662,18160
44 ,Oita,65_ 69,1935,Showa,10,25373,11932,13441
44 ,Oita,70_ 74,1935,Showa,10,17053,7597,9456
44 ,Oita,75_ 79,1935,Showa,10,10172,4424,5748
44 ,Oita,over_80,1935,Showa,10,7117,2703,4414
44 ,Oita,total,1940,Showa,15,972601,473297,499304
44 ,Oita,0_ 4,1940,Showa,15,119480,60298,59182
44 ,Oita,5_ 9,1940,Showa,15,121666,61199,60467
44 ,Oita,10_ 14,1940,Showa,15,118726,59558,59168
44 ,Oita,15_ 19,1940,Showa,15,90150,40830,49320
44 ,Oita,20_ 24,1940,Showa,15,69807,34553,35254
44 ,Oita,25_ 29,1940,Showa,15,62137,29751,32386
44 ,Oita,30_ 34,1940,Showa,15,56888,26957,29931
44 ,Oita,35_ 39,1940,Showa,15,54227,26274,27953
44 ,Oita,40_ 44,1940,Showa,15,52181,26006,26175
44 ,Oita,45_ 49,1940,Showa,15,45294,22526,22768
44 ,Oita,50_ 54,1940,Showa,15,41738,20578,21160
44 ,Oita,55_ 59,1940,Showa,15,40084,19315,20769
44 ,Oita,60_ 64,1940,Showa,15,37210,17598,19612
44 ,Oita,65_ 69,1940,Showa,15,28138,13014,15124
44 ,Oita,70_ 74,1940,Showa,15,18130,8080,10050
44 ,Oita,75_ 79,1940,Showa,15,10184,4266,5918
44 ,Oita,80_ 84,1940,Showa,15,4602,1828,2774
44 ,Oita,over_85,1940,Showa,15,1946,662,1284
44 ,Oita,total,1945,Showa,20,1124513,520470,604043
44 ,Oita,1_ 5,1945,Showa,20,146200,74049,72151
44 ,Oita,6_ 10,1945,Showa,20,135353,68533,66820
44 ,Oita,11_ 15,1945,Showa,20,137908,69248,68660
44 ,Oita,16_ 20,1945,Showa,20,118108,55989,62119
44 ,Oita,21_ 25,1945,Showa,20,82685,28831,53854
44 ,Oita,26_ 30,1945,Showa,20,63891,22070,41821
44 ,Oita,31_ 35,1945,Showa,20,63569,24158,39411
44 ,Oita,36_ 40,1945,Showa,20,62374,27465,34909
44 ,Oita,41_ 45,1945,Showa,20,59384,28504,30880
44 ,Oita,46_ 50,1945,Showa,20,56553,28217,28336
44 ,Oita,51_ 55,1945,Showa,20,47457,23783,23674
44 ,Oita,56_ 60,1945,Showa,20,41865,20612,21253
44 ,Oita,61_ 65,1945,Showa,20,37631,17736,19895
44 ,Oita,66_ 70,1945,Showa,20,31607,14424,17183
44 ,Oita,71_ 75,1945,Showa,20,21980,9645,12335
44 ,Oita,76_ 80,1945,Showa,20,11165,4667,6498
44 ,Oita,81_ 85,1945,Showa,20,4974,1904,3070
44 ,Oita,86以上,1945,Showa,20,1809,635,1174
44 ,Oita,total,1950,Showa,25,1252999,604825,648174
44 ,Oita,0_ 4,1950,Showa,25,171838,87553,84285
44 ,Oita,5_ 9,1950,Showa,25,145072,73435,71637
44 ,Oita,10_ 14,1950,Showa,25,133533,67597,65936
44 ,Oita,15_ 19,1950,Showa,25,129963,64230,65733
44 ,Oita,20_ 24,1950,Showa,25,107342,50113,57229
44 ,Oita,25_ 29,1950,Showa,25,86313,37672,48641
44 ,Oita,30_ 34,1950,Showa,25,72393,32124,40269
44 ,Oita,35_ 39,1950,Showa,25,71037,31944,39093
44 ,Oita,40_ 44,1950,Showa,25,64438,30671,33767
44 ,Oita,45_ 49,1950,Showa,25,58907,28869,30038
44 ,Oita,50_ 54,1950,Showa,25,54070,27061,27009
44 ,Oita,55_ 59,1950,Showa,25,44696,22190,22506
44 ,Oita,60_ 64,1950,Showa,25,37722,18391,19331
44 ,Oita,65_ 69,1950,Showa,25,30865,14193,16672
44 ,Oita,70_ 74,1950,Showa,25,23659,10329,13330
44 ,Oita,75_ 79,1950,Showa,25,13520,5638,7882
44 ,Oita,over_80,1950,Showa,25,7555,2780,4775
44 ,Oita,total,1955,Showa,30,1277199,616402,660797
44 ,Oita,0_ 4,1955,Showa,30,139189,71171,68018
44 ,Oita,5_ 9,1955,Showa,30,163855,83447,80408
44 ,Oita,10_ 14,1955,Showa,30,140673,71106,69567
44 ,Oita,15_ 19,1955,Showa,30,120533,59584,60949
44 ,Oita,20_ 24,1955,Showa,30,108162,49877,58285
44 ,Oita,25_ 29,1955,Showa,30,98764,47177,51587
44 ,Oita,30_ 34,1955,Showa,30,81837,36167,45670
44 ,Oita,35_ 39,1955,Showa,30,68759,30597,38162
44 ,Oita,40_ 44,1955,Showa,30,67382,30384,36998
44 ,Oita,45_ 49,1955,Showa,30,61209,29129,32080
44 ,Oita,50_ 54,1955,Showa,30,55216,27028,28188
44 ,Oita,55_ 59,1955,Showa,30,50173,25017,25156
44 ,Oita,60_ 64,1955,Showa,30,39814,19540,20274
44 ,Oita,65_ 69,1955,Showa,30,31722,15209,16513
44 ,Oita,70_ 74,1955,Showa,30,24153,10695,13458
44 ,Oita,75_ 79,1955,Showa,30,15804,6616,9188
44 ,Oita,80_ 84,1955,Showa,30,7344,2797,4547
44 ,Oita,over_85,1955,Showa,30,2599,856,1743
44 ,Oita,total,1960,Showa,35,1239655,590963,648692
44 ,Oita,0_ 4,1960,Showa,35,107546,54609,52937
44 ,Oita,5_ 9,1960,Showa,35,136158,69553,66605
44 ,Oita,10_ 14,1960,Showa,35,161399,82112,79287
44 ,Oita,15_ 19,1960,Showa,35,110194,53029,57165
44 ,Oita,20_ 24,1960,Showa,35,86342,36579,49763
44 ,Oita,25_ 29,1960,Showa,35,94436,44365,50071
44 ,Oita,30_ 34,1960,Showa,35,92682,44426,48256
44 ,Oita,35_ 39,1960,Showa,35,78134,34282,43852
44 ,Oita,40_ 44,1960,Showa,35,65901,29219,36682
44 ,Oita,45_ 49,1960,Showa,35,64085,28623,35462
44 ,Oita,50_ 54,1960,Showa,35,57750,27336,30414
44 ,Oita,55_ 59,1960,Showa,35,51416,25013,26403
44 ,Oita,60_ 64,1960,Showa,35,45331,22250,23081
44 ,Oita,65_ 69,1960,Showa,35,34087,16322,17765
44 ,Oita,70_ 74,1960,Showa,35,25062,11602,13460
44 ,Oita,75_ 79,1960,Showa,35,16669,7000,9669
44 ,Oita,80_ 84,1960,Showa,35,8814,3423,5391
44 ,Oita,over_85,1960,Showa,35,3649,1220,2429
44 ,Oita,total,1965,Showa,40,1187480,559433,628047
44 ,Oita,0_ 4,1965,Showa,40,90415,46094,44321
44 ,Oita,5_ 9,1965,Showa,40,105189,53288,51901
44 ,Oita,10_ 14,1965,Showa,40,134113,68408,65705
44 ,Oita,15_ 19,1965,Showa,40,125154,61132,64022
44 ,Oita,20_ 24,1965,Showa,40,75043,29681,45362
44 ,Oita,25_ 29,1965,Showa,40,77407,34587,42820
44 ,Oita,30_ 34,1965,Showa,40,90449,42896,47553
44 ,Oita,35_ 39,1965,Showa,40,90324,43197,47127
44 ,Oita,40_ 44,1965,Showa,40,75878,33088,42790
44 ,Oita,45_ 49,1965,Showa,40,63348,27902,35446
44 ,Oita,50_ 54,1965,Showa,40,60931,27031,33900
44 ,Oita,55_ 59,1965,Showa,40,54124,25309,28815
44 ,Oita,60_ 64,1965,Showa,40,46792,22375,24417
44 ,Oita,65_ 69,1965,Showa,40,39387,18950,20437
44 ,Oita,70_ 74,1965,Showa,40,27465,12686,14779
44 ,Oita,75_ 79,1965,Showa,40,17585,7658,9927
44 ,Oita,80_ 84,1965,Showa,40,9219,3601,5618
44 ,Oita,over_85,1965,Showa,40,4657,1550,3107
44 ,Oita,total,1970,Showa,45,1155566,540541,615025
44 ,Oita,0_ 4,1970,Showa,45,83756,43000,40756
44 ,Oita,5_ 9,1970,Showa,45,90721,46269,44452
44 ,Oita,10_ 14,1970,Showa,45,105128,53340,51788
44 ,Oita,15_ 19,1970,Showa,45,103161,49808,53353
44 ,Oita,20_ 24,1970,Showa,45,88650,36217,52433
44 ,Oita,25_ 29,1970,Showa,45,75829,34314,41515
44 ,Oita,30_ 34,1970,Showa,45,78094,35999,42095
44 ,Oita,35_ 39,1970,Showa,45,89759,42781,46978
44 ,Oita,40_ 44,1970,Showa,45,88229,42220,46009
44 ,Oita,45_ 49,1970,Showa,45,73730,32136,41594
44 ,Oita,50_ 54,1970,Showa,45,61291,26921,34370
44 ,Oita,55_ 59,1970,Showa,45,57440,25338,32102
44 ,Oita,60_ 64,1970,Showa,45,49866,22995,26871
44 ,Oita,65_ 69,1970,Showa,45,41636,19474,22162
44 ,Oita,70_ 74,1970,Showa,45,32669,15105,17564
44 ,Oita,75_ 79,1970,Showa,45,19996,8737,11259
44 ,Oita,80_ 84,1970,Showa,45,10429,4159,6270
44 ,Oita,over_85,1970,Showa,45,5182,1728,3454
44 ,Oita,total,1975,Showa,50,1190314,561760,628554
44 ,Oita,0_ 4,1975,Showa,50,94606,48431,46175
44 ,Oita,5_ 9,1975,Showa,50,87741,45028,42713
44 ,Oita,10_ 14,1975,Showa,50,92265,47096,45169
44 ,Oita,15_ 19,1975,Showa,50,87683,43571,44112
44 ,Oita,20_ 24,1975,Showa,50,79103,34180,44923
44 ,Oita,25_ 29,1975,Showa,50,97084,46015,51069
44 ,Oita,30_ 34,1975,Showa,50,81613,38755,42858
44 ,Oita,35_ 39,1975,Showa,50,80561,37728,42833
44 ,Oita,40_ 44,1975,Showa,50,90186,43210,46976
44 ,Oita,45_ 49,1975,Showa,50,87576,41848,45728
44 ,Oita,50_ 54,1975,Showa,50,72223,31303,40920
44 ,Oita,55_ 59,1975,Showa,50,58995,25738,33257
44 ,Oita,60_ 64,1975,Showa,50,54854,23946,30908
44 ,Oita,65_ 69,1975,Showa,50,45847,20587,25260
44 ,Oita,70_ 74,1975,Showa,50,35676,16055,19621
44 ,Oita,75_ 79,1975,Showa,50,25102,10926,14176
44 ,Oita,80_ 84,1975,Showa,50,12754,5117,7637
44 ,Oita,over_85,1975,Showa,50,6290,2147,4143
44 ,Oita,total,1980,Showa,55,1228913,583097,645816
44 ,Oita,0_ 4,1980,Showa,55,87901,45238,42663
44 ,Oita,5_ 9,1980,Showa,55,98569,50411,48158
44 ,Oita,10_ 14,1980,Showa,55,89920,46107,43813
44 ,Oita,15_ 19,1980,Showa,55,82236,41492,40744
44 ,Oita,20_ 24,1980,Showa,55,69752,31387,38365
44 ,Oita,25_ 29,1980,Showa,55,87600,41851,45749
44 ,Oita,30_ 34,1980,Showa,55,101372,49584,51788
44 ,Oita,35_ 39,1980,Showa,55,83881,40045,43836
44 ,Oita,40_ 44,1980,Showa,55,81043,38060,42983
44 ,Oita,45_ 49,1980,Showa,55,89220,42581,46639
44 ,Oita,50_ 54,1980,Showa,55,85924,40703,45221
44 ,Oita,55_ 59,1980,Showa,55,70468,30317,40151
44 ,Oita,60_ 64,1980,Showa,55,56634,24545,32089
44 ,Oita,65_ 69,1980,Showa,55,50964,21769,29195
44 ,Oita,70_ 74,1980,Showa,55,40214,17369,22845
44 ,Oita,75_ 79,1980,Showa,55,28182,11965,16217
44 ,Oita,80_ 84,1980,Showa,55,16587,6632,9955
44 ,Oita,over_85,1980,Showa,55,8293,2941,5352
44 ,Oita,total,1985,Showa,60,1250214,593014,657200
44 ,Oita,0_ 4,1985,Showa,60,76190,39130,37060
44 ,Oita,5_ 9,1985,Showa,60,90373,46453,43920
44 ,Oita,10_ 14,1985,Showa,60,99939,51215,48724
44 ,Oita,15_ 19,1985,Showa,60,82862,42175,40687
44 ,Oita,20_ 24,1985,Showa,60,65415,29964,35451
44 ,Oita,25_ 29,1985,Showa,60,75150,35640,39510
44 ,Oita,30_ 34,1985,Showa,60,90038,44027,46011
44 ,Oita,35_ 39,1985,Showa,60,102982,50512,52470
44 ,Oita,40_ 44,1985,Showa,60,83742,40011,43731
44 ,Oita,45_ 49,1985,Showa,60,79962,37354,42608
44 ,Oita,50_ 54,1985,Showa,60,87530,41388,46142
44 ,Oita,55_ 59,1985,Showa,60,83962,39350,44612
44 ,Oita,60_ 64,1985,Showa,60,68248,29049,39199
44 ,Oita,65_ 69,1985,Showa,60,53339,22609,30730
44 ,Oita,70_ 74,1985,Showa,60,45799,18831,26968
44 ,Oita,75_ 79,1985,Showa,60,33090,13466,19624
44 ,Oita,80_ 84,1985,Showa,60,19626,7617,12009
44 ,Oita,over_85,1985,Showa,60,11892,4180,7712
44 ,Oita,total,1990,Heisei,2,1236942,584672,652270
44 ,Oita,0_ 4,1990,Heisei,2,64214,33090,31124
44 ,Oita,5_ 9,1990,Heisei,2,76747,39383,37364
44 ,Oita,10_ 14,1990,Heisei,2,90304,46365,43939
44 ,Oita,15_ 19,1990,Heisei,2,90352,46381,43971
44 ,Oita,20_ 24,1990,Heisei,2,62865,29396,33469
44 ,Oita,25_ 29,1990,Heisei,2,66087,30484,35603
44 ,Oita,30_ 34,1990,Heisei,2,75051,36114,38937
44 ,Oita,35_ 39,1990,Heisei,2,89837,44018,45819
44 ,Oita,40_ 44,1990,Heisei,2,101530,49748,51782
44 ,Oita,45_ 49,1990,Heisei,2,81957,38971,42986
44 ,Oita,50_ 54,1990,Heisei,2,78079,36104,41975
44 ,Oita,55_ 59,1990,Heisei,2,85409,39829,45580
44 ,Oita,60_ 64,1990,Heisei,2,81498,37695,43803
44 ,Oita,65_ 69,1990,Heisei,2,64575,26955,37620
44 ,Oita,70_ 74,1990,Heisei,2,48446,19944,28502
44 ,Oita,75_ 79,1990,Heisei,2,38743,15068,23675
44 ,Oita,80_ 84,1990,Heisei,2,24097,8942,15155
44 ,Oita,over_85,1990,Heisei,2,15580,5183,10397
44 ,Oita,total,1995,Heisei,7,1231306,581909,649397
44 ,Oita,0_ 4,1995,Heisei,7,57729,29650,28079
44 ,Oita,5_ 9,1995,Heisei,7,65676,33820,31856
44 ,Oita,10_ 14,1995,Heisei,7,77504,39742,37762
44 ,Oita,15_ 19,1995,Heisei,7,83244,43040,40204
44 ,Oita,20_ 24,1995,Heisei,7,73778,36166,37612
44 ,Oita,25_ 29,1995,Heisei,7,66257,31228,35029
44 ,Oita,30_ 34,1995,Heisei,7,68026,32316,35710
44 ,Oita,35_ 39,1995,Heisei,7,76537,37096,39441
44 ,Oita,40_ 44,1995,Heisei,7,90383,44458,45925
44 ,Oita,45_ 49,1995,Heisei,7,101142,49603,51539
44 ,Oita,50_ 54,1995,Heisei,7,81014,38357,42657
44 ,Oita,55_ 59,1995,Heisei,7,77219,35459,41760
44 ,Oita,60_ 64,1995,Heisei,7,83435,38608,44827
44 ,Oita,65_ 69,1995,Heisei,7,77792,35254,42538
44 ,Oita,70_ 74,1995,Heisei,7,59640,23946,35694
44 ,Oita,75_ 79,1995,Heisei,7,41575,16184,25391
44 ,Oita,80_ 84,1995,Heisei,7,29487,10371,19116
44 ,Oita,over_85,1995,Heisei,7,20582,6440,14142
44 ,Oita,total,2000,Heisei,12,1221140,575985,645155
44 ,Oita,0_ 4,2000,Heisei,12,54803,28038,26765
44 ,Oita,5_ 9,2000,Heisei,12,58607,30052,28555
44 ,Oita,10_ 14,2000,Heisei,12,66029,34083,31946
44 ,Oita,15_ 19,2000,Heisei,12,71501,36738,34763
44 ,Oita,20_ 24,2000,Heisei,12,67264,33604,33660
44 ,Oita,25_ 29,2000,Heisei,12,75872,36642,39230
44 ,Oita,30_ 34,2000,Heisei,12,67274,32001,35273
44 ,Oita,35_ 39,2000,Heisei,12,68734,32929,35805
44 ,Oita,40_ 44,2000,Heisei,12,76792,37313,39479
44 ,Oita,45_ 49,2000,Heisei,12,89502,43947,45555
44 ,Oita,50_ 54,2000,Heisei,12,100358,48948,51410
44 ,Oita,55_ 59,2000,Heisei,12,80433,37688,42745
44 ,Oita,60_ 64,2000,Heisei,12,76673,34988,41685
44 ,Oita,65_ 69,2000,Heisei,12,79938,36329,43609
44 ,Oita,70_ 74,2000,Heisei,12,71942,31677,40265
44 ,Oita,75_ 79,2000,Heisei,12,52942,20193,32749
44 ,Oita,80_ 84,2000,Heisei,12,32858,11680,21178
44 ,Oita,over_85,2000,Heisei,12,28221,8251,19970
44 ,Oita,total,2005,Heisei,17,1209571,569796,639775
44 ,Oita,0_ 4,2005,Heisei,17,50912,26191,24721
44 ,Oita,5_ 9,2005,Heisei,17,55201,28202,26999
44 ,Oita,10_ 14,2005,Heisei,17,58428,29877,28551
44 ,Oita,15_ 19,2005,Heisei,17,62183,32136,30047
44 ,Oita,20_ 24,2005,Heisei,17,60417,29821,30596
44 ,Oita,25_ 29,2005,Heisei,17,69280,34280,35000
44 ,Oita,30_ 34,2005,Heisei,17,76882,37804,39078
44 ,Oita,35_ 39,2005,Heisei,17,67579,32403,35176
44 ,Oita,40_ 44,2005,Heisei,17,68419,32710,35709
44 ,Oita,45_ 49,2005,Heisei,17,75774,36572,39202
44 ,Oita,50_ 54,2005,Heisei,17,88775,43406,45369
44 ,Oita,55_ 59,2005,Heisei,17,99462,48172,51290
44 ,Oita,60_ 64,2005,Heisei,17,80101,37374,42727
44 ,Oita,65_ 69,2005,Heisei,17,74336,33584,40752
44 ,Oita,70_ 74,2005,Heisei,17,74889,33030,41859
44 ,Oita,75_ 79,2005,Heisei,17,64074,26736,37338
44 ,Oita,80_ 84,2005,Heisei,17,43170,15064,28106
44 ,Oita,over_85,2005,Heisei,17,36336,10340,25996
44 ,Oita,total,2010,Heisei,22,1196529,564890,631639
44 ,Oita,0_ 4,2010,Heisei,22,49360,25158,24202
44 ,Oita,5_ 9,2010,Heisei,22,51253,26300,24953
44 ,Oita,10_ 14,2010,Heisei,22,55021,28132,26889
44 ,Oita,15_ 19,2010,Heisei,22,56077,28776,27301
44 ,Oita,20_ 24,2010,Heisei,22,53272,26644,26628
44 ,Oita,25_ 29,2010,Heisei,22,60977,30308,30669
44 ,Oita,30_ 34,2010,Heisei,22,70890,35584,35306
44 ,Oita,35_ 39,2010,Heisei,22,77835,38673,39162
44 ,Oita,40_ 44,2010,Heisei,22,67834,32789,35045
44 ,Oita,45_ 49,2010,Heisei,22,67856,32583,35273
44 ,Oita,50_ 54,2010,Heisei,22,75356,36355,39001
44 ,Oita,55_ 59,2010,Heisei,22,88168,42885,45283
44 ,Oita,60_ 64,2010,Heisei,22,99054,47757,51297
44 ,Oita,65_ 69,2010,Heisei,22,77706,35815,41891
44 ,Oita,70_ 74,2010,Heisei,22,70074,30888,39186
44 ,Oita,75_ 79,2010,Heisei,22,67452,28395,39057
44 ,Oita,80_ 84,2010,Heisei,22,53373,20347,33026
44 ,Oita,over_85,2010,Heisei,22,48145,13345,34800
44 ,Oita,total,2015,Heisei,27,1166338,551932,614406
44 ,Oita,0_ 4,2015,Heisei,27,45798,23422,22376
44 ,Oita,5_ 9,2015,Heisei,27,49560,25268,24292
44 ,Oita,10_ 14,2015,Heisei,27,51055,26214,24841
44 ,Oita,15_ 19,2015,Heisei,27,53587,27267,26320
44 ,Oita,20_ 24,2015,Heisei,27,46785,23789,22996
44 ,Oita,25_ 29,2015,Heisei,27,52372,26594,25778
44 ,Oita,30_ 34,2015,Heisei,27,60742,30316,30426
44 ,Oita,35_ 39,2015,Heisei,27,70697,35422,35275
44 ,Oita,40_ 44,2015,Heisei,27,77300,38228,39072
44 ,Oita,45_ 49,2015,Heisei,27,67032,32487,34545
44 ,Oita,50_ 54,2015,Heisei,27,67039,32229,34810
44 ,Oita,55_ 59,2015,Heisei,27,74461,35763,38698
44 ,Oita,60_ 64,2015,Heisei,27,87154,42220,44934
44 ,Oita,65_ 69,2015,Heisei,27,96368,45988,50380
44 ,Oita,70_ 74,2015,Heisei,27,73480,33180,40300
44 ,Oita,75_ 79,2015,Heisei,27,63814,27022,36792
44 ,Oita,80_ 84,2015,Heisei,27,56765,22247,34518
44 ,Oita,over_85,2015,Heisei,27,61318,17992,43326
45 ,Miyazaki,total,1920,Taisho,9,651097,326610,324487
45 ,Miyazaki,0_ 4,1920,Taisho,9,90972,45628,45344
45 ,Miyazaki,5_ 9,1920,Taisho,9,80970,40756,40214
45 ,Miyazaki,10_ 14,1920,Taisho,9,69843,35574,34269
45 ,Miyazaki,15_ 19,1920,Taisho,9,58607,29494,29113
45 ,Miyazaki,20_ 24,1920,Taisho,9,50352,24530,25822
45 ,Miyazaki,25_ 29,1920,Taisho,9,44842,22218,22624
45 ,Miyazaki,30_ 34,1920,Taisho,9,40664,20239,20425
45 ,Miyazaki,35_ 39,1920,Taisho,9,36599,18359,18240
45 ,Miyazaki,40_ 44,1920,Taisho,9,36883,18745,18138
45 ,Miyazaki,45_ 49,1920,Taisho,9,33106,16824,16282
45 ,Miyazaki,50_ 54,1920,Taisho,9,28976,14893,14083
45 ,Miyazaki,55_ 59,1920,Taisho,9,23806,12144,11662
45 ,Miyazaki,60_ 64,1920,Taisho,9,19351,9999,9352
45 ,Miyazaki,65_ 69,1920,Taisho,9,14808,7375,7433
45 ,Miyazaki,70_ 74,1920,Taisho,9,11430,5448,5982
45 ,Miyazaki,75_ 79,1920,Taisho,9,6251,2854,3397
45 ,Miyazaki,over_80,1920,Taisho,9,3637,1530,2107
45 ,Miyazaki,total,1925,Taisho,14,691094,348088,343006
45 ,Miyazaki,0_ 4,1925,Taisho,14,100096,50177,49919
45 ,Miyazaki,5_ 9,1925,Taisho,14,85251,42867,42384
45 ,Miyazaki,10_ 14,1925,Taisho,14,77516,39795,37721
45 ,Miyazaki,15_ 19,1925,Taisho,14,62168,32427,29741
45 ,Miyazaki,20_ 24,1925,Taisho,14,52011,25941,26070
45 ,Miyazaki,25_ 29,1925,Taisho,14,48291,23950,24341
45 ,Miyazaki,30_ 34,1925,Taisho,14,42667,21460,21207
45 ,Miyazaki,35_ 39,1925,Taisho,14,39073,19594,19479
45 ,Miyazaki,40_ 44,1925,Taisho,14,34712,17539,17173
45 ,Miyazaki,45_ 49,1925,Taisho,14,34944,17716,17228
45 ,Miyazaki,50_ 54,1925,Taisho,14,30409,15369,15040
45 ,Miyazaki,55_ 59,1925,Taisho,14,26042,13230,12812
45 ,Miyazaki,60_ 64,1925,Taisho,14,20545,10344,10201
45 ,Miyazaki,65_ 69,1925,Taisho,14,15649,7783,7866
45 ,Miyazaki,70_ 74,1925,Taisho,14,10742,5113,5629
45 ,Miyazaki,75_ 79,1925,Taisho,14,6911,3090,3821
45 ,Miyazaki,80_ 84,1925,Taisho,14,3009,1285,1724
45 ,Miyazaki,over_85,1925,Taisho,14,1058,408,650
45 ,Miyazaki,total,1930,Showa,5,760467,383128,377339
45 ,Miyazaki,0_ 4,1930,Showa,5,113783,57363,56420
45 ,Miyazaki,5_ 9,1930,Showa,5,96284,48424,47860
45 ,Miyazaki,10_ 14,1930,Showa,5,83210,42137,41073
45 ,Miyazaki,15_ 19,1930,Showa,5,71595,37166,34429
45 ,Miyazaki,20_ 24,1930,Showa,5,57622,28763,28859
45 ,Miyazaki,25_ 29,1930,Showa,5,52042,26298,25744
45 ,Miyazaki,30_ 34,1930,Showa,5,48458,24410,24048
45 ,Miyazaki,35_ 39,1930,Showa,5,42671,21759,20912
45 ,Miyazaki,40_ 44,1930,Showa,5,37856,19296,18560
45 ,Miyazaki,45_ 49,1930,Showa,5,33374,16897,16477
45 ,Miyazaki,50_ 54,1930,Showa,5,32701,16581,16120
45 ,Miyazaki,55_ 59,1930,Showa,5,27961,13988,13973
45 ,Miyazaki,60_ 64,1930,Showa,5,22924,11369,11555
45 ,Miyazaki,65_ 69,1930,Showa,5,16883,8249,8634
45 ,Miyazaki,70_ 74,1930,Showa,5,11546,5480,6066
45 ,Miyazaki,75_ 79,1930,Showa,5,6771,3052,3719
45 ,Miyazaki,over_80,1930,Showa,5,4786,1896,2890
45 ,Miyazaki,total,1935,Showa,10,824431,416082,408349
45 ,Miyazaki,0_ 4,1935,Showa,10,120719,60567,60152
45 ,Miyazaki,5_ 9,1935,Showa,10,109800,55429,54371
45 ,Miyazaki,10_ 14,1935,Showa,10,93430,47978,45452
45 ,Miyazaki,15_ 19,1935,Showa,10,74378,38705,35673
45 ,Miyazaki,20_ 24,1935,Showa,10,63807,32024,31783
45 ,Miyazaki,25_ 29,1935,Showa,10,56178,28401,27777
45 ,Miyazaki,30_ 34,1935,Showa,10,51248,26015,25233
45 ,Miyazaki,35_ 39,1935,Showa,10,47514,24184,23330
45 ,Miyazaki,40_ 44,1935,Showa,10,41345,21252,20093
45 ,Miyazaki,45_ 49,1935,Showa,10,36429,18607,17822
45 ,Miyazaki,50_ 54,1935,Showa,10,31250,15797,15453
45 ,Miyazaki,55_ 59,1935,Showa,10,30192,15115,15077
45 ,Miyazaki,60_ 64,1935,Showa,10,24583,11960,12623
45 ,Miyazaki,65_ 69,1935,Showa,10,18782,9026,9756
45 ,Miyazaki,70_ 74,1935,Showa,10,12717,5868,6849
45 ,Miyazaki,75_ 79,1935,Showa,10,7237,3265,3972
45 ,Miyazaki,over_80,1935,Showa,10,4822,1889,2933
45 ,Miyazaki,total,1940,Showa,15,840187,417053,423134
45 ,Miyazaki,0_ 4,1940,Showa,15,113697,57243,56454
45 ,Miyazaki,5_ 9,1940,Showa,15,112182,56277,55905
45 ,Miyazaki,10_ 14,1940,Showa,15,103459,52345,51114
45 ,Miyazaki,15_ 19,1940,Showa,15,77400,37210,40190
45 ,Miyazaki,20_ 24,1940,Showa,15,63210,31860,31350
45 ,Miyazaki,25_ 29,1940,Showa,15,55317,27223,28094
45 ,Miyazaki,30_ 34,1940,Showa,15,50081,24638,25443
45 ,Miyazaki,35_ 39,1940,Showa,15,47293,23499,23794
45 ,Miyazaki,40_ 44,1940,Showa,15,44152,22296,21856
45 ,Miyazaki,45_ 49,1940,Showa,15,38502,19518,18984
45 ,Miyazaki,50_ 54,1940,Showa,15,33673,17062,16611
45 ,Miyazaki,55_ 59,1940,Showa,15,28300,14043,14257
45 ,Miyazaki,60_ 64,1940,Showa,15,26270,12799,13471
45 ,Miyazaki,65_ 69,1940,Showa,15,19894,9362,10532
45 ,Miyazaki,70_ 74,1940,Showa,15,13951,6313,7638
45 ,Miyazaki,75_ 79,1940,Showa,15,7797,3389,4408
45 ,Miyazaki,80_ 84,1940,Showa,15,3526,1425,2101
45 ,Miyazaki,over_85,1940,Showa,15,1483,551,932
45 ,Miyazaki,total,1945,Showa,20,913687,426201,487486
45 ,Miyazaki,1_ 5,1945,Showa,20,121124,61384,59740
45 ,Miyazaki,6_ 10,1945,Showa,20,118874,59944,58930
45 ,Miyazaki,11_ 15,1945,Showa,20,120224,60510,59714
45 ,Miyazaki,16_ 20,1945,Showa,20,100510,48274,52236
45 ,Miyazaki,21_ 25,1945,Showa,20,66495,23309,43186
45 ,Miyazaki,26_ 30,1945,Showa,20,52265,18162,34103
45 ,Miyazaki,31_ 35,1945,Showa,20,49522,18642,30880
45 ,Miyazaki,36_ 40,1945,Showa,20,48537,21046,27491
45 ,Miyazaki,41_ 45,1945,Showa,20,47680,23495,24185
45 ,Miyazaki,46_ 50,1945,Showa,20,43958,22063,21895
45 ,Miyazaki,51_ 55,1945,Showa,20,37094,18856,18238
45 ,Miyazaki,56_ 60,1945,Showa,20,31730,15850,15880
45 ,Miyazaki,61_ 65,1945,Showa,20,25371,12219,13152
45 ,Miyazaki,66_ 70,1945,Showa,20,21634,10150,11484
45 ,Miyazaki,71_ 75,1945,Showa,20,14946,6704,8242
45 ,Miyazaki,76_ 80,1945,Showa,20,8540,3586,4954
45 ,Miyazaki,81_ 85,1945,Showa,20,3824,1520,2304
45 ,Miyazaki,86以上,1945,Showa,20,1359,487,872
45 ,Miyazaki,total,1950,Showa,25,1091427,535107,556320
45 ,Miyazaki,0_ 4,1950,Showa,25,162894,82585,80309
45 ,Miyazaki,5_ 9,1950,Showa,25,129083,65460,63623
45 ,Miyazaki,10_ 14,1950,Showa,25,121931,61565,60366
45 ,Miyazaki,15_ 19,1950,Showa,25,114251,58400,55851
45 ,Miyazaki,20_ 24,1950,Showa,25,98069,48006,50063
45 ,Miyazaki,25_ 29,1950,Showa,25,77015,34447,42568
45 ,Miyazaki,30_ 34,1950,Showa,25,65322,29390,35932
45 ,Miyazaki,35_ 39,1950,Showa,25,60514,27748,32766
45 ,Miyazaki,40_ 44,1950,Showa,25,53587,25817,27770
45 ,Miyazaki,45_ 49,1950,Showa,25,48619,24434,24185
45 ,Miyazaki,50_ 54,1950,Showa,25,42703,21609,21094
45 ,Miyazaki,55_ 59,1950,Showa,25,35287,17752,17535
45 ,Miyazaki,60_ 64,1950,Showa,25,28653,14118,14535
45 ,Miyazaki,65_ 69,1950,Showa,25,21131,9985,11146
45 ,Miyazaki,70_ 74,1950,Showa,25,16700,7508,9192
45 ,Miyazaki,75_ 79,1950,Showa,25,9738,4123,5615
45 ,Miyazaki,over_80,1950,Showa,25,5904,2150,3754
45 ,Miyazaki,total,1955,Showa,30,1139384,559771,579613
45 ,Miyazaki,0_ 4,1955,Showa,30,141565,72243,69322
45 ,Miyazaki,5_ 9,1955,Showa,30,155547,78958,76589
45 ,Miyazaki,10_ 14,1955,Showa,30,126135,63873,62262
45 ,Miyazaki,15_ 19,1955,Showa,30,104326,54848,49478
45 ,Miyazaki,20_ 24,1955,Showa,30,98064,47907,50157
45 ,Miyazaki,25_ 29,1955,Showa,30,92470,45140,47330
45 ,Miyazaki,30_ 34,1955,Showa,30,73546,32951,40595
45 ,Miyazaki,35_ 39,1955,Showa,30,62276,27855,34421
45 ,Miyazaki,40_ 44,1955,Showa,30,57566,26366,31200
45 ,Miyazaki,45_ 49,1955,Showa,30,50979,24330,26649
45 ,Miyazaki,50_ 54,1955,Showa,30,45934,22974,22960
45 ,Miyazaki,55_ 59,1955,Showa,30,39797,19977,19820
45 ,Miyazaki,60_ 64,1955,Showa,30,31748,15687,16061
45 ,Miyazaki,65_ 69,1955,Showa,30,24097,11571,12526
45 ,Miyazaki,70_ 74,1955,Showa,30,16407,7425,8982
45 ,Miyazaki,75_ 79,1955,Showa,30,11463,4872,6591
45 ,Miyazaki,80_ 84,1955,Showa,30,5275,2061,3214
45 ,Miyazaki,over_85,1955,Showa,30,2183,730,1453
45 ,Miyazaki,total,1960,Showa,35,1134590,552285,582305
45 ,Miyazaki,0_ 4,1960,Showa,35,113215,57521,55694
45 ,Miyazaki,5_ 9,1960,Showa,35,139183,70921,68262
45 ,Miyazaki,10_ 14,1960,Showa,35,153552,77983,75569
45 ,Miyazaki,15_ 19,1960,Showa,35,85545,44953,40592
45 ,Miyazaki,20_ 24,1960,Showa,35,80752,37530,43222
45 ,Miyazaki,25_ 29,1960,Showa,35,91754,43795,47959
45 ,Miyazaki,30_ 34,1960,Showa,35,88517,43210,45307
45 ,Miyazaki,35_ 39,1960,Showa,35,71209,31699,39510
45 ,Miyazaki,40_ 44,1960,Showa,35,60449,26995,33454
45 ,Miyazaki,45_ 49,1960,Showa,35,55248,25136,30112
45 ,Miyazaki,50_ 54,1960,Showa,35,48410,22961,25449
45 ,Miyazaki,55_ 59,1960,Showa,35,42841,21159,21682
45 ,Miyazaki,60_ 64,1960,Showa,35,36298,17905,18393
45 ,Miyazaki,65_ 69,1960,Showa,35,27280,13150,14130
45 ,Miyazaki,70_ 74,1960,Showa,35,19353,8921,10432
45 ,Miyazaki,75_ 79,1960,Showa,35,11493,4910,6583
45 ,Miyazaki,80_ 84,1960,Showa,35,6712,2580,4132
45 ,Miyazaki,over_85,1960,Showa,35,2779,956,1823
45 ,Miyazaki,total,1965,Showa,40,1080692,517235,563457
45 ,Miyazaki,0_ 4,1965,Showa,40,91708,46649,45059
45 ,Miyazaki,5_ 9,1965,Showa,40,108712,54819,53893
45 ,Miyazaki,10_ 14,1965,Showa,40,134636,68392,66244
45 ,Miyazaki,15_ 19,1965,Showa,40,103085,53178,49907
45 ,Miyazaki,20_ 24,1965,Showa,40,64248,27747,36501
45 ,Miyazaki,25_ 29,1965,Showa,40,74038,33623,40415
45 ,Miyazaki,30_ 34,1965,Showa,40,84982,40684,44298
45 ,Miyazaki,35_ 39,1965,Showa,40,83349,40209,43140
45 ,Miyazaki,40_ 44,1965,Showa,40,66950,29280,37670
45 ,Miyazaki,45_ 49,1965,Showa,40,56808,24983,31825
45 ,Miyazaki,50_ 54,1965,Showa,40,51641,23161,28480
45 ,Miyazaki,55_ 59,1965,Showa,40,44818,20970,23848
45 ,Miyazaki,60_ 64,1965,Showa,40,38737,18800,19937
45 ,Miyazaki,65_ 69,1965,Showa,40,31457,15071,16386
45 ,Miyazaki,70_ 74,1965,Showa,40,22006,10129,11877
45 ,Miyazaki,75_ 79,1965,Showa,40,13449,5814,7635
45 ,Miyazaki,80_ 84,1965,Showa,40,6564,2537,4027
45 ,Miyazaki,over_85,1965,Showa,40,3504,1189,2315
45 ,Miyazaki,total,1970,Showa,45,1051105,498065,553040
45 ,Miyazaki,0_ 4,1970,Showa,45,81380,41624,39756
45 ,Miyazaki,5_ 9,1970,Showa,45,90555,46204,44351
45 ,Miyazaki,10_ 14,1970,Showa,45,106307,53793,52514
45 ,Miyazaki,15_ 19,1970,Showa,45,93664,47629,46035
45 ,Miyazaki,20_ 24,1970,Showa,45,78964,34434,44530
45 ,Miyazaki,25_ 29,1970,Showa,45,67624,31199,36425
45 ,Miyazaki,30_ 34,1970,Showa,45,73312,34197,39115
45 ,Miyazaki,35_ 39,1970,Showa,45,82962,39687,43275
45 ,Miyazaki,40_ 44,1970,Showa,45,79686,38136,41550
45 ,Miyazaki,45_ 49,1970,Showa,45,64502,27947,36555
45 ,Miyazaki,50_ 54,1970,Showa,45,54242,23628,30614
45 ,Miyazaki,55_ 59,1970,Showa,45,48039,21243,26796
45 ,Miyazaki,60_ 64,1970,Showa,45,41096,18782,22314
45 ,Miyazaki,65_ 69,1970,Showa,45,34542,16197,18345
45 ,Miyazaki,70_ 74,1970,Showa,45,26314,12008,14306
45 ,Miyazaki,75_ 79,1970,Showa,45,16041,6902,9139
45 ,Miyazaki,80_ 84,1970,Showa,45,8117,3187,4930
45 ,Miyazaki,over_85,1970,Showa,45,3758,1268,2490
45 ,Miyazaki,total,1975,Showa,50,1085055,515236,569819
45 ,Miyazaki,0_ 4,1975,Showa,50,91002,46610,44392
45 ,Miyazaki,5_ 9,1975,Showa,50,83972,42909,41063
45 ,Miyazaki,10_ 14,1975,Showa,50,91013,46375,44638
45 ,Miyazaki,15_ 19,1975,Showa,50,82444,41583,40861
45 ,Miyazaki,20_ 24,1975,Showa,50,75245,33571,41674
45 ,Miyazaki,25_ 29,1975,Showa,50,88945,42814,46131
45 ,Miyazaki,30_ 34,1975,Showa,50,71637,34398,37239
45 ,Miyazaki,35_ 39,1975,Showa,50,74846,35285,39561
45 ,Miyazaki,40_ 44,1975,Showa,50,82750,39622,43128
45 ,Miyazaki,45_ 49,1975,Showa,50,78970,37743,41227
45 ,Miyazaki,50_ 54,1975,Showa,50,62659,27053,35606
45 ,Miyazaki,55_ 59,1975,Showa,50,52291,22648,29643
45 ,Miyazaki,60_ 64,1975,Showa,50,46290,20182,26108
45 ,Miyazaki,65_ 69,1975,Showa,50,37712,16684,21028
45 ,Miyazaki,70_ 74,1975,Showa,50,29724,13328,16396
45 ,Miyazaki,75_ 79,1975,Showa,50,20270,8663,11607
45 ,Miyazaki,80_ 84,1975,Showa,50,10340,4062,6278
45 ,Miyazaki,over_85,1975,Showa,50,4877,1665,3212
45 ,Miyazaki,total,1980,Showa,55,1151587,550207,601380
45 ,Miyazaki,0_ 4,1980,Showa,55,90220,46332,43888
45 ,Miyazaki,5_ 9,1980,Showa,55,96612,49354,47258
45 ,Miyazaki,10_ 14,1980,Showa,55,86934,44448,42486
45 ,Miyazaki,15_ 19,1980,Showa,55,77586,39438,38148
45 ,Miyazaki,20_ 24,1980,Showa,55,69473,31655,37818
45 ,Miyazaki,25_ 29,1980,Showa,55,89667,43677,45990
45 ,Miyazaki,30_ 34,1980,Showa,55,96463,47955,48508
45 ,Miyazaki,35_ 39,1980,Showa,55,75145,36393,38752
45 ,Miyazaki,40_ 44,1980,Showa,55,76068,36062,40006
45 ,Miyazaki,45_ 49,1980,Showa,55,82605,39633,42972
45 ,Miyazaki,50_ 54,1980,Showa,55,78164,37089,41075
45 ,Miyazaki,55_ 59,1980,Showa,55,61456,26335,35121
45 ,Miyazaki,60_ 64,1980,Showa,55,50447,21621,28826
45 ,Miyazaki,65_ 69,1980,Showa,55,43144,18404,24740
45 ,Miyazaki,70_ 74,1980,Showa,55,33327,14069,19258
45 ,Miyazaki,75_ 79,1980,Showa,55,23713,9946,13767
45 ,Miyazaki,80_ 84,1980,Showa,55,13587,5362,8225
45 ,Miyazaki,over_85,1980,Showa,55,6867,2372,4495
45 ,Miyazaki,total,1985,Showa,60,1175543,558355,617188
45 ,Miyazaki,0_ 4,1985,Showa,60,80629,41060,39569
45 ,Miyazaki,5_ 9,1985,Showa,60,91668,47186,44482
45 ,Miyazaki,10_ 14,1985,Showa,60,97787,49939,47848
45 ,Miyazaki,15_ 19,1985,Showa,60,75329,37834,37495
45 ,Miyazaki,20_ 24,1985,Showa,60,59500,26661,32839
45 ,Miyazaki,25_ 29,1985,Showa,60,76702,36406,40296
45 ,Miyazaki,30_ 34,1985,Showa,60,90843,44783,46060
45 ,Miyazaki,35_ 39,1985,Showa,60,96671,47862,48809
45 ,Miyazaki,40_ 44,1985,Showa,60,74627,35910,38717
45 ,Miyazaki,45_ 49,1985,Showa,60,74748,35209,39539
45 ,Miyazaki,50_ 54,1985,Showa,60,80871,38350,42521
45 ,Miyazaki,55_ 59,1985,Showa,60,76084,35636,40448
45 ,Miyazaki,60_ 64,1985,Showa,60,59242,25069,34173
45 ,Miyazaki,65_ 69,1985,Showa,60,47515,19879,27636
45 ,Miyazaki,70_ 74,1985,Showa,60,38863,15860,23003
45 ,Miyazaki,75_ 79,1985,Showa,60,27440,10809,16631
45 ,Miyazaki,80_ 84,1985,Showa,60,16963,6472,10491
45 ,Miyazaki,over_85,1985,Showa,60,9966,3373,6593
45 ,Miyazaki,total,1990,Heisei,2,1168907,551524,617383
45 ,Miyazaki,0_ 4,1990,Heisei,2,67423,34330,33093
45 ,Miyazaki,5_ 9,1990,Heisei,2,81034,41265,39769
45 ,Miyazaki,10_ 14,1990,Heisei,2,91281,46869,44412
45 ,Miyazaki,15_ 19,1990,Heisei,2,83882,42300,41582
45 ,Miyazaki,20_ 24,1990,Heisei,2,54231,24246,29985
45 ,Miyazaki,25_ 29,1990,Heisei,2,64134,29586,34548
45 ,Miyazaki,30_ 34,1990,Heisei,2,76301,36655,39646
45 ,Miyazaki,35_ 39,1990,Heisei,2,89903,44218,45685
45 ,Miyazaki,40_ 44,1990,Heisei,2,95112,46881,48231
45 ,Miyazaki,45_ 49,1990,Heisei,2,72488,34615,37873
45 ,Miyazaki,50_ 54,1990,Heisei,2,72871,34015,38856
45 ,Miyazaki,55_ 59,1990,Heisei,2,78711,36869,41842
45 ,Miyazaki,60_ 64,1990,Heisei,2,73735,34062,39673
45 ,Miyazaki,65_ 69,1990,Heisei,2,56248,23244,33004
45 ,Miyazaki,70_ 74,1990,Heisei,2,43224,17431,25793
45 ,Miyazaki,75_ 79,1990,Heisei,2,32813,12543,20270
45 ,Miyazaki,80_ 84,1990,Heisei,2,20377,7240,13137
45 ,Miyazaki,over_85,1990,Heisei,2,13877,4419,9458
45 ,Miyazaki,total,1995,Heisei,7,1175819,556245,619574
45 ,Miyazaki,0_ 4,1995,Heisei,7,59943,30722,29221
45 ,Miyazaki,5_ 9,1995,Heisei,7,69195,35248,33947
45 ,Miyazaki,10_ 14,1995,Heisei,7,81668,41533,40135
45 ,Miyazaki,15_ 19,1995,Heisei,7,81103,41532,39571
45 ,Miyazaki,20_ 24,1995,Heisei,7,66255,32351,33904
45 ,Miyazaki,25_ 29,1995,Heisei,7,61169,28445,32724
45 ,Miyazaki,30_ 34,1995,Heisei,7,67120,31923,35197
45 ,Miyazaki,35_ 39,1995,Heisei,7,78078,37956,40122
45 ,Miyazaki,40_ 44,1995,Heisei,7,90732,44909,45823
45 ,Miyazaki,45_ 49,1995,Heisei,7,94532,46690,47842
45 ,Miyazaki,50_ 54,1995,Heisei,7,71860,34293,37567
45 ,Miyazaki,55_ 59,1995,Heisei,7,72289,33549,38740
45 ,Miyazaki,60_ 64,1995,Heisei,7,77613,36021,41592
45 ,Miyazaki,65_ 69,1995,Heisei,7,70741,31981,38760
45 ,Miyazaki,70_ 74,1995,Heisei,7,52058,20732,31326
45 ,Miyazaki,75_ 79,1995,Heisei,7,37396,14182,23214
45 ,Miyazaki,80_ 84,1995,Heisei,7,25357,8726,16631
45 ,Miyazaki,over_85,1995,Heisei,7,18670,5431,13239
45 ,Miyazaki,total,2000,Heisei,12,1170007,552160,617847
45 ,Miyazaki,0_ 4,2000,Heisei,12,56149,28889,27260
45 ,Miyazaki,5_ 9,2000,Heisei,12,61334,31480,29854
45 ,Miyazaki,10_ 14,2000,Heisei,12,69948,35623,34325
45 ,Miyazaki,15_ 19,2000,Heisei,12,72845,36890,35955
45 ,Miyazaki,20_ 24,2000,Heisei,12,62019,30493,31526
45 ,Miyazaki,25_ 29,2000,Heisei,12,70025,33865,36160
45 ,Miyazaki,30_ 34,2000,Heisei,12,62940,29841,33099
45 ,Miyazaki,35_ 39,2000,Heisei,12,68349,32672,35677
45 ,Miyazaki,40_ 44,2000,Heisei,12,78214,37993,40221
45 ,Miyazaki,45_ 49,2000,Heisei,12,89791,44401,45390
45 ,Miyazaki,50_ 54,2000,Heisei,12,93329,45923,47406
45 ,Miyazaki,55_ 59,2000,Heisei,12,71077,33593,37484
45 ,Miyazaki,60_ 64,2000,Heisei,12,71812,33040,38772
45 ,Miyazaki,65_ 69,2000,Heisei,12,74622,34044,40578
45 ,Miyazaki,70_ 74,2000,Heisei,12,65753,28742,37011
45 ,Miyazaki,75_ 79,2000,Heisei,12,46028,17181,28847
45 ,Miyazaki,80_ 84,2000,Heisei,12,29824,10248,19576
45 ,Miyazaki,over_85,2000,Heisei,12,25527,6972,18555
45 ,Miyazaki,total,2005,Heisei,17,1153042,542113,610929
45 ,Miyazaki,0_ 4,2005,Heisei,17,51322,26276,25046
45 ,Miyazaki,5_ 9,2005,Heisei,17,56720,29204,27516
45 ,Miyazaki,10_ 14,2005,Heisei,17,61033,31362,29671
45 ,Miyazaki,15_ 19,2005,Heisei,17,62665,31587,31078
45 ,Miyazaki,20_ 24,2005,Heisei,17,55672,26912,28760
45 ,Miyazaki,25_ 29,2005,Heisei,17,64279,31351,32928
45 ,Miyazaki,30_ 34,2005,Heisei,17,70380,34099,36281
45 ,Miyazaki,35_ 39,2005,Heisei,17,62648,29715,32933
45 ,Miyazaki,40_ 44,2005,Heisei,17,67778,32358,35420
45 ,Miyazaki,45_ 49,2005,Heisei,17,76934,37169,39765
45 ,Miyazaki,50_ 54,2005,Heisei,17,88713,43697,45016
45 ,Miyazaki,55_ 59,2005,Heisei,17,92452,45160,47292
45 ,Miyazaki,60_ 64,2005,Heisei,17,71006,33453,37553
45 ,Miyazaki,65_ 69,2005,Heisei,17,69726,31791,37935
45 ,Miyazaki,70_ 74,2005,Heisei,17,70261,31158,39103
45 ,Miyazaki,75_ 79,2005,Heisei,17,58834,24374,34460
45 ,Miyazaki,80_ 84,2005,Heisei,17,38029,12989,25040
45 ,Miyazaki,over_85,2005,Heisei,17,33736,8974,24762
45 ,Miyazaki,total,2010,Heisei,22,1135233,533035,602198
45 ,Miyazaki,0_ 4,2010,Heisei,22,49977,25507,24470
45 ,Miyazaki,5_ 9,2010,Heisei,22,51900,26599,25301
45 ,Miyazaki,10_ 14,2010,Heisei,22,56711,29158,27553
45 ,Miyazaki,15_ 19,2010,Heisei,22,55543,28276,27267
45 ,Miyazaki,20_ 24,2010,Heisei,22,46827,22348,24479
45 ,Miyazaki,25_ 29,2010,Heisei,22,56767,27414,29353
45 ,Miyazaki,30_ 34,2010,Heisei,22,65697,32152,33545
45 ,Miyazaki,35_ 39,2010,Heisei,22,70746,34457,36289
45 ,Miyazaki,40_ 44,2010,Heisei,22,62734,29885,32849
45 ,Miyazaki,45_ 49,2010,Heisei,22,67238,32158,35080
45 ,Miyazaki,50_ 54,2010,Heisei,22,76110,36758,39352
45 ,Miyazaki,55_ 59,2010,Heisei,22,87558,42835,44723
45 ,Miyazaki,60_ 64,2010,Heisei,22,91634,44418,47216
45 ,Miyazaki,65_ 69,2010,Heisei,22,68865,32026,36839
45 ,Miyazaki,70_ 74,2010,Heisei,22,65826,29349,36477
45 ,Miyazaki,75_ 79,2010,Heisei,22,63443,26849,36594
45 ,Miyazaki,80_ 84,2010,Heisei,22,48944,18601,30343
45 ,Miyazaki,over_85,2010,Heisei,22,44223,11635,32588
45 ,Miyazaki,total,2015,Heisei,27,1104069,519242,584827
45 ,Miyazaki,0_ 4,2015,Heisei,27,47196,23964,23232
45 ,Miyazaki,5_ 9,2015,Heisei,27,50583,25826,24757
45 ,Miyazaki,10_ 14,2015,Heisei,27,51829,26528,25301
45 ,Miyazaki,15_ 19,2015,Heisei,27,52298,26533,25765
45 ,Miyazaki,20_ 24,2015,Heisei,27,41007,20610,20397
45 ,Miyazaki,25_ 29,2015,Heisei,27,47064,22767,24297
45 ,Miyazaki,30_ 34,2015,Heisei,27,57378,27733,29645
45 ,Miyazaki,35_ 39,2015,Heisei,27,65550,32064,33486
45 ,Miyazaki,40_ 44,2015,Heisei,27,70268,34258,36010
45 ,Miyazaki,45_ 49,2015,Heisei,27,61711,29492,32219
45 ,Miyazaki,50_ 54,2015,Heisei,27,66243,31708,34535
45 ,Miyazaki,55_ 59,2015,Heisei,27,74784,35947,38837
45 ,Miyazaki,60_ 64,2015,Heisei,27,86241,41858,44383
45 ,Miyazaki,65_ 69,2015,Heisei,27,88745,42552,46193
45 ,Miyazaki,70_ 74,2015,Heisei,27,64932,29534,35398
45 ,Miyazaki,75_ 79,2015,Heisei,27,59608,25583,34025
45 ,Miyazaki,80_ 84,2015,Heisei,27,53430,21101,32329
45 ,Miyazaki,over_85,2015,Heisei,27,56260,16191,40069
46 ,Kagoshima,total,1920,Taisho,9,1415582,682243,733339
46 ,Kagoshima,0_ 4,1920,Taisho,9,205843,103039,102804
46 ,Kagoshima,5_ 9,1920,Taisho,9,185709,93591,92118
46 ,Kagoshima,10_ 14,1920,Taisho,9,164114,83351,80763
46 ,Kagoshima,15_ 19,1920,Taisho,9,125171,60791,64380
46 ,Kagoshima,20_ 24,1920,Taisho,9,99892,44620,55272
46 ,Kagoshima,25_ 29,1920,Taisho,9,91638,42535,49103
46 ,Kagoshima,30_ 34,1920,Taisho,9,83916,38981,44935
46 ,Kagoshima,35_ 39,1920,Taisho,9,80993,37914,43079
46 ,Kagoshima,40_ 44,1920,Taisho,9,81683,38947,42736
46 ,Kagoshima,45_ 49,1920,Taisho,9,73533,35724,37809
46 ,Kagoshima,50_ 54,1920,Taisho,9,59877,29119,30758
46 ,Kagoshima,55_ 59,1920,Taisho,9,47176,22766,24410
46 ,Kagoshima,60_ 64,1920,Taisho,9,39075,18242,20833
46 ,Kagoshima,65_ 69,1920,Taisho,9,31746,14333,17413
46 ,Kagoshima,70_ 74,1920,Taisho,9,24485,10421,14064
46 ,Kagoshima,75_ 79,1920,Taisho,9,12773,5036,7737
46 ,Kagoshima,over_80,1920,Taisho,9,7958,2833,5125
46 ,Kagoshima,total,1925,Taisho,14,1472193,713702,758491
46 ,Kagoshima,0_ 4,1925,Taisho,14,216858,108787,108071
46 ,Kagoshima,5_ 9,1925,Taisho,14,191812,96286,95526
46 ,Kagoshima,10_ 14,1925,Taisho,14,177271,91242,86029
46 ,Kagoshima,15_ 19,1925,Taisho,14,129573,66247,63326
46 ,Kagoshima,20_ 24,1925,Taisho,14,99537,45288,54249
46 ,Kagoshima,25_ 29,1925,Taisho,14,93018,42719,50299
46 ,Kagoshima,30_ 34,1925,Taisho,14,86196,40450,45746
46 ,Kagoshima,35_ 39,1925,Taisho,14,80430,37453,42977
46 ,Kagoshima,40_ 44,1925,Taisho,14,75970,35923,40047
46 ,Kagoshima,45_ 49,1925,Taisho,14,77469,36822,40647
46 ,Kagoshima,50_ 54,1925,Taisho,14,68360,33135,35225
46 ,Kagoshima,55_ 59,1925,Taisho,14,53813,25946,27867
46 ,Kagoshima,60_ 64,1925,Taisho,14,41569,19597,21972
46 ,Kagoshima,65_ 69,1925,Taisho,14,31633,14249,17384
46 ,Kagoshima,70_ 74,1925,Taisho,14,23716,10116,13600
46 ,Kagoshima,75_ 79,1925,Taisho,14,15527,6102,9425
46 ,Kagoshima,80_ 84,1925,Taisho,14,6697,2434,4263
46 ,Kagoshima,over_85,1925,Taisho,14,2744,906,1838
46 ,Kagoshima,total,1930,Showa,5,1556690,753644,803046
46 ,Kagoshima,0_ 4,1930,Showa,5,231387,116280,115107
46 ,Kagoshima,5_ 9,1930,Showa,5,208733,104784,103949
46 ,Kagoshima,10_ 14,1930,Showa,5,183804,93447,90357
46 ,Kagoshima,15_ 19,1930,Showa,5,142139,72743,69396
46 ,Kagoshima,20_ 24,1930,Showa,5,107385,49353,58032
46 ,Kagoshima,25_ 29,1930,Showa,5,95932,44302,51630
46 ,Kagoshima,30_ 34,1930,Showa,5,89455,41624,47831
46 ,Kagoshima,35_ 39,1930,Showa,5,83956,39712,44244
46 ,Kagoshima,40_ 44,1930,Showa,5,76934,36289,40645
46 ,Kagoshima,45_ 49,1930,Showa,5,72868,34343,38525
46 ,Kagoshima,50_ 54,1930,Showa,5,71762,33915,37847
46 ,Kagoshima,55_ 59,1930,Showa,5,61729,29679,32050
46 ,Kagoshima,60_ 64,1930,Showa,5,47291,22204,25087
46 ,Kagoshima,65_ 69,1930,Showa,5,33487,15162,18325
46 ,Kagoshima,70_ 74,1930,Showa,5,23709,10082,13627
46 ,Kagoshima,75_ 79,1930,Showa,5,15146,5937,9209
46 ,Kagoshima,over_80,1930,Showa,5,10973,3788,7185
46 ,Kagoshima,total,1935,Showa,10,1591466,773126,818340
46 ,Kagoshima,0_ 4,1935,Showa,10,230358,115876,114482
46 ,Kagoshima,5_ 9,1935,Showa,10,220379,110858,109521
46 ,Kagoshima,10_ 14,1935,Showa,10,197787,101686,96101
46 ,Kagoshima,15_ 19,1935,Showa,10,130350,69479,60871
46 ,Kagoshima,20_ 24,1935,Showa,10,104687,48099,56588
46 ,Kagoshima,25_ 29,1935,Showa,10,97546,44853,52693
46 ,Kagoshima,30_ 34,1935,Showa,10,91236,42555,48681
46 ,Kagoshima,35_ 39,1935,Showa,10,86596,40469,46127
46 ,Kagoshima,40_ 44,1935,Showa,10,80192,38338,41854
46 ,Kagoshima,45_ 49,1935,Showa,10,73412,34554,38858
46 ,Kagoshima,50_ 54,1935,Showa,10,67781,31993,35788
46 ,Kagoshima,55_ 59,1935,Showa,10,65330,30370,34960
46 ,Kagoshima,60_ 64,1935,Showa,10,54372,25461,28911
46 ,Kagoshima,65_ 69,1935,Showa,10,39059,17643,21416
46 ,Kagoshima,70_ 74,1935,Showa,10,25412,10904,14508
46 ,Kagoshima,75_ 79,1935,Showa,10,15275,6020,9255
46 ,Kagoshima,over_80,1935,Showa,10,11694,3968,7726
46 ,Kagoshima,total,1940,Showa,15,1589082,765342,823740
46 ,Kagoshima,0_ 4,1940,Showa,15,210977,106504,104473
46 ,Kagoshima,5_ 9,1940,Showa,15,217576,109329,108247
46 ,Kagoshima,10_ 14,1940,Showa,15,207440,105550,101890
46 ,Kagoshima,15_ 19,1940,Showa,15,131896,62624,69272
46 ,Kagoshima,20_ 24,1940,Showa,15,110219,56778,53441
46 ,Kagoshima,25_ 29,1940,Showa,15,93701,43541,50160
46 ,Kagoshima,30_ 34,1940,Showa,15,88539,40054,48485
46 ,Kagoshima,35_ 39,1940,Showa,15,85523,39058,46465
46 ,Kagoshima,40_ 44,1940,Showa,15,81162,37827,43335
46 ,Kagoshima,45_ 49,1940,Showa,15,75067,35549,39518
46 ,Kagoshima,50_ 54,1940,Showa,15,67566,31713,35853
46 ,Kagoshima,55_ 59,1940,Showa,15,61489,28494,32995
46 ,Kagoshima,60_ 64,1940,Showa,15,57319,25921,31398
46 ,Kagoshima,65_ 69,1940,Showa,15,44378,19941,24437
46 ,Kagoshima,70_ 74,1940,Showa,15,29139,12467,16672
46 ,Kagoshima,75_ 79,1940,Showa,15,15983,6303,9680
46 ,Kagoshima,80_ 84,1940,Showa,15,7500,2605,4895
46 ,Kagoshima,over_85,1940,Showa,15,3608,1084,2524
46 ,Kagoshima,total,1945,Showa,20,1538466,699455,839011
46 ,Kagoshima,1_ 5,1945,Showa,20,192145,96963,95182
46 ,Kagoshima,6_ 10,1945,Showa,20,202099,101941,100158
46 ,Kagoshima,11_ 15,1945,Showa,20,205590,103178,102412
46 ,Kagoshima,16_ 20,1945,Showa,20,172677,82663,90014
46 ,Kagoshima,21_ 25,1945,Showa,20,113663,39155,74508
46 ,Kagoshima,26_ 30,1945,Showa,20,84388,27542,56846
46 ,Kagoshima,31_ 35,1945,Showa,20,79388,28767,50621
46 ,Kagoshima,36_ 40,1945,Showa,20,80443,33144,47299
46 ,Kagoshima,41_ 45,1945,Showa,20,77955,36138,41817
46 ,Kagoshima,46_ 50,1945,Showa,20,72029,34232,37797
46 ,Kagoshima,51_ 55,1945,Showa,20,62526,29979,32547
46 ,Kagoshima,56_ 60,1945,Showa,20,55411,25875,29536
46 ,Kagoshima,61_ 65,1945,Showa,20,46367,20961,25406
46 ,Kagoshima,66_ 70,1945,Showa,20,40392,17460,22932
46 ,Kagoshima,71_ 75,1945,Showa,20,28587,12111,16476
46 ,Kagoshima,76_ 80,1945,Showa,20,15468,6055,9413
46 ,Kagoshima,81_ 85,1945,Showa,20,6876,2532,4344
46 ,Kagoshima,86以上,1945,Showa,20,2462,759,1703
46 ,Kagoshima,total,1950,Showa,25,1804118,868963,935155
46 ,Kagoshima,0_ 4,1950,Showa,25,252435,128558,123877
46 ,Kagoshima,5_ 9,1950,Showa,25,212566,107428,105138
46 ,Kagoshima,10_ 14,1950,Showa,25,215009,108548,106461
46 ,Kagoshima,15_ 19,1950,Showa,25,187055,99439,87616
46 ,Kagoshima,20_ 24,1950,Showa,25,148123,70683,77440
46 ,Kagoshima,25_ 29,1950,Showa,25,123587,53063,70524
46 ,Kagoshima,30_ 34,1950,Showa,25,105773,45900,59873
46 ,Kagoshima,35_ 39,1950,Showa,25,101524,45703,55821
46 ,Kagoshima,40_ 44,1950,Showa,25,92119,42403,49716
46 ,Kagoshima,45_ 49,1950,Showa,25,83126,39913,43213
46 ,Kagoshima,50_ 54,1950,Showa,25,72046,34688,37358
46 ,Kagoshima,55_ 59,1950,Showa,25,60653,29208,31445
46 ,Kagoshima,60_ 64,1950,Showa,25,50360,23039,27321
46 ,Kagoshima,65_ 69,1950,Showa,25,39434,17123,22311
46 ,Kagoshima,70_ 74,1950,Showa,25,30729,12407,18322
46 ,Kagoshima,75_ 79,1950,Showa,25,18728,7214,11514
46 ,Kagoshima,over_80,1950,Showa,25,10840,3641,7199
46 ,Kagoshima,total,1955,Showa,30,2044112,985617,1058495
46 ,Kagoshima,0_ 4,1955,Showa,30,260848,133476,127372
46 ,Kagoshima,5_ 9,1955,Showa,30,266724,135900,130824
46 ,Kagoshima,10_ 14,1955,Showa,30,228471,115441,113030
46 ,Kagoshima,15_ 19,1955,Showa,30,185072,99924,85148
46 ,Kagoshima,20_ 24,1955,Showa,30,155533,75181,80352
46 ,Kagoshima,25_ 29,1955,Showa,30,151036,70678,80358
46 ,Kagoshima,30_ 34,1955,Showa,30,128562,55592,72970
46 ,Kagoshima,35_ 39,1955,Showa,30,111521,48536,62985
46 ,Kagoshima,40_ 44,1955,Showa,30,106804,47922,58882
46 ,Kagoshima,45_ 49,1955,Showa,30,97328,44500,52828
46 ,Kagoshima,50_ 54,1955,Showa,30,87321,41352,45969
46 ,Kagoshima,55_ 59,1955,Showa,30,75332,35844,39488
46 ,Kagoshima,60_ 64,1955,Showa,30,63159,29684,33475
46 ,Kagoshima,65_ 69,1955,Showa,30,49247,21977,27270
46 ,Kagoshima,70_ 74,1955,Showa,30,35939,14819,21120
46 ,Kagoshima,75_ 79,1955,Showa,30,24660,9301,15359
46 ,Kagoshima,80_ 84,1955,Showa,30,11979,4196,7783
46 ,Kagoshima,over_85,1955,Showa,30,4570,1292,3278
46 ,Kagoshima,total,1960,Showa,35,1963104,935282,1027822
46 ,Kagoshima,0_ 4,1960,Showa,35,203597,103712,99885
46 ,Kagoshima,5_ 9,1960,Showa,35,253935,129742,124193
46 ,Kagoshima,10_ 14,1960,Showa,35,260731,132784,127947
46 ,Kagoshima,15_ 19,1960,Showa,35,135556,72994,62562
46 ,Kagoshima,20_ 24,1960,Showa,35,115201,51901,63300
46 ,Kagoshima,25_ 29,1960,Showa,35,138242,63596,74646
46 ,Kagoshima,30_ 34,1960,Showa,35,141710,65926,75784
46 ,Kagoshima,35_ 39,1960,Showa,35,123006,52689,70317
46 ,Kagoshima,40_ 44,1960,Showa,35,106660,45996,60664
46 ,Kagoshima,45_ 49,1960,Showa,35,101553,45088,56465
46 ,Kagoshima,50_ 54,1960,Showa,35,91735,41717,50018
46 ,Kagoshima,55_ 59,1960,Showa,35,81441,38387,43054
46 ,Kagoshima,60_ 64,1960,Showa,35,68616,32071,36545
46 ,Kagoshima,65_ 69,1960,Showa,35,54694,25115,29579
46 ,Kagoshima,70_ 74,1960,Showa,35,39861,16952,22909
46 ,Kagoshima,75_ 79,1960,Showa,35,25430,9807,15623
46 ,Kagoshima,80_ 84,1960,Showa,35,14554,4923,9631
46 ,Kagoshima,over_85,1960,Showa,35,6582,1882,4700
46 ,Kagoshima,total,1965,Showa,40,1853541,872751,980790
46 ,Kagoshima,0_ 4,1965,Showa,40,153569,77941,75628
46 ,Kagoshima,5_ 9,1965,Showa,40,195628,98968,96660
46 ,Kagoshima,10_ 14,1965,Showa,40,245007,124272,120735
46 ,Kagoshima,15_ 19,1965,Showa,40,165996,87881,78115
46 ,Kagoshima,20_ 24,1965,Showa,40,91278,38520,52758
46 ,Kagoshima,25_ 29,1965,Showa,40,107352,47677,59675
46 ,Kagoshima,30_ 34,1965,Showa,40,130440,60775,69665
46 ,Kagoshima,35_ 39,1965,Showa,40,134839,62612,72227
46 ,Kagoshima,40_ 44,1965,Showa,40,116867,49607,67260
46 ,Kagoshima,45_ 49,1965,Showa,40,101094,43124,57970
46 ,Kagoshima,50_ 54,1965,Showa,40,95034,42097,52937
46 ,Kagoshima,55_ 59,1965,Showa,40,85449,38565,46884
46 ,Kagoshima,60_ 64,1965,Showa,40,73872,34411,39461
46 ,Kagoshima,65_ 69,1965,Showa,40,60114,27506,32608
46 ,Kagoshima,70_ 74,1965,Showa,40,44709,19583,25126
46 ,Kagoshima,75_ 79,1965,Showa,40,28680,11489,17191
46 ,Kagoshima,80_ 84,1965,Showa,40,15068,5281,9787
46 ,Kagoshima,over_85,1965,Showa,40,8545,2442,6103
46 ,Kagoshima,total,1970,Showa,45,1729150,803980,925170
46 ,Kagoshima,0_ 4,1970,Showa,45,125643,64160,61483
46 ,Kagoshima,5_ 9,1970,Showa,45,151867,77417,74450
46 ,Kagoshima,10_ 14,1970,Showa,45,191456,97225,94231
46 ,Kagoshima,15_ 19,1970,Showa,45,158038,80904,77134
46 ,Kagoshima,20_ 24,1970,Showa,45,103479,43941,59538
46 ,Kagoshima,25_ 29,1970,Showa,45,90944,41028,49916
46 ,Kagoshima,30_ 34,1970,Showa,45,105335,48030,57305
46 ,Kagoshima,35_ 39,1970,Showa,45,126020,58639,67381
46 ,Kagoshima,40_ 44,1970,Showa,45,127785,58902,68883
46 ,Kagoshima,45_ 49,1970,Showa,45,111900,46836,65064
46 ,Kagoshima,50_ 54,1970,Showa,45,95876,40465,55411
46 ,Kagoshima,55_ 59,1970,Showa,45,88189,38556,49633
46 ,Kagoshima,60_ 64,1970,Showa,45,78141,34543,43598
46 ,Kagoshima,65_ 69,1970,Showa,45,65325,29462,35863
46 ,Kagoshima,70_ 74,1970,Showa,45,49930,21544,28386
46 ,Kagoshima,75_ 79,1970,Showa,45,32771,13464,19307
46 ,Kagoshima,80_ 84,1970,Showa,45,17384,6253,11131
46 ,Kagoshima,over_85,1970,Showa,45,9067,2611,6456
46 ,Kagoshima,total,1975,Showa,50,1723902,804365,919537
46 ,Kagoshima,0_ 4,1975,Showa,50,126394,64528,61866
46 ,Kagoshima,5_ 9,1975,Showa,50,130983,66795,64188
46 ,Kagoshima,10_ 14,1975,Showa,50,152851,77943,74908
46 ,Kagoshima,15_ 19,1975,Showa,50,141189,71393,69796
46 ,Kagoshima,20_ 24,1975,Showa,50,107139,47016,60123
46 ,Kagoshima,25_ 29,1975,Showa,50,115896,55652,60244
46 ,Kagoshima,30_ 34,1975,Showa,50,97970,46858,51112
46 ,Kagoshima,35_ 39,1975,Showa,50,108874,50547,58327
46 ,Kagoshima,40_ 44,1975,Showa,50,127490,59889,67601
46 ,Kagoshima,45_ 49,1975,Showa,50,128012,59249,68763
46 ,Kagoshima,50_ 54,1975,Showa,50,109368,45946,63422
46 ,Kagoshima,55_ 59,1975,Showa,50,93175,39476,53699
46 ,Kagoshima,60_ 64,1975,Showa,50,85662,37151,48511
46 ,Kagoshima,65_ 69,1975,Showa,50,72040,31206,40834
46 ,Kagoshima,70_ 74,1975,Showa,50,56245,24189,32056
46 ,Kagoshima,75_ 79,1975,Showa,50,38067,15232,22835
46 ,Kagoshima,80_ 84,1975,Showa,50,21127,7855,13272
46 ,Kagoshima,over_85,1975,Showa,50,11291,3370,7921
46 ,Kagoshima,total,1980,Showa,55,1784623,839392,945231
46 ,Kagoshima,0_ 4,1980,Showa,55,126262,64270,61992
46 ,Kagoshima,5_ 9,1980,Showa,55,137300,69948,67352
46 ,Kagoshima,10_ 14,1980,Showa,55,135949,69306,66643
46 ,Kagoshima,15_ 19,1980,Showa,55,127787,64466,63321
46 ,Kagoshima,20_ 24,1980,Showa,55,104421,47155,57266
46 ,Kagoshima,25_ 29,1980,Showa,55,128360,62584,65776
46 ,Kagoshima,30_ 34,1980,Showa,55,128819,65054,63765
46 ,Kagoshima,35_ 39,1980,Showa,55,104506,50823,53683
46 ,Kagoshima,40_ 44,1980,Showa,55,111750,52474,59276
46 ,Kagoshima,45_ 49,1980,Showa,55,127253,59791,67462
46 ,Kagoshima,50_ 54,1980,Showa,55,127191,58720,68471
46 ,Kagoshima,55_ 59,1980,Showa,55,107974,45301,62673
46 ,Kagoshima,60_ 64,1980,Showa,55,90155,37907,52248
46 ,Kagoshima,65_ 69,1980,Showa,55,79869,34071,45798
46 ,Kagoshima,70_ 74,1980,Showa,55,62951,26023,36928
46 ,Kagoshima,75_ 79,1980,Showa,55,44273,17759,26514
46 ,Kagoshima,80_ 84,1980,Showa,55,25372,9196,16176
46 ,Kagoshima,over_85,1980,Showa,55,14388,4521,9867
46 ,Kagoshima,total,1985,Showa,60,1819270,856493,962777
46 ,Kagoshima,0_ 4,1985,Showa,60,121977,62328,59649
46 ,Kagoshima,5_ 9,1985,Showa,60,130965,66745,64220
46 ,Kagoshima,10_ 14,1985,Showa,60,140212,71400,68812
46 ,Kagoshima,15_ 19,1985,Showa,60,120072,60090,59982
46 ,Kagoshima,20_ 24,1985,Showa,60,94444,42498,51946
46 ,Kagoshima,25_ 29,1985,Showa,60,115714,54989,60725
46 ,Kagoshima,30_ 34,1985,Showa,60,133622,67134,66488
46 ,Kagoshima,35_ 39,1985,Showa,60,132058,66955,65103
46 ,Kagoshima,40_ 44,1985,Showa,60,105253,51207,54046
46 ,Kagoshima,45_ 49,1985,Showa,60,110958,52016,58942
46 ,Kagoshima,50_ 54,1985,Showa,60,125848,58743,67105
46 ,Kagoshima,55_ 59,1985,Showa,60,125154,57239,67915
46 ,Kagoshima,60_ 64,1985,Showa,60,105287,43937,61350
46 ,Kagoshima,65_ 69,1985,Showa,60,85015,35042,49973
46 ,Kagoshima,70_ 74,1985,Showa,60,71524,29356,42168
46 ,Kagoshima,75_ 79,1985,Showa,60,51226,19784,31442
46 ,Kagoshima,80_ 84,1985,Showa,60,30868,11147,19721
46 ,Kagoshima,over_85,1985,Showa,60,19005,5841,13164
46 ,Kagoshima,total,1990,Heisei,2,1797824,842474,955350
46 ,Kagoshima,0_ 4,1990,Heisei,2,102807,52753,50054
46 ,Kagoshima,5_ 9,1990,Heisei,2,123006,62805,60201
46 ,Kagoshima,10_ 14,1990,Heisei,2,131640,67128,64512
46 ,Kagoshima,15_ 19,1990,Heisei,2,123765,61837,61928
46 ,Kagoshima,20_ 24,1990,Heisei,2,84790,37657,47133
46 ,Kagoshima,25_ 29,1990,Heisei,2,96888,44286,52602
46 ,Kagoshima,30_ 34,1990,Heisei,2,114956,55818,59138
46 ,Kagoshima,35_ 39,1990,Heisei,2,132876,66500,66376
46 ,Kagoshima,40_ 44,1990,Heisei,2,130447,65855,64592
46 ,Kagoshima,45_ 49,1990,Heisei,2,102472,49418,53054
46 ,Kagoshima,50_ 54,1990,Heisei,2,108587,50373,58214
46 ,Kagoshima,55_ 59,1990,Heisei,2,122993,56645,66348
46 ,Kagoshima,60_ 64,1990,Heisei,2,122000,55226,66774
46 ,Kagoshima,65_ 69,1990,Heisei,2,99847,40877,58970
46 ,Kagoshima,70_ 74,1990,Heisei,2,77347,30796,46551
46 ,Kagoshima,75_ 79,1990,Heisei,2,59665,23033,36632
46 ,Kagoshima,80_ 84,1990,Heisei,2,37094,12907,24187
46 ,Kagoshima,over_85,1990,Heisei,2,24951,7553,17398
46 ,Kagoshima,total,1995,Heisei,7,1794224,840980,953244
46 ,Kagoshima,0_ 4,1995,Heisei,7,89757,45838,43919
46 ,Kagoshima,5_ 9,1995,Heisei,7,105640,54196,51444
46 ,Kagoshima,10_ 14,1995,Heisei,7,124521,63675,60846
46 ,Kagoshima,15_ 19,1995,Heisei,7,120962,60379,60583
46 ,Kagoshima,20_ 24,1995,Heisei,7,95534,44599,50935
46 ,Kagoshima,25_ 29,1995,Heisei,7,90373,41321,49052
46 ,Kagoshima,30_ 34,1995,Heisei,7,100382,47596,52786
46 ,Kagoshima,35_ 39,1995,Heisei,7,117751,57749,60002
46 ,Kagoshima,40_ 44,1995,Heisei,7,134419,67889,66530
46 ,Kagoshima,45_ 49,1995,Heisei,7,130088,65966,64122
46 ,Kagoshima,50_ 54,1995,Heisei,7,101595,48822,52773
46 ,Kagoshima,55_ 59,1995,Heisei,7,107722,49550,58172
46 ,Kagoshima,60_ 64,1995,Heisei,7,121606,55638,65968
46 ,Kagoshima,65_ 69,1995,Heisei,7,116991,51831,65160
46 ,Kagoshima,70_ 74,1995,Heisei,7,92260,36297,55963
46 ,Kagoshima,75_ 79,1995,Heisei,7,66559,24861,41698
46 ,Kagoshima,80_ 84,1995,Heisei,7,45193,15659,29534
46 ,Kagoshima,over_85,1995,Heisei,7,32854,9103,23751
46 ,Kagoshima,total,2000,Heisei,12,1786194,837979,948215
46 ,Kagoshima,0_ 4,2000,Heisei,12,81550,41402,40148
46 ,Kagoshima,5_ 9,2000,Heisei,12,91898,46958,44940
46 ,Kagoshima,10_ 14,2000,Heisei,12,107269,55031,52238
46 ,Kagoshima,15_ 19,2000,Heisei,12,114471,57496,56975
46 ,Kagoshima,20_ 24,2000,Heisei,12,97342,46736,50606
46 ,Kagoshima,25_ 29,2000,Heisei,12,100877,47920,52957
46 ,Kagoshima,30_ 34,2000,Heisei,12,94333,44295,50038
46 ,Kagoshima,35_ 39,2000,Heisei,12,102545,49211,53334
46 ,Kagoshima,40_ 44,2000,Heisei,12,119057,58663,60394
46 ,Kagoshima,45_ 49,2000,Heisei,12,134058,67774,66284
46 ,Kagoshima,50_ 54,2000,Heisei,12,129272,65299,63973
46 ,Kagoshima,55_ 59,2000,Heisei,12,101418,48143,53275
46 ,Kagoshima,60_ 64,2000,Heisei,12,108028,49606,58422
46 ,Kagoshima,65_ 69,2000,Heisei,12,117530,52989,64541
46 ,Kagoshima,70_ 74,2000,Heisei,12,108502,46489,62013
46 ,Kagoshima,75_ 79,2000,Heisei,12,80841,29957,50884
46 ,Kagoshima,80_ 84,2000,Heisei,12,52074,17560,34514
46 ,Kagoshima,over_85,2000,Heisei,12,44292,11973,32319
46 ,Kagoshima,total,2005,Heisei,17,1753179,819646,933533
46 ,Kagoshima,0_ 4,2005,Heisei,17,76979,39423,37556
46 ,Kagoshima,5_ 9,2005,Heisei,17,82526,41932,40594
46 ,Kagoshima,10_ 14,2005,Heisei,17,92780,47490,45290
46 ,Kagoshima,15_ 19,2005,Heisei,17,99017,49977,49040
46 ,Kagoshima,20_ 24,2005,Heisei,17,89523,42304,47219
46 ,Kagoshima,25_ 29,2005,Heisei,17,96483,46009,50474
46 ,Kagoshima,30_ 34,2005,Heisei,17,100956,48503,52453
46 ,Kagoshima,35_ 39,2005,Heisei,17,94788,44773,50015
46 ,Kagoshima,40_ 44,2005,Heisei,17,103007,49517,53490
46 ,Kagoshima,45_ 49,2005,Heisei,17,118485,58171,60314
46 ,Kagoshima,50_ 54,2005,Heisei,17,133601,67286,66315
46 ,Kagoshima,55_ 59,2005,Heisei,17,128556,64322,64234
46 ,Kagoshima,60_ 64,2005,Heisei,17,101544,48066,53478
46 ,Kagoshima,65_ 69,2005,Heisei,17,104696,47432,57264
46 ,Kagoshima,70_ 74,2005,Heisei,17,109830,47999,61831
46 ,Kagoshima,75_ 79,2005,Heisei,17,96127,38926,57201
46 ,Kagoshima,80_ 84,2005,Heisei,17,66074,22179,43895
46 ,Kagoshima,over_85,2005,Heisei,17,57832,15113,42719
46 ,Kagoshima,total,2010,Heisei,22,1706242,796896,909346
46 ,Kagoshima,0_ 4,2010,Heisei,22,73903,38008,35895
46 ,Kagoshima,5_ 9,2010,Heisei,22,76992,39464,37528
46 ,Kagoshima,10_ 14,2010,Heisei,22,82484,42016,40468
46 ,Kagoshima,15_ 19,2010,Heisei,22,84977,42753,42224
46 ,Kagoshima,20_ 24,2010,Heisei,22,72956,33899,39057
46 ,Kagoshima,25_ 29,2010,Heisei,22,87110,41182,45928
46 ,Kagoshima,30_ 34,2010,Heisei,22,95733,46070,49663
46 ,Kagoshima,35_ 39,2010,Heisei,22,100667,48613,52054
46 ,Kagoshima,40_ 44,2010,Heisei,22,94453,44708,49745
46 ,Kagoshima,45_ 49,2010,Heisei,22,102191,49155,53036
46 ,Kagoshima,50_ 54,2010,Heisei,22,117422,57583,59839
46 ,Kagoshima,55_ 59,2010,Heisei,22,132319,66133,66186
46 ,Kagoshima,60_ 64,2010,Heisei,22,128322,63929,64393
46 ,Kagoshima,65_ 69,2010,Heisei,22,98783,46312,52471
46 ,Kagoshima,70_ 74,2010,Heisei,22,98738,43717,55021
46 ,Kagoshima,75_ 79,2010,Heisei,22,98332,40949,57383
46 ,Kagoshima,80_ 84,2010,Heisei,22,79286,29396,49890
46 ,Kagoshima,over_85,2010,Heisei,22,74553,19382,55171
46 ,Kagoshima,total,2015,Heisei,27,1648177,773061,875116
46 ,Kagoshima,0_ 4,2015,Heisei,27,70404,36056,34348
46 ,Kagoshima,5_ 9,2015,Heisei,27,73961,38126,35835
46 ,Kagoshima,10_ 14,2015,Heisei,27,76386,39281,37105
46 ,Kagoshima,15_ 19,2015,Heisei,27,76184,38406,37778
46 ,Kagoshima,20_ 24,2015,Heisei,27,61058,28850,32208
46 ,Kagoshima,25_ 29,2015,Heisei,27,71124,33614,37510
46 ,Kagoshima,30_ 34,2015,Heisei,27,86603,41319,45284
46 ,Kagoshima,35_ 39,2015,Heisei,27,95159,46008,49151
46 ,Kagoshima,40_ 44,2015,Heisei,27,99487,48125,51362
46 ,Kagoshima,45_ 49,2015,Heisei,27,92903,44090,48813
46 ,Kagoshima,50_ 54,2015,Heisei,27,100377,48275,52102
46 ,Kagoshima,55_ 59,2015,Heisei,27,115808,56431,59377
46 ,Kagoshima,60_ 64,2015,Heisei,27,131055,65185,65870
46 ,Kagoshima,65_ 69,2015,Heisei,27,124560,61537,63023
46 ,Kagoshima,70_ 74,2015,Heisei,27,92769,42519,50250
46 ,Kagoshima,75_ 79,2015,Heisei,27,89017,37983,51034
46 ,Kagoshima,80_ 84,2015,Heisei,27,81774,31516,50258
46 ,Kagoshima,over_85,2015,Heisei,27,91614,25657,65957
47 ,Okinawa,total,1920,Taisho,9,571572,274829,296743
47 ,Okinawa,0_ 4,1920,Taisho,9,80482,40032,40450
47 ,Okinawa,5_ 9,1920,Taisho,9,68973,34572,34401
47 ,Okinawa,10_ 14,1920,Taisho,9,64437,32130,32307
47 ,Okinawa,15_ 19,1920,Taisho,9,56638,28209,28429
47 ,Okinawa,20_ 24,1920,Taisho,9,43697,20553,23144
47 ,Okinawa,25_ 29,1920,Taisho,9,42551,20758,21793
47 ,Okinawa,30_ 34,1920,Taisho,9,34880,16314,18566
47 ,Okinawa,35_ 39,1920,Taisho,9,33483,16179,17304
47 ,Okinawa,40_ 44,1920,Taisho,9,31277,15296,15981
47 ,Okinawa,45_ 49,1920,Taisho,9,29521,14409,15112
47 ,Okinawa,50_ 54,1920,Taisho,9,26266,12448,13818
47 ,Okinawa,55_ 59,1920,Taisho,9,19429,8851,10578
47 ,Okinawa,60_ 64,1920,Taisho,9,15331,6543,8788
47 ,Okinawa,65_ 69,1920,Taisho,9,10366,4031,6335
47 ,Okinawa,70_ 74,1920,Taisho,9,7300,2581,4719
47 ,Okinawa,75_ 79,1920,Taisho,9,4707,1384,3323
47 ,Okinawa,over_80,1920,Taisho,9,2234,539,1695
47 ,Okinawa,total,1925,Taisho,14,557622,267933,289689
47 ,Okinawa,0_ 4,1925,Taisho,14,80756,40238,40518
47 ,Okinawa,5_ 9,1925,Taisho,14,72901,36461,36440
47 ,Okinawa,10_ 14,1925,Taisho,14,64060,33052,31008
47 ,Okinawa,15_ 19,1925,Taisho,14,47819,26165,21654
47 ,Okinawa,20_ 24,1925,Taisho,14,39731,18766,20965
47 ,Okinawa,25_ 29,1925,Taisho,14,35260,15799,19461
47 ,Okinawa,30_ 34,1925,Taisho,14,34616,16063,18553
47 ,Okinawa,35_ 39,1925,Taisho,14,30491,13685,16806
47 ,Okinawa,40_ 44,1925,Taisho,14,29776,14010,15766
47 ,Okinawa,45_ 49,1925,Taisho,14,28456,13644,14812
47 ,Okinawa,50_ 54,1925,Taisho,14,26671,12669,14002
47 ,Okinawa,55_ 59,1925,Taisho,14,23078,10601,12477
47 ,Okinawa,60_ 64,1925,Taisho,14,16877,7243,9634
47 ,Okinawa,65_ 69,1925,Taisho,14,12182,4839,7343
47 ,Okinawa,70_ 74,1925,Taisho,14,7523,2573,4950
47 ,Okinawa,75_ 79,1925,Taisho,14,4539,1431,3108
47 ,Okinawa,80_ 84,1925,Taisho,14,2228,552,1676
47 ,Okinawa,over_85,1925,Taisho,14,658,142,516
47 ,Okinawa,total,1930,Showa,5,577509,272797,304712
47 ,Okinawa,0_ 4,1930,Showa,5,84457,42492,41965
47 ,Okinawa,5_ 9,1930,Showa,5,75960,38319,37641
47 ,Okinawa,10_ 14,1930,Showa,5,68699,34708,33991
47 ,Okinawa,15_ 19,1930,Showa,5,51777,26672,25105
47 ,Okinawa,20_ 24,1930,Showa,5,39801,17899,21902
47 ,Okinawa,25_ 29,1930,Showa,5,35739,15564,20175
47 ,Okinawa,30_ 34,1930,Showa,5,31973,14098,17875
47 ,Okinawa,35_ 39,1930,Showa,5,32382,14627,17755
47 ,Okinawa,40_ 44,1930,Showa,5,28329,12554,15775
47 ,Okinawa,45_ 49,1930,Showa,5,27963,13030,14933
47 ,Okinawa,50_ 54,1930,Showa,5,26395,12461,13934
47 ,Okinawa,55_ 59,1930,Showa,5,23826,10990,12836
47 ,Okinawa,60_ 64,1930,Showa,5,20072,8768,11304
47 ,Okinawa,65_ 69,1930,Showa,5,13319,5289,8030
47 ,Okinawa,70_ 74,1930,Showa,5,8996,3177,5819
47 ,Okinawa,75_ 79,1930,Showa,5,4746,1413,3333
47 ,Okinawa,over_80,1930,Showa,5,3075,736,2339
47 ,Okinawa,total,1935,Showa,10,592494,281266,311228
47 ,Okinawa,0_ 4,1935,Showa,10,84666,42314,42352
47 ,Okinawa,5_ 9,1935,Showa,10,79186,40189,38997
47 ,Okinawa,10_ 14,1935,Showa,10,71683,36567,35116
47 ,Okinawa,15_ 19,1935,Showa,10,53043,28149,24894
47 ,Okinawa,20_ 24,1935,Showa,10,39746,18434,21312
47 ,Okinawa,25_ 29,1935,Showa,10,36032,16161,19871
47 ,Okinawa,30_ 34,1935,Showa,10,33927,14895,19032
47 ,Okinawa,35_ 39,1935,Showa,10,30518,13569,16949
47 ,Okinawa,40_ 44,1935,Showa,10,30453,13843,16610
47 ,Okinawa,45_ 49,1935,Showa,10,26657,11792,14865
47 ,Okinawa,50_ 54,1935,Showa,10,25922,12007,13915
47 ,Okinawa,55_ 59,1935,Showa,10,23886,10994,12892
47 ,Okinawa,60_ 64,1935,Showa,10,21095,9351,11744
47 ,Okinawa,65_ 69,1935,Showa,10,16364,6731,9633
47 ,Okinawa,70_ 74,1935,Showa,10,10004,3609,6395
47 ,Okinawa,75_ 79,1935,Showa,10,5877,1814,4063
47 ,Okinawa,over_80,1935,Showa,10,3435,847,2588
47 ,Okinawa,total,1940,Showa,15,574490,270634,303856
47 ,Okinawa,0_ 4,1940,Showa,15,81708,41474,40234
47 ,Okinawa,5_ 9,1940,Showa,15,78258,39467,38791
47 ,Okinawa,10_ 14,1940,Showa,15,73877,38154,35723
47 ,Okinawa,15_ 19,1940,Showa,15,44766,22691,22075
47 ,Okinawa,20_ 24,1940,Showa,15,36497,17436,19061
47 ,Okinawa,25_ 29,1940,Showa,15,32066,14204,17862
47 ,Okinawa,30_ 34,1940,Showa,15,30794,13120,17674
47 ,Okinawa,35_ 39,1940,Showa,15,30919,13281,17638
47 ,Okinawa,40_ 44,1940,Showa,15,28320,12536,15784
47 ,Okinawa,45_ 49,1940,Showa,15,28493,12869,15624
47 ,Okinawa,50_ 54,1940,Showa,15,24845,10871,13974
47 ,Okinawa,55_ 59,1940,Showa,15,23327,10604,12723
47 ,Okinawa,60_ 64,1940,Showa,15,20910,9227,11683
47 ,Okinawa,65_ 69,1940,Showa,15,17019,7129,9890
47 ,Okinawa,70_ 74,1940,Showa,15,12311,4628,7683
47 ,Okinawa,75_ 79,1940,Showa,15,6346,2000,4346
47 ,Okinawa,80_ 84,1940,Showa,15,2977,746,2231
47 ,Okinawa,over_85,1940,Showa,15,1053,196,857
47 ,Okinawa,total,1945,Showa,20,326625,135126,191499
47 ,Okinawa,1_ 5,1945,Showa,20,36879,18398,18481
47 ,Okinawa,6_ 10,1945,Showa,20,50480,25089,25391
47 ,Okinawa,11_ 15,1945,Showa,20,48503,23988,24515
47 ,Okinawa,16_ 20,1945,Showa,20,33350,14845,18505
47 ,Okinawa,21_ 25,1945,Showa,20,16424,2835,13589
47 ,Okinawa,26_ 30,1945,Showa,20,15857,3545,12312
47 ,Okinawa,31_ 35,1945,Showa,20,14861,4149,10712
47 ,Okinawa,36_ 40,1945,Showa,20,13974,3983,9991
47 ,Okinawa,41_ 45,1945,Showa,20,13667,3904,9763
47 ,Okinawa,46_ 50,1945,Showa,20,16261,6576,9685
47 ,Okinawa,51_ 55,1945,Showa,20,16246,6829,9417
47 ,Okinawa,56_ 60,1945,Showa,20,14431,6170,8261
47 ,Okinawa,61_ 65,1945,Showa,20,12813,5519,7294
47 ,Okinawa,66_ 70,1945,Showa,20,10181,4370,5811
47 ,Okinawa,71_ 75,1945,Showa,20,7244,3027,4217
47 ,Okinawa,76_ 80,1945,Showa,20,3577,1333,2244
47 ,Okinawa,81_ 85,1945,Showa,20,1514,472,1042
47 ,Okinawa,86以上,1945,Showa,20,363,94,269
47 ,Okinawa,total,1950,Showa,25,906854,425175,481679
47 ,Okinawa,0_ 4,1950,Showa,25,144334,73661,70673
47 ,Okinawa,5_ 9,1950,Showa,25,100851,51372,49479
47 ,Okinawa,10_ 14,1950,Showa,25,110352,56036,54316
47 ,Okinawa,15_ 19,1950,Showa,25,100790,49719,51071
47 ,Okinawa,20_ 24,1950,Showa,25,78181,35563,42618
47 ,Okinawa,25_ 29,1950,Showa,25,60503,25728,34775
47 ,Okinawa,30_ 34,1950,Showa,25,51600,22094,29506
47 ,Okinawa,35_ 39,1950,Showa,25,46397,20208,26189
47 ,Okinawa,40_ 44,1950,Showa,25,42042,18334,23708
47 ,Okinawa,45_ 49,1950,Showa,25,37444,16148,21296
47 ,Okinawa,50_ 54,1950,Showa,25,32476,14395,18081
47 ,Okinawa,55_ 59,1950,Showa,25,30808,13794,17014
47 ,Okinawa,60_ 64,1950,Showa,25,25316,10758,14558
47 ,Okinawa,65_ 69,1950,Showa,25,19116,7818,11298
47 ,Okinawa,70以上,1950,Showa,25,26644,9547,17097
47 ,Okinawa,total,1955,Showa,30,801065,381939,419126
47 ,Okinawa,0_ 4,1955,Showa,30,133771,68096,65675
47 ,Okinawa,5_ 9,1955,Showa,30,113423,57956,55467
47 ,Okinawa,10_ 14,1955,Showa,30,77553,39756,37797
47 ,Okinawa,15_ 19,1955,Showa,30,83556,41759,41797
47 ,Okinawa,20_ 24,1955,Showa,30,72711,35286,37425
47 ,Okinawa,25_ 29,1955,Showa,30,58751,27342,31409
47 ,Okinawa,30_ 34,1955,Showa,30,45690,19915,25775
47 ,Okinawa,35_ 39,1955,Showa,30,39563,17031,22532
47 ,Okinawa,40_ 44,1955,Showa,30,35176,15679,19497
47 ,Okinawa,45_ 49,1955,Showa,30,30820,13587,17233
47 ,Okinawa,50_ 54,1955,Showa,30,27289,11832,15457
47 ,Okinawa,55_ 59,1955,Showa,30,22848,10057,12791
47 ,Okinawa,60_ 64,1955,Showa,30,20963,9190,11773
47 ,Okinawa,65_ 69,1955,Showa,30,15580,6344,9236
47 ,Okinawa,70以上,1955,Showa,30,23328,8090,15238
47 ,Okinawa,total,1960,Showa,35,883122,422843,460279
47 ,Okinawa,0_ 4,1960,Showa,35,120395,61186,59209
47 ,Okinawa,5_ 9,1960,Showa,35,134506,68247,66259
47 ,Okinawa,10_ 14,1960,Showa,35,112652,57432,55220
47 ,Okinawa,15_ 19,1960,Showa,35,71135,36091,35044
47 ,Okinawa,20_ 24,1960,Showa,35,72532,34830,37702
47 ,Okinawa,25_ 29,1960,Showa,35,70164,34510,35654
47 ,Okinawa,30_ 34,1960,Showa,35,57888,27142,30746
47 ,Okinawa,35_ 39,1960,Showa,35,45105,19662,25443
47 ,Okinawa,40_ 44,1960,Showa,35,38817,16776,22041
47 ,Okinawa,45_ 49,1960,Showa,35,34254,15155,19099
47 ,Okinawa,50_ 54,1960,Showa,35,29814,13063,16751
47 ,Okinawa,55_ 59,1960,Showa,35,26169,11189,14980
47 ,Okinawa,60_ 64,1960,Showa,35,21391,9183,12208
47 ,Okinawa,65_ 69,1960,Showa,35,18888,8049,10839
47 ,Okinawa,70_ 74,1960,Showa,35,13223,5106,8117
47 ,Okinawa,75_ 79,1960,Showa,35,8719,3061,5658
47 ,Okinawa,80_ 84,1960,Showa,35,4738,1455,3283
47 ,Okinawa,over_85,1960,Showa,35,2603,650,1953
47 ,Okinawa,total,1965,Showa,40,934176,447693,486483
47 ,Okinawa,0_ 4,1965,Showa,40,108124,55191,52933
47 ,Okinawa,5_ 9,1965,Showa,40,120828,61183,59645
47 ,Okinawa,10_ 14,1965,Showa,40,134096,68155,65941
47 ,Okinawa,15_ 19,1965,Showa,40,96108,49014,47094
47 ,Okinawa,20_ 24,1965,Showa,40,58830,27672,31158
47 ,Okinawa,25_ 29,1965,Showa,40,71398,34533,36865
47 ,Okinawa,30_ 34,1965,Showa,40,67587,33715,33872
47 ,Okinawa,35_ 39,1965,Showa,40,55458,25963,29495
47 ,Okinawa,40_ 44,1965,Showa,40,43619,18976,24643
47 ,Okinawa,45_ 49,1965,Showa,40,37521,16146,21375
47 ,Okinawa,50_ 54,1965,Showa,40,33473,14584,18889
47 ,Okinawa,55_ 59,1965,Showa,40,28125,12074,16051
47 ,Okinawa,60_ 64,1965,Showa,40,24169,9957,14212
47 ,Okinawa,65_ 69,1965,Showa,40,19155,7874,11281
47 ,Okinawa,70_ 74,1965,Showa,40,16057,6378,9679
47 ,Okinawa,75_ 79,1965,Showa,40,10223,3540,6683
47 ,Okinawa,80_ 84,1965,Showa,40,5798,1804,3994
47 ,Okinawa,over_85,1965,Showa,40,3556,910,2646
47 ,Okinawa,total,1970,Showa,45,945111,451393,493718
47 ,Okinawa,0_ 4,1970,Showa,45,101745,51599,50146
47 ,Okinawa,5_ 9,1970,Showa,45,108089,54948,53141
47 ,Okinawa,10_ 14,1970,Showa,45,119488,60281,59207
47 ,Okinawa,15_ 19,1970,Showa,45,103446,51371,52075
47 ,Okinawa,20_ 24,1970,Showa,45,67318,31894,35424
47 ,Okinawa,25_ 29,1970,Showa,45,59082,28532,30550
47 ,Okinawa,30_ 34,1970,Showa,45,69306,34089,35217
47 ,Okinawa,35_ 39,1970,Showa,45,65930,33104,32826
47 ,Okinawa,40_ 44,1970,Showa,45,53680,25054,28626
47 ,Okinawa,45_ 49,1970,Showa,45,42081,18137,23944
47 ,Okinawa,50_ 54,1970,Showa,45,35939,15292,20647
47 ,Okinawa,55_ 59,1970,Showa,45,30467,13080,17387
47 ,Okinawa,60_ 64,1970,Showa,45,26237,10996,15241
47 ,Okinawa,65_ 69,1970,Showa,45,21707,8690,13017
47 ,Okinawa,70_ 74,1970,Showa,45,16610,6435,10175
47 ,Okinawa,75_ 79,1970,Showa,45,12275,4471,7804
47 ,Okinawa,80_ 84,1970,Showa,45,7031,2176,4855
47 ,Okinawa,over_85,1970,Showa,45,4680,1244,3436
47 ,Okinawa,total,1975,Showa,50,1042572,510754,531818
47 ,Okinawa,0_ 4,1975,Showa,50,112309,57413,54896
47 ,Okinawa,5_ 9,1975,Showa,50,105300,53581,51719
47 ,Okinawa,10_ 14,1975,Showa,50,108929,55268,53661
47 ,Okinawa,15_ 19,1975,Showa,50,101766,51735,50031
47 ,Okinawa,20_ 24,1975,Showa,50,90539,46299,44240
47 ,Okinawa,25_ 29,1975,Showa,50,83102,42975,40127
47 ,Okinawa,30_ 34,1975,Showa,50,65086,32791,32295
47 ,Okinawa,35_ 39,1975,Showa,50,73017,36850,36167
47 ,Okinawa,40_ 44,1975,Showa,50,67799,34794,33005
47 ,Okinawa,45_ 49,1975,Showa,50,54639,25907,28732
47 ,Okinawa,50_ 54,1975,Showa,50,41409,18051,23358
47 ,Okinawa,55_ 59,1975,Showa,50,34858,14869,19989
47 ,Okinawa,60_ 64,1975,Showa,50,29900,12645,17255
47 ,Okinawa,65_ 69,1975,Showa,50,24680,10010,14670
47 ,Okinawa,70_ 74,1975,Showa,50,19471,7346,12125
47 ,Okinawa,75_ 79,1975,Showa,50,13519,4917,8602
47 ,Okinawa,80_ 84,1975,Showa,50,8920,2938,5982
47 ,Okinawa,over_85,1975,Showa,50,5949,1545,4404
47 ,Okinawa,total,1980,Showa,55,1106559,543692,562867
47 ,Okinawa,0_ 4,1980,Showa,55,104246,53301,50945
47 ,Okinawa,5_ 9,1980,Showa,55,115493,59125,56368
47 ,Okinawa,10_ 14,1980,Showa,55,105654,53787,51867
47 ,Okinawa,15_ 19,1980,Showa,55,94640,48144,46496
47 ,Okinawa,20_ 24,1980,Showa,55,80425,40597,39828
47 ,Okinawa,25_ 29,1980,Showa,55,99800,51440,48360
47 ,Okinawa,30_ 34,1980,Showa,55,86112,44593,41519
47 ,Okinawa,35_ 39,1980,Showa,55,65827,33322,32505
47 ,Okinawa,40_ 44,1980,Showa,55,72528,36665,35863
47 ,Okinawa,45_ 49,1980,Showa,55,66726,33855,32871
47 ,Okinawa,50_ 54,1980,Showa,55,53557,25053,28504
47 ,Okinawa,55_ 59,1980,Showa,55,40565,17375,23190
47 ,Okinawa,60_ 64,1980,Showa,55,33994,14187,19807
47 ,Okinawa,65_ 69,1980,Showa,55,28240,11533,16707
47 ,Okinawa,70_ 74,1980,Showa,55,22603,8725,13878
47 ,Okinawa,75_ 79,1980,Showa,55,16561,5760,10801
47 ,Okinawa,80_ 84,1980,Showa,55,10343,3337,7006
47 ,Okinawa,over_85,1980,Showa,55,8072,2186,5886
47 ,Okinawa,total,1985,Showa,60,1179097,581102,597995
47 ,Okinawa,0_ 4,1985,Showa,60,100880,51631,49249
47 ,Okinawa,5_ 9,1985,Showa,60,106521,54576,51945
47 ,Okinawa,10_ 14,1985,Showa,60,115122,58705,56417
47 ,Okinawa,15_ 19,1985,Showa,60,96362,48970,47392
47 ,Okinawa,20_ 24,1985,Showa,60,79747,39763,39984
47 ,Okinawa,25_ 29,1985,Showa,60,91989,46584,45405
47 ,Okinawa,30_ 34,1985,Showa,60,104833,54600,50233
47 ,Okinawa,35_ 39,1985,Showa,60,87010,45424,41586
47 ,Okinawa,40_ 44,1985,Showa,60,65457,33357,32100
47 ,Okinawa,45_ 49,1985,Showa,60,71624,36068,35556
47 ,Okinawa,50_ 54,1985,Showa,60,65359,32920,32439
47 ,Okinawa,55_ 59,1985,Showa,60,52306,24265,28041
47 ,Okinawa,60_ 64,1985,Showa,60,39432,16597,22835
47 ,Okinawa,65_ 69,1985,Showa,60,32298,13115,19183
47 ,Okinawa,70_ 74,1985,Showa,60,26070,10224,15846
47 ,Okinawa,75_ 79,1985,Showa,60,19782,7146,12636
47 ,Okinawa,80_ 84,1985,Showa,60,13138,4099,9039
47 ,Okinawa,over_85,1985,Showa,60,10659,2849,7810
47 ,Okinawa,total,1990,Heisei,2,1222398,598669,623729
47 ,Okinawa,0_ 4,1990,Heisei,2,92885,47619,45266
47 ,Okinawa,5_ 9,1990,Heisei,2,101639,52037,49602
47 ,Okinawa,10_ 14,1990,Heisei,2,105312,53720,51592
47 ,Okinawa,15_ 19,1990,Heisei,2,105362,53200,52162
47 ,Okinawa,20_ 24,1990,Heisei,2,78605,38271,40334
47 ,Okinawa,25_ 29,1990,Heisei,2,83186,40955,42231
47 ,Okinawa,30_ 34,1990,Heisei,2,92227,46480,45747
47 ,Okinawa,35_ 39,1990,Heisei,2,102642,52829,49813
47 ,Okinawa,40_ 44,1990,Heisei,2,84596,43767,40829
47 ,Okinawa,45_ 49,1990,Heisei,2,63344,31887,31457
47 ,Okinawa,50_ 54,1990,Heisei,2,69469,34442,35027
47 ,Okinawa,55_ 59,1990,Heisei,2,63419,31505,31914
47 ,Okinawa,60_ 64,1990,Heisei,2,50437,22960,27477
47 ,Okinawa,65_ 69,1990,Heisei,2,37591,15406,22185
47 ,Okinawa,70_ 74,1990,Heisei,2,29977,11735,18242
47 ,Okinawa,75_ 79,1990,Heisei,2,23216,8548,14668
47 ,Okinawa,80_ 84,1990,Heisei,2,16011,5264,10747
47 ,Okinawa,over_85,1990,Heisei,2,14287,3635,10652
47 ,Okinawa,total,1995,Heisei,7,1273440,624737,648703
47 ,Okinawa,0_ 4,1995,Heisei,7,85831,44026,41805
47 ,Okinawa,5_ 9,1995,Heisei,7,94663,48535,46128
47 ,Okinawa,10_ 14,1995,Heisei,7,100808,51391,49417
47 ,Okinawa,15_ 19,1995,Heisei,7,99612,50697,48915
47 ,Okinawa,20_ 24,1995,Heisei,7,96293,48122,48171
47 ,Okinawa,25_ 29,1995,Heisei,7,85988,42127,43861
47 ,Okinawa,30_ 34,1995,Heisei,7,87584,43646,43938
47 ,Okinawa,35_ 39,1995,Heisei,7,93708,47497,46211
47 ,Okinawa,40_ 44,1995,Heisei,7,102171,52813,49358
47 ,Okinawa,45_ 49,1995,Heisei,7,83908,43353,40555
47 ,Okinawa,50_ 54,1995,Heisei,7,62661,31254,31407
47 ,Okinawa,55_ 59,1995,Heisei,7,68673,33755,34918
47 ,Okinawa,60_ 64,1995,Heisei,7,62154,30539,31615
47 ,Okinawa,65_ 69,1995,Heisei,7,48643,21641,27002
47 ,Okinawa,70_ 74,1995,Heisei,7,35384,13927,21457
47 ,Okinawa,75_ 79,1995,Heisei,7,26843,9856,16987
47 ,Okinawa,80_ 84,1995,Heisei,7,19139,6378,12761
47 ,Okinawa,over_85,1995,Heisei,7,18558,4726,13832
47 ,Okinawa,total,2000,Heisei,12,1318220,647877,670343
47 ,Okinawa,0_ 4,2000,Heisei,12,82594,42443,40151
47 ,Okinawa,5_ 9,2000,Heisei,12,87200,44631,42569
47 ,Okinawa,10_ 14,2000,Heisei,12,94485,48357,46128
47 ,Okinawa,15_ 19,2000,Heisei,12,95512,48771,46741
47 ,Okinawa,20_ 24,2000,Heisei,12,86467,43467,43000
47 ,Okinawa,25_ 29,2000,Heisei,12,98712,48895,49817
47 ,Okinawa,30_ 34,2000,Heisei,12,88860,43743,45117
47 ,Okinawa,35_ 39,2000,Heisei,12,88508,44259,44249
47 ,Okinawa,40_ 44,2000,Heisei,12,92940,47132,45808
47 ,Okinawa,45_ 49,2000,Heisei,12,100475,51829,48646
47 ,Okinawa,50_ 54,2000,Heisei,12,81999,42325,39674
47 ,Okinawa,55_ 59,2000,Heisei,12,61080,30335,30745
47 ,Okinawa,60_ 64,2000,Heisei,12,67273,32810,34463
47 ,Okinawa,65_ 69,2000,Heisei,12,59502,28707,30795
47 ,Okinawa,70_ 74,2000,Heisei,12,45533,19604,25929
47 ,Okinawa,75_ 79,2000,Heisei,12,31661,11889,19772
47 ,Okinawa,80_ 84,2000,Heisei,12,22321,7465,14856
47 ,Okinawa,over_85,2000,Heisei,12,23540,6087,17453
47 ,Okinawa,total,2005,Heisei,17,1361594,668502,693092
47 ,Okinawa,0_ 4,2005,Heisei,17,81799,41975,39824
47 ,Okinawa,5_ 9,2005,Heisei,17,84777,43530,41247
47 ,Okinawa,10_ 14,2005,Heisei,17,87627,44944,42683
47 ,Okinawa,15_ 19,2005,Heisei,17,90043,46038,44005
47 ,Okinawa,20_ 24,2005,Heisei,17,84034,41843,42191
47 ,Okinawa,25_ 29,2005,Heisei,17,92905,46053,46852
47 ,Okinawa,30_ 34,2005,Heisei,17,103874,51493,52381
47 ,Okinawa,35_ 39,2005,Heisei,17,91672,45398,46274
47 ,Okinawa,40_ 44,2005,Heisei,17,89305,44799,44506
47 ,Okinawa,45_ 49,2005,Heisei,17,93056,47122,45934
47 ,Okinawa,50_ 54,2005,Heisei,17,100276,51718,48558
47 ,Okinawa,55_ 59,2005,Heisei,17,81904,41993,39911
47 ,Okinawa,60_ 64,2005,Heisei,17,60977,30224,30753
47 ,Okinawa,65_ 69,2005,Heisei,17,65378,31460,33918
47 ,Okinawa,70_ 74,2005,Heisei,17,56050,26264,29786
47 ,Okinawa,75_ 79,2005,Heisei,17,41163,16821,24342
47 ,Okinawa,80_ 84,2005,Heisei,17,26803,9078,17725
47 ,Okinawa,over_85,2005,Heisei,17,29503,7479,22024
47 ,Okinawa,total,2010,Heisei,22,1392818,683328,709490
47 ,Okinawa,0_ 4,2010,Heisei,22,80792,41136,39656
47 ,Okinawa,5_ 9,2010,Heisei,22,81422,41797,39625
47 ,Okinawa,10_ 14,2010,Heisei,22,84099,43140,40959
47 ,Okinawa,15_ 19,2010,Heisei,22,83477,42704,40773
47 ,Okinawa,20_ 24,2010,Heisei,22,76546,38299,38247
47 ,Okinawa,25_ 29,2010,Heisei,22,86184,42198,43986
47 ,Okinawa,30_ 34,2010,Heisei,22,94733,46857,47876
47 ,Okinawa,35_ 39,2010,Heisei,22,105201,52541,52660
47 ,Okinawa,40_ 44,2010,Heisei,22,91826,45542,46284
47 ,Okinawa,45_ 49,2010,Heisei,22,88611,44470,44141
47 ,Okinawa,50_ 54,2010,Heisei,22,91916,46511,45405
47 ,Okinawa,55_ 59,2010,Heisei,22,98513,50264,48249
47 ,Okinawa,60_ 64,2010,Heisei,22,80953,41290,39663
47 ,Okinawa,65_ 69,2010,Heisei,22,58874,28775,30099
47 ,Okinawa,70_ 74,2010,Heisei,22,61287,28732,32555
47 ,Okinawa,75_ 79,2010,Heisei,22,50514,22545,27969
47 ,Okinawa,80_ 84,2010,Heisei,22,35072,13190,21882
47 ,Okinawa,over_85,2010,Heisei,22,34760,8990,25770
47 ,Okinawa,total,2015,Heisei,27,1433566,704619,728947
47 ,Okinawa,0_ 4,2015,Heisei,27,82414,41877,40537
47 ,Okinawa,5_ 9,2015,Heisei,27,82708,42173,40535
47 ,Okinawa,10_ 14,2015,Heisei,27,82084,42179,39905
47 ,Okinawa,15_ 19,2015,Heisei,27,80791,41462,39329
47 ,Okinawa,20_ 24,2015,Heisei,27,71233,36157,35076
47 ,Okinawa,25_ 29,2015,Heisei,27,79110,39297,39813
47 ,Okinawa,30_ 34,2015,Heisei,27,89819,44078,45741
47 ,Okinawa,35_ 39,2015,Heisei,27,96740,47798,48942
47 ,Okinawa,40_ 44,2015,Heisei,27,105782,52998,52784
47 ,Okinawa,45_ 49,2015,Heisei,27,92038,45798,46240
47 ,Okinawa,50_ 54,2015,Heisei,27,88142,44320,43822
47 ,Okinawa,55_ 59,2015,Heisei,27,91033,45818,45215
47 ,Okinawa,60_ 64,2015,Heisei,27,97421,49410,48011
47 ,Okinawa,65_ 69,2015,Heisei,27,79074,39799,39275
47 ,Okinawa,70_ 74,2015,Heisei,27,55820,26756,29064
47 ,Okinawa,75_ 79,2015,Heisei,27,56111,25504,30607
47 ,Okinawa,80_ 84,2015,Heisei,27,43199,18017,25182
47 ,Okinawa,over_85,2015,Heisei,27,44133,12637,31496